QUERY_ID	QUERY_NAME	QUERY_START	QUERY_END	QUERY_LENGTH	REF_ID	REF_NAME	REF_START	REF_END	REF_LENGTH	IDENTITY	EVALUE
UCT124H	contig_1	25767	26406	639	renamed_GCF_000008685.2	chromosome	25752	26391	639	100.0	1.211e-143
UCT124H	contig_1	26413	27463	1050	renamed_GCF_000008685.2	chromosome	26398	27448	1050	99.7	1.732e-234
UCT124H	contig_1	27880	27448	432	renamed_GCF_000008685.2	chromosome	27865	27433	432	100.0	2.641e-92
UCT124H	contig_1	28505	27869	636	renamed_GCF_000008685.2	chromosome	28490	27854	636	100.0	8.334e-139
UCT124H	contig_1	29487	28506	981	renamed_GCF_000008685.2	chromosome	29472	28491	981	100.0	8.047e-223
UCT124H	contig_1	29557	31030	1473	renamed_GCF_000008685.2	chromosome	29542	31015	1473	100.0	0.0
UCT124H	contig_1	31041	31494	453	renamed_GCF_000008685.2	chromosome	31026	31479	453	100.0	2.279e-97
UCT124H	contig_1	32104	31564	540	renamed_GCF_000008685.2	chromosome	32089	31549	540	100.0	3.274e-116
UCT124H	contig_1	34052	32171	1881	renamed_GCF_000008685.2	chromosome	34037	32156	1881	100.0	0.0
UCT124H	contig_1	35851	34051	1800	renamed_GCF_000008685.2	chromosome	35836	34036	1800	100.0	0.0
UCT124H	contig_1	36624	35871	753	renamed_GCF_000008685.2	chromosome	36609	35856	753	100.0	1.343e-161
UCT124H	contig_1	39840	40692	852	renamed_GCF_000008685.2	chromosome	39825	40677	852	100.0	1.031e-189
UCT124H	contig_1	41447	40775	672	renamed_GCF_000008685.2	chromosome	41432	40760	672	100.0	1.856e-144
UCT124H	contig_1	45369	42921	2448	renamed_GCF_000008685.2	chromosome	45354	42906	2448	99.6	0.0
UCT124H	contig_1	46394	46025	369	renamed_GCF_000008685.2	chromosome	46379	46010	369	100.0	3.085e-80
UCT124H	contig_1	49274	48617	657	renamed_GCF_000008685.2	chromosome	49259	48602	657	99.5	1.056e-139
UCT124H	contig_1	51266	50504	762	renamed_GCF_000008685.2	chromosome	51251	50489	762	100.0	1.168e-164
UCT124H	contig_1	55519	53548	1971	renamed_GCF_000008685.2	chromosome	55504	53533	1971	99.5	0.0
UCT124H	contig_1	56763	56295	468	renamed_GCF_000008685.2	chromosome	56748	56280	468	100.0	3.979e-102
UCT124H	contig_1	79022	77723	1299	renamed_GCF_000008685.2	chromosome	79009	77710	1299	100.0	8.363e-285
UCT124H	contig_1	79515	80784	1269	renamed_GCF_000008685.2	chromosome	79504	80773	1269	100.0	1.4e-282
UCT124H	contig_1	81414	82950	1536	renamed_GCF_000008685.2	chromosome	81404	82940	1536	100.0	0.0
UCT124H	contig_1	85730	84050	1680	renamed_GCF_000008685.2	chromosome	85720	84040	1680	99.8	0.0
UCT124H	contig_1	87370	86935	435	renamed_GCF_000008685.2	chromosome	87360	86925	435	100.0	2.772e-92
UCT124H	contig_1	89818	89209	609	renamed_GCF_000008685.2	chromosome	89808	89199	609	100.0	1.275e-129
UCT124H	contig_1	102958	101533	1425	renamed_GCF_000008685.2	chromosome	102949	101524	1425	100.0	1.009e-312
UCT124H	contig_1	105440	103772	1668	renamed_GCF_000008685.2	chromosome	105299	103763	1668	99.8	0.0
UCT124H	contig_1	106903	105892	1011	renamed_GCF_000008685.2	chromosome	106894	105883	1011	100.0	4.14e-218
UCT124H	contig_1	108315	109680	1365	renamed_GCF_000008685.2	chromosome	108306	109671	1365	99.7	2.146e-311
UCT124H	contig_1	157635	158070	435	renamed_GCF_000008685.2	chromosome	157626	158061	435	99.3	1.372e-91
UCT124H	contig_1	171107	170729	378	renamed_GCF_000008685.2	chromosome	171097	170719	378	100.0	1.603e-80
UCT124H	contig_1	173590	171541	2049	renamed_GCF_000008685.2	chromosome	173535	171531	2049	99.2	0.0
UCT124H	contig_1	175094	174107	987	renamed_GCF_000008685.2	chromosome	174970	174097	987	98.9	9.202e-188
UCT124H	contig_1	176984	176078	906	renamed_GCF_000008685.2	chromosome	176974	176068	906	100.0	1.374e-195
UCT124H	contig_1	188504	188243	261	renamed_GCF_000008685.2	chromosome	188494	188233	261	100.0	7.054e-54
UCT124H	contig_1	189286	189085	201	renamed_GCF_000008685.2	chromosome	189276	189075	201	100.0	9.889e-41
UCT124H	contig_1	190073	190727	654	renamed_GCF_000008685.2	chromosome	190186	190717	654	100.0	6.314e-111
UCT124H	contig_1	192337	191527	810	renamed_GCF_000008685.2	chromosome	192327	191517	810	99.6	1.125e-181
UCT124H	contig_1	194886	195747	861	renamed_GCF_000008685.2	chromosome	194875	195736	861	98.9	3.489e-186
UCT124H	contig_1	256488	259011	2523	renamed_GCF_000008685.2	chromosome	256462	258985	2523	99.7	0.0
UCT124H	contig_1	263738	261317	2421	renamed_GCF_000008685.2	chromosome	263712	261291	2421	100.0	0.0
UCT124H	contig_1	266132	267077	945	renamed_GCF_000008685.2	chromosome	266106	267051	945	99.6	3.099e-210
UCT124H	contig_1	291621	291084	537	renamed_GCF_000008685.2	chromosome	291595	291058	537	100.0	7.638e-115
UCT124H	contig_1	293234	292451	783	renamed_GCF_000008685.2	chromosome	293208	292425	783	100.0	6.057e-167
UCT124H	contig_1	294806	293477	1329	renamed_GCF_000008685.2	chromosome	294780	293451	1329	100.0	2.397e-295
UCT124H	contig_1	295254	294810	444	renamed_GCF_000008685.2	chromosome	295228	294784	444	100.0	1.185e-94
UCT124H	contig_1	297071	296453	618	renamed_GCF_000008685.2	chromosome	297045	296427	618	100.0	5.47e-132
UCT124H	contig_1	308542	307342	1200	renamed_GCF_000008685.2	chromosome	308517	307317	1200	99.7	1.629e-260
UCT124H	contig_1	309805	308563	1242	renamed_GCF_000008685.2	chromosome	309780	308538	1242	100.0	1.368e-269
UCT124H	contig_1	312740	311684	1056	renamed_GCF_000008685.2	chromosome	312715	311659	1056	100.0	1.239e-230
UCT124H	contig_1	314453	314171	282	renamed_GCF_000008685.2	chromosome	314427	314145	282	100.0	2.699e-59
UCT124H	contig_1	315340	314449	891	renamed_GCF_000008685.2	chromosome	315314	314423	891	99.6	9.9e-197
UCT124H	contig_1	317242	316165	1077	renamed_GCF_000008685.2	chromosome	317216	316139	1077	100.0	1.824e-238
UCT124H	contig_1	577295	577838	543	renamed_GCF_000008685.2	chromosome	577394	577937	543	100.0	3.121e-117
UCT124H	contig_1	604675	603631	1044	renamed_GCF_000008685.2	chromosome	604769	603725	1044	100.0	3.194e-235
UCT124H	contig_1	606889	604684	2205	renamed_GCF_000008685.2	chromosome	606983	604778	2205	100.0	0.0
UCT124H	contig_1	607043	607841	798	renamed_GCF_000008685.2	chromosome	607137	607935	798	100.0	9.72e-173
UCT124H	contig_1	609812	608966	846	renamed_GCF_000008685.2	chromosome	609906	609060	846	100.0	3.324e-184
UCT124H	contig_1	611099	609848	1251	renamed_GCF_000008685.2	chromosome	611193	609942	1251	99.0	8.508e-268
UCT124H	contig_1	611214	611928	714	renamed_GCF_000008685.2	chromosome	611308	612022	714	100.0	1.949e-159
UCT124H	contig_1	611953	613891	1938	renamed_GCF_000008685.2	chromosome	612047	613985	1938	100.0	0.0
UCT124H	contig_1	615677	613919	1758	renamed_GCF_000008685.2	chromosome	615771	614013	1758	99.8	0.0
UCT124H	contig_1	616296	615669	627	renamed_GCF_000008685.2	chromosome	616390	615763	627	100.0	5.736e-133
UCT124H	contig_1	631896	632388	492	renamed_GCF_000008685.2	chromosome	631990	632482	492	100.0	1.786e-106
UCT124H	contig_1	632390	634370	1980	renamed_GCF_000008685.2	chromosome	632484	634464	1980	100.0	0.0
UCT124H	contig_1	634486	635917	1431	renamed_GCF_000008685.2	chromosome	634580	636011	1431	98.3	9.218e-315
UCT124H	contig_1	636497	637862	1365	renamed_GCF_000008685.2	chromosome	636592	637957	1365	99.3	1.721e-296
UCT124H	contig_1	637867	638461	594	renamed_GCF_000008685.2	chromosome	637971	638556	594	100.0	1.47e-125
UCT124H	contig_1	638484	639777	1293	renamed_GCF_000008685.2	chromosome	638579	639872	1293	100.0	3.129e-286
UCT124H	contig_1	639745	642154	2409	renamed_GCF_000008685.2	chromosome	639858	642249	2409	99.8	0.0
UCT124H	contig_1	642193	642346	153	renamed_GCF_000008685.2	chromosome	642288	642441	153	98.0	2.814e-30
UCT124H	contig_1	643032	642405	627	renamed_GCF_000008685.2	chromosome	643126	642499	627	100.0	8.735e-137
UCT124H	contig_1	644556	643200	1356	renamed_GCF_000008685.2	chromosome	644650	643294	1356	99.7	7.88e-304
UCT124H	contig_1	658803	659529	726	renamed_GCF_000008685.2	chromosome	658897	659623	726	100.0	3.429e-155
UCT124H	contig_1	661421	659549	1872	renamed_GCF_000008685.2	chromosome	661515	659643	1872	100.0	0.0
UCT124H	contig_1	661511	662435	924	renamed_GCF_000008685.2	chromosome	661605	662529	924	99.0	2.789e-199
UCT124H	contig_1	662823	662508	315	renamed_GCF_000008685.2	chromosome	662917	662602	315	98.0	1.392e-63
UCT124H	contig_1	664920	663087	1833	renamed_GCF_000008685.2	chromosome	665011	663178	1833	99.5	0.0
UCT124H	contig_1	668426	664916	3510	renamed_GCF_000008685.2	chromosome	668517	665007	3510	99.3	0.0
UCT124H	contig_1	673120	671674	1446	renamed_GCF_000008685.2	chromosome	673167	671766	1446	99.3	4.469e-308
UCT124H	contig_1	673249	674686	1437	renamed_GCF_000008685.2	chromosome	673341	674778	1437	99.3	0.0
UCT124H	contig_1	674942	676286	1344	renamed_GCF_000008685.2	chromosome	675034	676378	1344	99.7	1.793e-292
UCT124H	contig_1	688401	690039	1638	renamed_GCF_000008685.2	chromosome	688489	690127	1638	100.0	0.0
UCT124H	contig_1	690104	690401	297	renamed_GCF_000008685.2	chromosome	690192	690489	297	100.0	1.037e-63
UCT124H	contig_1	690414	690711	297	renamed_GCF_000008685.2	chromosome	690481	690799	297	98.9	6.955e-60
UCT124H	contig_1	690795	692556	1761	renamed_GCF_000008685.2	chromosome	690884	692645	1761	99.8	0.0
UCT124H	contig_1	692539	693439	900	renamed_GCF_000008685.2	chromosome	692628	693528	900	100.0	8.957e-191
UCT124H	contig_1	693464	694607	1143	renamed_GCF_000008685.2	chromosome	693553	694696	1143	100.0	3.979e-258
UCT124H	contig_1	695434	694603	831	renamed_GCF_000008685.2	chromosome	695523	694692	831	99.6	6.41e-183
UCT124H	contig_1	695532	696666	1134	renamed_GCF_000008685.2	chromosome	695630	696764	1134	99.4	3.457e-258
UCT124H	contig_1	697339	696652	687	renamed_GCF_000008685.2	chromosome	697437	696750	687	98.6	7.971e-148
UCT124H	contig_1	783289	784921	1632	renamed_GCF_000008685.2	chromosome	783389	785021	1632	99.8	0.0
UCT124H	contig_1	784956	786654	1698	renamed_GCF_000008685.2	chromosome	785056	786754	1698	99.4	0.0
UCT124H	contig_1	786759	788862	2103	renamed_GCF_000008685.2	chromosome	786859	788962	2103	99.2	0.0
UCT124H	contig_1	789220	789838	618	renamed_GCF_000008685.2	chromosome	789302	789938	618	99.5	3.406e-137
UCT124H	contig_1	790707	789846	861	renamed_GCF_000008685.2	chromosome	790807	789946	861	100.0	1.57e-186
UCT124H	contig_1	791687	790706	981	renamed_GCF_000008685.2	chromosome	791787	790806	981	99.6	1.28e-217
UCT124H	contig_1	792152	791693	459	renamed_GCF_000008685.2	chromosome	792252	791793	459	100.0	5.068e-98
UCT124H	contig_1	792250	793525	1275	renamed_GCF_000008685.2	chromosome	792350	793625	1275	98.8	8.317e-281
UCT124H	contig_1	794755	793741	1014	renamed_GCF_000008685.2	chromosome	794855	793841	1014	100.0	1.719e-228
UCT124H	contig_1	797948	797018	930	renamed_GCF_000008685.2	chromosome	798048	797118	930	100.0	3.063e-199
UCT124H	contig_1	798916	797956	960	renamed_GCF_000008685.2	chromosome	799016	798056	960	99.6	2.967e-213
UCT124H	contig_1	800175	799107	1068	renamed_GCF_000008685.2	chromosome	800275	799207	1068	100.0	8.292e-246
UCT124H	contig_1	800375	800972	597	renamed_GCF_000008685.2	chromosome	800475	801072	597	100.0	2.836e-127
UCT124H	contig_1	800910	801678	768	renamed_GCF_000008685.2	chromosome	801118	801778	768	99.5	4.938e-141
UCT124H	contig_1	802699	801841	858	renamed_GCF_000008685.2	chromosome	802798	801940	858	100.0	3.462e-177
UCT124H	contig_1	803068	802738	330	renamed_GCF_000008685.2	chromosome	803167	802837	330	100.0	2.178e-69
UCT124H	contig_1	815212	814777	435	renamed_GCF_000008685.2	chromosome	815302	814867	435	100.0	4.611e-95
UCT124H	contig_1	816209	815411	798	renamed_GCF_000008685.2	chromosome	816299	815501	798	100.0	1.968e-173
UCT124H	contig_1	817112	816221	891	renamed_GCF_000008685.2	chromosome	817160	816311	891	98.9	5.573e-186
UCT124H	contig_1	817310	817871	561	renamed_GCF_000008685.2	chromosome	817395	817956	561	100.0	3.237e-128
UCT124H	contig_1	817932	818463	531	renamed_GCF_000008685.2	chromosome	818017	818548	531	100.0	1.403e-115
UCT124H	contig_1	818519	818831	312	renamed_GCF_000008685.2	chromosome	818604	818916	312	100.0	1.086e-65
UCT124H	contig_1	818836	819157	321	renamed_GCF_000008685.2	chromosome	819035	819242	321	98.5	2.552e-42
UCT124H	contig_1	819156	819402	246	renamed_GCF_000008685.2	chromosome	819241	819487	246	100.0	8.275e-50
UCT124H	contig_1	819456	820443	987	renamed_GCF_000008685.2	chromosome	819541	820528	987	99.6	2.594e-219
UCT124H	contig_1	820521	821103	582	renamed_GCF_000008685.2	chromosome	820606	821188	582	99.4	2.236e-127
UCT124H	contig_1	831478	830869	609	renamed_GCF_000008685.2	chromosome	831563	830954	609	100.0	7.938e-135
UCT124H	contig_1	835975	838441	2466	renamed_GCF_000008685.2	chromosome	836060	838526	2466	99.7	0.0
UCT124H	contig_1	838461	838995	534	renamed_GCF_000008685.2	chromosome	838546	839080	534	99.4	3.603e-114
UCT124H	contig_1	839158	841747	2589	renamed_GCF_000008685.2	chromosome	839243	841832	2589	100.0	0.0
UCT124H	contig_1	841748	842366	618	renamed_GCF_000008685.2	chromosome	841833	842451	618	99.0	1.532e-137
UCT124H	contig_1	842466	842904	438	renamed_GCF_000008685.2	chromosome	842500	842989	438	99.3	1.307e-92
UCT124H	contig_1	842917	844366	1449	renamed_GCF_000008685.2	chromosome	843002	844451	1449	100.0	7.712e-320
UCT124H	contig_1	844368	847017	2649	renamed_GCF_000008685.2	chromosome	844453	847102	2649	99.7	0.0
UCT124H	contig_1	847040	847403	363	renamed_GCF_000008685.2	chromosome	847125	847488	363	100.0	2.269e-74
UCT124H	contig_1	860354	861689	1335	renamed_GCF_000008685.2	chromosome	860439	861774	1335	99.3	2.053e-289
UCT124H	contig_1	862614	863562	948	renamed_GCF_000008685.2	chromosome	862698	863646	948	100.0	4.292e-207
UCT124H	contig_1	863551	864958	1407	renamed_GCF_000008685.2	chromosome	863635	865042	1407	99.5	1.411e-314
UCT124H	contig_1	864977	865835	858	renamed_GCF_000008685.2	chromosome	865052	865919	858	99.6	3.329e-186
UCT124H	contig_1	865831	866374	543	renamed_GCF_000008685.2	chromosome	865915	866458	543	98.8	6.309e-118
UCT124H	contig_1	866409	866610	201	renamed_GCF_000008685.2	chromosome	866493	866694	201	100.0	2.206e-40
UCT124H	contig_1	866596	867517	921	renamed_GCF_000008685.2	chromosome	866680	867601	921	99.6	6.858e-206
UCT124H	contig_1	868030	867658	372	renamed_GCF_000008685.2	chromosome	868114	867742	372	98.3	4.349e-77
UCT124H	contig_1	868110	868656	546	renamed_GCF_000008685.2	chromosome	868194	868740	546	99.4	2.031e-122
UCT124H	contig_1	890237	893090	2853	renamed_GCF_000008685.2	chromosome	890321	893174	2853	99.5	0.0
UCT124H	contig_1	893044	896485	3441	renamed_GCF_000008685.2	chromosome	893128	896569	3441	99.8	0.0
UCT124H	contig_1	897043	896494	549	renamed_GCF_000008685.2	chromosome	897127	896578	549	100.0	1.159e-120
UCT124H	contig_2	30668	31739	1071	renamed_GCF_000008685.2	lp54	30709	31780	1071	99.7	2.403e-234
UCT124H	contig_2	32219	32708	489	renamed_GCF_000008685.2	lp54	32260	32749	489	100.0	3.125e-108
UCT124H	contig_2	43491	42582	909	renamed_GCF_000008685.2	lp54	43532	42623	909	99.3	1.196e-197
UCT124H	contig_2	45918	44682	1236	renamed_GCF_000008685.2	lp54	45947	44711	1236	99.0	3.997e-265
UCT124H	contig_2	48238	47446	792	renamed_GCF_000008685.2	lp54	48267	47475	792	100.0	4.37e-172
UCT124H	contig_2	51001	50110	891	renamed_GCF_000008685.2	lp54	51176	50285	891	99.3	2.004e-197
UCT124H	contig_3	12592	12001	591	renamed_GCF_000008685.2	lp38	12452	11861	591	99.4	7.931e-132
UCT124H	contig_3	16647	17457	810	renamed_GCF_000008685.2	lp38	16519	17329	810	98.1	3.988e-176
UCT124H	contig_4	28314	27408	906	renamed_GCF_000008685.2	lp36	28288	27382	906	99.6	2.782e-196
UCT124H	contig_4	30489	29502	987	renamed_GCF_000008685.2	lp36	30463	29476	987	100.0	5.255e-220
UCT124H	contig_5	5976	5406	570	renamed_GCF_000008685.2	cp32-6	6160	6730	570	97.8	6.014e-123
UCT124H	contig_5	6733	6349	384	renamed_GCF_000008685.2	cp32-6	5403	5787	384	100.0	2.931e-83
UCT124H	contig_5	8167	7207	960	renamed_GCF_000008685.2	cp32-1	3962	4922	960	100.0	6.593e-213
UCT124H	contig_5	10119	9561	558	renamed_GCF_000008685.2	cp32-7	2009	2567	558	100.0	1.105e-122
UCT124H	contig_5	12064	10840	1224	renamed_GCF_000008685.2	cp32-7	64	1288	1224	100.0	2.096e-270
UCT124H	contig_5	25777	25330	447	renamed_GCF_000008685.2	cp32-8	17204	17651	447	100.0	1.879e-98
UCT124H	contig_5	26895	26541	354	renamed_GCF_000008685.2	cp32-6	16102	16456	354	100.0	1.459e-77
UCT124H	contig_7	1792	1438	354	renamed_GCF_000008685.2	cp32-7	16093	16447	354	100.0	1.459e-77
UCT124H	contig_7	2120	1784	336	renamed_GCF_000008685.2	lp56	19256	19592	336	100.0	5.348e-69
UCT124H	contig_7	3555	2739	816	renamed_GCF_000008685.2	cp32-8	14323	15139	816	100.0	1.636e-178
UCT124H	contig_7	5054	4175	879	renamed_GCF_000008685.2	cp32-7	12831	13710	879	100.0	2.903e-191
UCT124H	contig_7	5958	5412	546	renamed_GCF_000008685.2	cp32-7	11927	12473	546	100.0	8.009e-116
UCT124H	contig_7	8916	7581	1335	renamed_GCF_000008685.2	cp32-7	8969	10304	1335	100.0	9.244e-290
UCT124H	contig_7	25406	24080	1326	renamed_GCF_000008685.2	cp32-1	23230	24556	1326	100.0	7.132e-300
UCT124H	contig_7	27076	26518	558	renamed_GCF_000008685.2	cp32-1	21560	22118	558	100.0	2.975e-120
UCT124H	contig_7	28413	27846	567	renamed_GCF_000008685.2	cp32-1	20223	20790	567	100.0	2.944e-130
UCT124H	contig_8	22460	23027	567	renamed_GCF_000008685.2	cp32-4	28383	28950	567	94.6	2.258e-116
UCT124H	contig_8	24441	25665	1224	renamed_GCF_000008685.2	cp32-4	65	1289	1224	99.5	2.298e-269
UCT124H	contig_8	26955	27723	768	renamed_GCF_000008685.2	cp32-4	2579	3347	768	99.2	1.626e-170
UCT124H	contig_8	28348	29308	960	renamed_GCF_000008685.2	cp32-4	3972	4932	960	100.0	6.008e-214
UCT124H	contig_8	29782	30166	384	renamed_GCF_000008685.2	cp32-9	5412	5796	384	100.0	2.931e-83
UCT124H	contig_9	13501	13705	204	renamed_GCF_000008685.2	cp32-1	15214	15418	204	100.0	2.578e-39
UCT124H	contig_9	14875	15193	318	renamed_GCF_000008685.2	cp32-3	16585	16903	318	100.0	2.414e-66
UCT124H	contig_10	5926	6694	768	renamed_GCF_000008685.2	lp28-2	5910	6678	768	100.0	2.365e-166
UCT124H	contig_10	25994	26405	411	renamed_GCF_000008685.2	lp28-2	25979	26390	411	99.2	4.62e-91
UCT124H	contig_10	26671	27100	429	renamed_GCF_000008685.2	lp28-2	26569	27085	429	99.2	9.316e-95
UCT124H	contig_10	27127	27955	828	renamed_GCF_000008685.2	lp28-2	27112	27940	828	100.0	3.316e-181
UCT124H	contig_10	28045	28846	801	renamed_GCF_000008685.2	lp28-2	28030	28831	801	100.0	3.29e-168
UCT124H	contig_10	29633	28868	765	renamed_GCF_000008685.2	lp28-2	29618	28853	765	100.0	1.703e-169
UCT124H	contig_11	19377	18708	669	renamed_GCF_000008685.2	cp32-6	22101	22770	669	100.0	2.138e-142
UCT124H	contig_11	26248	26044	204	renamed_GCF_000008685.2	cp32-7	15221	15425	204	100.0	2.578e-39
UCT124H	contig_11	27751	27145	606	renamed_GCF_000008685.2	cp32-8	13708	14314	606	100.0	5.47e-130
UCT124H	contig_11	28965	28632	333	renamed_GCF_000008685.2	cp32-7	12502	12835	333	100.0	1.876e-71
UCT124H	contig_12	1597	2170	573	renamed_GCF_000008685.2	lp28-3	28197	27624	573	100.0	5.735e-124
UCT124H	contig_13	26676	26472	204	renamed_GCF_000008685.2	lp56	18712	18916	204	100.0	2.578e-39
UCT124H	contig_13	29067	28191	876	renamed_GCF_000008685.2	cp32-3	12823	13699	876	99.6	6.156e-191
UCT124H	contig_14	1280	350	930	renamed_GCF_000008685.2	cp26	7835	8765	930	100.0	7.897e-206
UCT124H	contig_14	4676	4358	318	renamed_GCF_000008685.2	cp26	4481	4757	318	100.0	7.253e-55
UCT124H	contig_15	23325	22191	1134	renamed_GCF_000008685.2	lp28-3	27445	26977	1134	98.5	1.339e-87
UCT124H	contig_16	21	264	243	renamed_GCF_000008685.2	lp28-4	26036	25793	243	100.0	2.599e-53
UCT124H	contig_1	121831	121108	723	renamed_GCF_000008685.2	chromosome	121823	121100	723	99.5	4.138e-161
UCT124H	contig_1	124154	122498	1656	renamed_GCF_000008685.2	chromosome	124146	122490	1656	99.8	0.0
UCT124H	contig_1	125555	124805	750	renamed_GCF_000008685.2	chromosome	125547	124797	750	99.1	1.407e-160
UCT124H	contig_1	127421	126323	1098	renamed_GCF_000008685.2	chromosome	127413	126315	1098	100.0	1.369e-236
UCT124H	contig_1	131122	130177	945	renamed_GCF_000008685.2	chromosome	131114	130169	945	100.0	6.888e-210
UCT124H	contig_1	133850	132479	1371	renamed_GCF_000008685.2	chromosome	133842	132471	1371	100.0	2.422e-302
UCT124H	contig_1	137774	135881	1893	renamed_GCF_000008685.2	chromosome	137766	135873	1893	100.0	0.0
UCT124H	contig_1	144276	142953	1323	renamed_GCF_000008685.2	chromosome	144230	142943	1323	99.7	1.75e-280
UCT124H	contig_1	145468	144595	873	renamed_GCF_000008685.2	chromosome	145458	144585	873	98.9	1.511e-197
UCT124H	contig_1	201077	199991	1086	renamed_GCF_000008685.2	chromosome	201050	199964	1086	99.4	6.528e-243
UCT124H	contig_1	202876	204115	1239	renamed_GCF_000008685.2	chromosome	202849	204088	1239	100.0	5.514e-262
UCT124H	contig_1	205099	206071	972	renamed_GCF_000008685.2	chromosome	205174	206044	972	99.6	3.289e-188
UCT124H	contig_1	208646	208109	537	renamed_GCF_000008685.2	chromosome	208581	208083	537	99.3	7.373e-107
UCT124H	contig_1	223204	223987	783	renamed_GCF_000008685.2	chromosome	223178	223961	783	99.2	8.433e-172
UCT124H	contig_1	226636	224851	1785	renamed_GCF_000008685.2	chromosome	226610	224825	1785	99.6	0.0
UCT124H	contig_1	228547	227839	708	renamed_GCF_000008685.2	chromosome	228521	227813	708	100.0	8.763e-159
UCT124H	contig_1	231517	230239	1278	renamed_GCF_000008685.2	chromosome	231491	230213	1278	99.7	4.58e-288
UCT124H	contig_1	244739	243968	771	renamed_GCF_000008685.2	chromosome	244713	243942	771	100.0	4.161e-169
UCT124H	contig_1	285985	283894	2091	renamed_GCF_000008685.2	chromosome	285962	283868	2091	99.8	0.0
UCT124H	contig_1	287903	287114	789	renamed_GCF_000008685.2	chromosome	287877	287088	789	98.8	2.148e-162
UCT124H	contig_1	288972	288207	765	renamed_GCF_000008685.2	chromosome	288946	288181	765	99.6	5.507e-165
UCT124H	contig_1	289943	289601	342	renamed_GCF_000008685.2	chromosome	289917	289575	342	100.0	1.077e-70
UCT124H	contig_1	299741	298820	921	renamed_GCF_000008685.2	chromosome	299715	298794	921	98.6	5.59e-191
UCT124H	contig_1	302515	300805	1710	renamed_GCF_000008685.2	chromosome	302489	300779	1710	100.0	0.0
UCT124H	contig_1	303335	302876	459	renamed_GCF_000008685.2	chromosome	303309	302850	459	100.0	4.601e-99
UCT124H	contig_1	305146	303799	1347	renamed_GCF_000008685.2	chromosome	305120	303773	1347	100.0	1.016e-290
UCT124H	contig_1	306643	305695	948	renamed_GCF_000008685.2	chromosome	306615	305670	948	99.0	1.931e-207
UCT124H	contig_1	318031	317272	759	renamed_GCF_000008685.2	chromosome	318005	317246	759	100.0	1.223e-163
UCT124H	contig_1	368910	370053	1143	renamed_GCF_000008685.2	chromosome	368884	370027	1143	100.0	3.212e-243
UCT124H	contig_1	371059	373072	2013	renamed_GCF_000008685.2	chromosome	371033	373046	2013	100.0	0.0
UCT124H	contig_1	374177	373592	585	renamed_GCF_000008685.2	chromosome	374151	373566	585	99.4	4.312e-129
UCT124H	contig_1	375686	375965	279	renamed_GCF_000008685.2	chromosome	375660	375939	279	100.0	3.143e-57
UCT124H	contig_1	379356	377064	2292	renamed_GCF_000008685.2	chromosome	379258	377038	2292	99.8	0.0
UCT124H	contig_1	381918	380580	1338	renamed_GCF_000008685.2	chromosome	381892	380554	1338	99.5	6.95e-311
UCT124H	contig_1	384188	383420	768	renamed_GCF_000008685.2	chromosome	384162	383394	768	99.6	9.689e-168
UCT124H	contig_1	396532	395506	1026	renamed_GCF_000008685.2	chromosome	396506	395480	1026	100.0	3.003e-224
UCT124H	contig_1	454500	452067	2433	renamed_GCF_000008685.2	chromosome	454472	452039	2433	100.0	0.0
UCT124H	contig_1	456603	458064	1461	renamed_GCF_000008685.2	chromosome	456575	458036	1461	99.3	0.0
UCT124H	contig_1	459552	459852	300	renamed_GCF_000008685.2	chromosome	459524	459824	300	100.0	7.304e-60
UCT124H	contig_1	471784	471250	534	renamed_GCF_000008685.2	chromosome	471756	471222	534	99.4	1.961e-112
UCT124H	contig_1	472593	473436	843	renamed_GCF_000008685.2	chromosome	472565	473408	843	100.0	5.328e-187
UCT124H	contig_1	474640	475630	990	renamed_GCF_000008685.2	chromosome	474612	475602	990	99.6	8.752e-215
UCT124H	contig_1	478102	476290	1812	renamed_GCF_000008685.2	chromosome	478005	476262	1812	99.3	0.0
UCT124H	contig_1	482082	481368	714	renamed_GCF_000008685.2	chromosome	482057	481343	714	100.0	3.944e-160
UCT124H	contig_1	484311	484611	300	renamed_GCF_000008685.2	chromosome	484286	484586	300	100.0	5.976e-62
UCT124H	contig_1	485574	486102	528	renamed_GCF_000008685.2	chromosome	485549	486077	528	100.0	1.004e-118
UCT124H	contig_1	486741	487563	822	renamed_GCF_000008685.2	chromosome	486746	487538	822	99.6	9.243e-169
UCT124H	contig_1	488250	488997	747	renamed_GCF_000008685.2	chromosome	488225	488972	747	99.1	4.558e-164
UCT124H	contig_1	498237	499071	834	renamed_GCF_000008685.2	chromosome	498212	499046	834	100.0	1.895e-188
UCT124H	contig_1	499365	499728	363	renamed_GCF_000008685.2	chromosome	499340	499703	363	100.0	3.407e-78
UCT124H	contig_1	500617	501034	417	renamed_GCF_000008685.2	chromosome	500592	501009	417	100.0	2.778e-89
UCT124H	contig_1	501239	501494	255	renamed_GCF_000008685.2	chromosome	501214	501469	255	100.0	1.745e-51
UCT124H	contig_1	501904	502210	306	renamed_GCF_000008685.2	chromosome	501879	502185	306	100.0	2.959e-62
UCT124H	contig_1	507430	507823	393	renamed_GCF_000008685.2	chromosome	507405	507798	393	100.0	3.073e-84
UCT124H	contig_1	508894	509266	372	renamed_GCF_000008685.2	chromosome	508869	509241	372	100.0	8.775e-78
UCT124H	contig_1	561027	560628	399	renamed_GCF_000008685.2	chromosome	561127	560728	399	100.0	7.535e-84
UCT124H	contig_1	561864	561462	402	renamed_GCF_000008685.2	chromosome	561943	561562	402	99.2	7.039e-77
UCT124H	contig_1	567710	568184	474	renamed_GCF_000008685.2	chromosome	567809	568277	474	100.0	2.168e-101
UCT124H	contig_1	578177	580322	2145	renamed_GCF_000008685.2	chromosome	578276	580421	2145	99.7	0.0
UCT124H	contig_1	581545	583318	1773	renamed_GCF_000008685.2	chromosome	581644	583417	1773	100.0	0.0
UCT124H	contig_1	584781	584091	690	renamed_GCF_000008685.2	chromosome	584880	584190	690	100.0	9.609e-155
UCT124H	contig_1	587966	589568	1602	renamed_GCF_000008685.2	chromosome	588065	589667	1602	99.8	0.0
UCT124H	contig_1	590248	590836	588	renamed_GCF_000008685.2	chromosome	590347	590935	588	100.0	4.112e-130
UCT124H	contig_1	648458	649013	555	renamed_GCF_000008685.2	chromosome	648552	649107	555	100.0	3.12e-119
UCT124H	contig_1	653696	650318	3378	renamed_GCF_000008685.2	chromosome	653790	650412	3378	99.9	0.0
UCT124H	contig_1	654714	656808	2094	renamed_GCF_000008685.2	chromosome	654862	656902	2094	99.7	0.0
UCT124H	contig_1	676384	677773	1389	renamed_GCF_000008685.2	chromosome	676471	677860	1389	100.0	1.442e-302
UCT124H	contig_1	679662	678870	792	renamed_GCF_000008685.2	chromosome	679750	678958	792	99.2	3.782e-165
UCT124H	contig_1	681518	680474	1044	renamed_GCF_000008685.2	chromosome	681606	680562	1044	100.0	8.539e-233
UCT124H	contig_1	682590	683289	699	renamed_GCF_000008685.2	chromosome	682678	683377	699	100.0	1.337e-152
UCT124H	contig_1	685892	684908	984	renamed_GCF_000008685.2	chromosome	685980	684996	984	100.0	1.708e-223
UCT124H	contig_1	697487	698234	747	renamed_GCF_000008685.2	chromosome	697585	698332	747	100.0	1.547e-167
UCT124H	contig_1	700826	699953	873	renamed_GCF_000008685.2	chromosome	700924	700051	873	99.6	6.447e-190
UCT124H	contig_1	724030	722962	1068	renamed_GCF_000008685.2	chromosome	724130	723062	1068	100.0	3.402e-247
UCT124H	contig_1	725330	726395	1065	renamed_GCF_000008685.2	chromosome	725430	726495	1065	100.0	4.042e-236
UCT124H	contig_1	727636	728575	939	renamed_GCF_000008685.2	chromosome	727736	728675	939	100.0	1.678e-207
UCT124H	contig_1	729512	730406	894	renamed_GCF_000008685.2	chromosome	729612	730506	894	99.3	2.777e-194
UCT124H	contig_1	731083	731620	537	renamed_GCF_000008685.2	chromosome	731183	731720	537	100.0	1.936e-121
UCT124H	contig_1	731693	733703	2010	renamed_GCF_000008685.2	chromosome	731793	733803	2010	99.8	0.0
UCT124H	contig_1	735250	736585	1335	renamed_GCF_000008685.2	chromosome	735351	736686	1335	99.7	2.962e-285
UCT124H	contig_1	736858	737107	249	renamed_GCF_000008685.2	chromosome	736959	737208	249	100.0	2.148e-48
UCT124H	contig_1	737607	738327	720	renamed_GCF_000008685.2	chromosome	737708	738428	720	100.0	9.639e-160
UCT124H	contig_1	739042	739582	540	renamed_GCF_000008685.2	chromosome	739143	739683	540	100.0	2.458e-119
UCT124H	contig_2	7171	8206	1035	renamed_GCF_000008685.2	lp54	7208	8243	1035	100.0	8.138e-232
UCT124H	contig_2	8404	8830	426	renamed_GCF_000008685.2	lp54	8441	8867	426	100.0	3.21e-89
UCT124H	contig_2	18115	18709	594	renamed_GCF_000008685.2	lp54	18127	18721	594	98.9	7.995e-124
UCT124H	contig_2	20683	20878	195	renamed_GCF_000008685.2	lp54	20717	20912	195	100.0	2.214e-39
UCT124H	contig_2	23239	21649	1590	renamed_GCF_000008685.2	lp54	23273	21683	1590	100.0	0.0
UCT124H	contig_2	24466	25072	606	renamed_GCF_000008685.2	lp54	24497	25103	606	98.0	1.777e-125
UCT124H	contig_2	34343	34907	564	renamed_GCF_000008685.2	lp54	34384	34948	564	99.4	3.599e-119
UCT124H	contig_2	35912	36188	276	renamed_GCF_000008685.2	lp54	35953	36229	276	100.0	3.31e-56
UCT124H	contig_3	34815	34518	297	renamed_GCF_000008685.2	lp38	34668	34371	297	100.0	2.824e-61
UCT124H	contig_3	36395	35780	615	renamed_GCF_000008685.2	lp38	36248	35633	615	100.0	2.836e-130
UCT124H	contig_3	38476	37561	915	renamed_GCF_000008685.2	lp28-1	26996	28073	915	40.3	1.326e-33
UCT124H	contig_4	15818	14891	927	renamed_GCF_000008685.2	lp36	15760	14833	927	100.0	2.815e-208
UCT124H	contig_4	17438	17642	204	renamed_GCF_000008685.2	lp36	17379	17583	204	100.0	8.441e-43
UCT124H	contig_5	29273	28667	606	renamed_GCF_000008685.2	cp32-7	13715	14321	606	100.0	1.216e-129
UCT124H	contig_6	873	519	354	renamed_GCF_000008685.2	cp32-8	16086	16440	354	100.0	1.459e-77
UCT124H	contig_6	1538	1181	357	renamed_GCF_000008685.2	cp32-7	15428	15785	357	100.0	8.381e-76
UCT124H	contig_6	2636	1820	816	renamed_GCF_000008685.2	cp32-1	14323	15139	816	100.0	1.636e-178
UCT124H	contig_6	6650	6008	642	renamed_GCF_000008685.2	cp32-7	10316	10958	642	100.0	3.749e-140
UCT124H	contig_7	12119	11729	390	renamed_GCF_000008685.2	cp32-7	5766	6156	390	100.0	1.451e-83
UCT124H	contig_7	12490	12106	384	renamed_GCF_000008685.2	cp32-7	5395	5779	384	100.0	2.931e-83
UCT124H	contig_7	13924	12964	960	renamed_GCF_000008685.2	cp32-7	3961	4921	960	100.0	6.593e-213
UCT124H	contig_7	15312	14547	765	renamed_GCF_000008685.2	cp32-7	2573	3338	765	99.6	3.139e-171
UCT124H	contig_7	15876	15318	558	renamed_GCF_000008685.2	cp32-3	2010	2568	558	100.0	1.105e-122
UCT124H	contig_7	16581	15888	693	renamed_GCF_000008685.2	cp32-1	1305	1998	693	100.0	2.582e-144
UCT124H	contig_7	17821	16597	1224	renamed_GCF_000008685.2	cp32-6	65	1289	1224	100.0	2.096e-270
UCT124H	contig_7	19239	17886	1353	renamed_GCF_000008685.2	cp32-6	28485	29838	1353	99.7	1.39e-305
UCT124H	contig_8	11181	11604	423	renamed_GCF_000008685.2	cp32-4	17102	17525	423	100.0	4.616e-93
UCT124H	contig_8	12662	11651	1011	renamed_GCF_000008685.2	cp32-4	18583	17572	1011	99.7	3.027e-230
UCT124H	contig_8	14145	14712	567	renamed_GCF_000008685.2	cp32-4	20066	20633	567	100.0	2.944e-130
UCT124H	contig_8	14687	15443	756	renamed_GCF_000008685.2	cp32-4	20608	21364	756	100.0	8.022e-168
UCT124H	contig_9	3681	4065	384	renamed_GCF_000008685.2	cp32-1	5396	5780	384	100.0	2.931e-83
UCT124H	contig_9	4052	4442	390	renamed_GCF_000008685.2	cp32-9	5783	6173	390	100.0	3.229e-83
UCT124H	contig_9	4985	6098	1113	renamed_GCF_000008685.2	cp32-1	6700	7813	1113	99.4	3.394e-246
UCT124H	contig_10	18035	17696	339	renamed_GCF_000008685.2	lp28-2	18019	17680	339	100.0	5.085e-70
UCT124H	contig_10	19635	18852	783	renamed_GCF_000008685.2	lp28-2	19619	18836	783	100.0	1.354e-183
UCT124H	contig_10	22675	22288	387	renamed_GCF_000008685.2	lp28-2	22659	22272	387	100.0	4.63e-87
UCT124H	contig_10	23741	23048	693	renamed_GCF_000008685.2	lp28-2	23725	23032	693	100.0	4.125e-156
UCT124H	contig_13	12243	11019	1224	renamed_GCF_000008685.2	cp32-1	65	1289	1224	100.0	2.096e-270
UCT124H	contig_13	14933	14405	528	renamed_GCF_000008685.2	cp32-4	27675	28203	528	90.2	1.565e-105
UCT124H	contig_13	18784	17458	1326	renamed_GCF_000008685.2	cp32-7	23134	24460	1326	100.0	1.445e-300
UCT124H	contig_13	20364	19842	522	renamed_GCF_000008685.2	cp32-7	21521	22076	522	100.0	1.473e-113
UCT124H	contig_13	21695	21128	567	renamed_GCF_000008685.2	cp32-7	20223	20790	567	100.0	6.547e-130
UCT124H	contig_14	5032	4684	348	renamed_GCF_000008685.2	cp26	4083	4431	348	99.1	2.393e-71
UCT124H	contig_14	6929	8279	1350	renamed_GCF_000008685.2	cp26	2186	836	1350	100.0	7.868e-303
UCT124H	contig_14	9070	8791	279	renamed_GCF_000008685.2	cp26	45	324	279	100.0	2.323e-60
UCT124H	contig_14	12359	11114	1245	renamed_GCF_000008685.2	cp26	23254	24499	1245	99.7	5.213e-281
UCT124H	contig_16	3126	3963	837	renamed_GCF_000008685.2	lp28-4	22931	22094	837	98.9	3.479e-182
UCT124H	contig_16	5947	6442	495	renamed_GCF_000008685.2	lp56	3622	4108	495	64.8	4.52e-55
UCT124H	contig_16	10700	9521	1179	renamed_GCF_000008685.2	lp28-4	15351	16530	1179	100.0	4.972e-253
UCT124H	contig_17	10280	9659	621	renamed_GCF_000008685.2	lp25	10187	9566	621	99.5	6.572e-139
UCT124H	contig_17	12173	11591	582	renamed_GCF_000008685.2	lp25	12079	11497	582	100.0	4.521e-128
UCT124H	contig_19	8293	8860	567	renamed_GCF_000008685.2	cp32-9	20274	20841	567	98.9	1.762e-127
UCT124H	contig_20	6202	6529	327	renamed_GCF_000008685.2	lp17	7784	8111	327	99.0	2.291e-68
UCT124H	contig_20	8305	8008	297	renamed_GCF_000008685.2	lp17	9980	9590	297	100.0	9.385e-65
UCT124H	contig_20	11560	12301	741	renamed_GCF_000008685.2	lp17	13338	14079	741	100.0	7.64e-166
UCT124H	contig_20	17953	17683	270	renamed_GCF_000008685.2	lp17	14069	14339	270	100.0	1.489e-55
UCT124H	contig_21	49	784	735	renamed_GCF_000008685.2	chromosome	900798	901782	735	100.0	3.773e-164
UCT124H	contig_21	3870	2931	939	renamed_GCF_000008685.2	chromosome	904900	903928	939	99.0	7.831e-199
UCT124H	contig_22	743	1268	525	renamed_GCF_000008685.2	cp9	4377	3852	525	100.0	1.87e-111
UCT124H	contig_22	3229	2668	561	renamed_GCF_000008685.2	cp9	1891	2452	561	100.0	2.578e-122
UCT124H	contig_22	4958	3848	1110	renamed_GCF_000008685.2	cp9	162	1272	1110	100.0	8.376e-253
UCT124H	contig_22	7533	6735	798	renamed_GCF_000008685.2	cp9	6973	7771	798	100.0	6.09e-178
UCT124H	contig_1	1809	780	1029	renamed_GCF_000008685.2	chromosome	1796	767	1029	100.0	4.829e-228
UCT124H	contig_1	3408	5202	1794	renamed_GCF_000008685.2	chromosome	3418	5188	1794	99.6	0.0
UCT124H	contig_1	6320	5264	1056	renamed_GCF_000008685.2	chromosome	6306	5250	1056	99.4	3.853e-235
UCT124H	contig_1	7411	6322	1089	renamed_GCF_000008685.2	chromosome	7397	6308	1089	100.0	1.828e-240
UCT124H	contig_1	8329	7471	858	renamed_GCF_000008685.2	chromosome	8315	7457	858	100.0	6.472e-196
UCT124H	contig_1	8440	9211	771	renamed_GCF_000008685.2	chromosome	8426	9197	771	100.0	1.781e-161
UCT124H	contig_1	9215	10220	1005	renamed_GCF_000008685.2	chromosome	9201	10206	1005	99.7	3.77e-218
UCT124H	contig_1	10216	10591	375	renamed_GCF_000008685.2	chromosome	10202	10577	375	100.0	3.75e-79
UCT124H	contig_1	42896	42494	402	renamed_GCF_000008685.2	chromosome	42881	42479	402	100.0	2.405e-88
UCT124H	contig_1	45460	46006	546	renamed_GCF_000008685.2	chromosome	45445	45991	546	99.4	7.28e-117
UCT124H	contig_1	47181	47856	675	renamed_GCF_000008685.2	chromosome	47166	47841	675	99.5	4.326e-144
UCT124H	contig_1	47919	48621	702	renamed_GCF_000008685.2	chromosome	47916	48606	702	99.5	4.987e-147
UCT124H	contig_1	49355	50027	672	renamed_GCF_000008685.2	chromosome	49340	50012	672	100.0	9.591e-152
UCT124H	contig_1	50489	50126	363	renamed_GCF_000008685.2	chromosome	50474	50111	363	100.0	4.578e-75
UCT124H	contig_1	52449	51267	1182	renamed_GCF_000008685.2	chromosome	52434	51252	1182	99.7	3.289e-258
UCT124H	contig_1	53476	52468	1008	renamed_GCF_000008685.2	chromosome	53461	52453	1008	100.0	6.65e-221
UCT124H	contig_1	56295	55515	780	renamed_GCF_000008685.2	chromosome	56280	55500	780	99.6	1.628e-172
UCT124H	contig_1	57200	56846	354	renamed_GCF_000008685.2	chromosome	57185	56831	354	99.1	6.554e-78
UCT124H	contig_1	80992	81418	426	renamed_GCF_000008685.2	chromosome	80982	81408	426	98.5	2.913e-90
UCT124H	contig_1	83930	82979	951	renamed_GCF_000008685.2	chromosome	83920	82969	951	99.6	3.736e-209
UCT124H	contig_1	86864	85889	975	renamed_GCF_000008685.2	chromosome	86854	85879	975	100.0	4.354e-220
UCT124H	contig_1	91125	89820	1305	renamed_GCF_000008685.2	chromosome	91115	89810	1305	100.0	2.863e-289
UCT124H	contig_1	103780	103024	756	renamed_GCF_000008685.2	chromosome	103771	103015	756	99.6	2.151e-165
UCT124H	contig_1	105855	105426	429	renamed_GCF_000008685.2	chromosome	105846	105417	429	98.5	1.668e-88
UCT124H	contig_1	108179	106982	1197	renamed_GCF_000008685.2	chromosome	108170	106973	1197	99.2	1.011e-256
UCT124H	contig_1	111051	109683	1368	renamed_GCF_000008685.2	chromosome	111042	109674	1368	100.0	1.976e-295
UCT124H	contig_1	111883	111592	291	renamed_GCF_000008685.2	chromosome	111875	111584	291	98.9	9.399e-64
UCT124H	contig_1	169548	170718	1170	renamed_GCF_000008685.2	chromosome	169562	170708	1170	99.7	6.062e-258
UCT124H	contig_1	171260	171494	234	renamed_GCF_000008685.2	chromosome	171262	171484	234	98.6	1.134e-44
UCT124H	contig_1	174126	173538	588	renamed_GCF_000008685.2	chromosome	174116	173528	588	98.4	9.145e-130
UCT124H	contig_1	177863	176987	876	renamed_GCF_000008685.2	chromosome	177853	176977	876	100.0	9.427e-195
UCT124H	contig_1	178870	177877	993	renamed_GCF_000008685.2	chromosome	178860	177867	993	100.0	4.528e-214
UCT124H	contig_1	189869	189308	561	renamed_GCF_000008685.2	chromosome	189859	189298	561	99.4	2.836e-121
UCT124H	contig_1	190728	191469	741	renamed_GCF_000008685.2	chromosome	190718	191459	741	99.5	3.597e-157
UCT124H	contig_1	193473	192333	1140	renamed_GCF_000008685.2	chromosome	193463	192323	1140	99.7	9.252e-257
UCT124H	contig_1	240276	239169	1107	renamed_GCF_000008685.2	chromosome	240250	239143	1107	99.7	3.718e-244
UCT124H	contig_1	242463	244029	1566	renamed_GCF_000008685.2	chromosome	242437	244003	1566	99.0	0.0
UCT124H	contig_1	255671	256286	615	renamed_GCF_000008685.2	chromosome	255645	256260	615	100.0	1.16e-131
UCT124H	contig_1	264013	266140	2127	renamed_GCF_000008685.2	chromosome	263987	266114	2127	99.2	0.0
UCT124H	contig_1	267091	267301	210	renamed_GCF_000008685.2	chromosome	267065	267275	210	100.0	4.647e-42
UCT124H	contig_1	270499	269698	801	renamed_GCF_000008685.2	chromosome	270473	269672	801	100.0	6.66e-169
UCT124H	contig_1	292452	291669	783	renamed_GCF_000008685.2	chromosome	292426	291643	783	100.0	1.874e-171
UCT124H	contig_1	293455	293230	225	renamed_GCF_000008685.2	chromosome	293429	293204	225	100.0	8.8e-46
UCT124H	contig_1	296446	295267	1179	renamed_GCF_000008685.2	chromosome	296420	295241	1179	100.0	1.072e-261
UCT124H	contig_1	333624	330828	2796	renamed_GCF_000008685.2	chromosome	333598	330802	2796	99.8	0.0
UCT124H	contig_1	334541	333644	897	renamed_GCF_000008685.2	chromosome	334515	333618	897	100.0	1.666e-200
UCT124H	contig_1	334962	336534	1572	renamed_GCF_000008685.2	chromosome	334936	336508	1572	99.6	0.0
UCT124H	contig_1	338383	340009	1626	renamed_GCF_000008685.2	chromosome	338357	339983	1626	99.8	0.0
UCT124H	contig_1	340366	341287	921	renamed_GCF_000008685.2	chromosome	340340	341261	921	100.0	2.92e-198
UCT124H	contig_1	351357	351081	276	renamed_GCF_000008685.2	chromosome	351331	351055	276	100.0	8.162e-55
UCT124H	contig_1	353466	351366	2100	renamed_GCF_000008685.2	chromosome	353437	351340	2100	99.5	0.0
UCT124H	contig_1	354662	353465	1197	renamed_GCF_000008685.2	chromosome	354636	353439	1197	99.7	2.622e-263
UCT124H	contig_1	355324	354673	651	renamed_GCF_000008685.2	chromosome	355298	354647	651	100.0	1.769e-141
UCT124H	contig_1	388506	387843	663	renamed_GCF_000008685.2	chromosome	388480	387817	663	100.0	4.965e-149
UCT124H	contig_1	388952	388532	420	renamed_GCF_000008685.2	chromosome	388926	388506	420	100.0	9.787e-93
UCT124H	contig_1	390367	389002	1365	renamed_GCF_000008685.2	chromosome	390341	388976	1365	99.5	7.255e-289
UCT124H	contig_1	391845	390420	1425	renamed_GCF_000008685.2	chromosome	391819	390391	1425	99.7	0.0
UCT124H	contig_1	392983	391957	1026	renamed_GCF_000008685.2	chromosome	392957	391931	1026	99.4	3.003e-224
UCT124H	contig_1	394089	393069	1020	renamed_GCF_000008685.2	chromosome	394063	393043	1020	99.7	1.481e-222
UCT124H	contig_1	407924	407369	555	renamed_GCF_000008685.2	chromosome	407898	407343	555	100.0	5.734e-121
UCT124H	contig_1	408406	408226	180	renamed_GCF_000008685.2	chromosome	408380	408200	180	100.0	2.118e-37
UCT124H	contig_1	409428	408579	849	renamed_GCF_000008685.2	chromosome	409402	408553	849	100.0	9.834e-190
UCT124H	contig_1	410473	409441	1032	renamed_GCF_000008685.2	chromosome	410447	409415	1032	100.0	9.895e-238
UCT124H	contig_1	435131	430646	4485	renamed_GCF_000008685.2	chromosome	435103	430618	4485	99.8	0.0
UCT124H	contig_1	442580	441740	840	renamed_GCF_000008685.2	chromosome	442552	441712	840	100.0	1.361e-184
UCT124H	contig_1	443276	442715	561	renamed_GCF_000008685.2	chromosome	443248	442687	561	100.0	1.054e-123
UCT124H	contig_1	446903	446354	549	renamed_GCF_000008685.2	chromosome	446875	446326	549	99.4	4.738e-122
UCT124H	contig_1	447788	446996	792	renamed_GCF_000008685.2	chromosome	447736	446968	792	99.2	9.228e-164
UCT124H	contig_1	447882	448200	318	renamed_GCF_000008685.2	chromosome	447854	448172	318	99.0	4.406e-68
UCT124H	contig_1	459943	460099	156	renamed_GCF_000008685.2	chromosome	459915	460071	156	100.0	2.965e-30
UCT124H	contig_1	460079	460439	360	renamed_GCF_000008685.2	chromosome	460051	460411	360	99.1	5.311e-73
UCT124H	contig_1	462072	462801	729	renamed_GCF_000008685.2	chromosome	462044	462773	729	99.5	2.469e-159
UCT124H	contig_1	494567	494174	393	renamed_GCF_000008685.2	chromosome	494539	494149	393	99.2	2.252e-79
UCT124H	contig_1	495057	496242	1185	renamed_GCF_000008685.2	chromosome	495032	496217	1185	100.0	4.832e-263
UCT124H	contig_1	496292	496604	312	renamed_GCF_000008685.2	chromosome	496267	496579	312	100.0	2.953e-63
UCT124H	contig_1	496639	497260	621	renamed_GCF_000008685.2	chromosome	496614	497235	621	100.0	8.732e-136
UCT124H	contig_1	497269	497899	630	renamed_GCF_000008685.2	chromosome	497244	497874	630	100.0	4.528e-136
UCT124H	contig_1	497919	498216	297	renamed_GCF_000008685.2	chromosome	497894	498191	297	100.0	5.69e-62
UCT124H	contig_1	502780	502966	186	renamed_GCF_000008685.2	chromosome	502755	502941	186	100.0	7.664e-41
UCT124H	contig_1	502975	503374	399	renamed_GCF_000008685.2	chromosome	502950	503349	399	96.2	1.849e-82
UCT124H	contig_1	503390	503933	543	renamed_GCF_000008685.2	chromosome	503365	503908	543	100.0	7.636e-116
UCT124H	contig_1	503950	504310	360	renamed_GCF_000008685.2	chromosome	503925	504285	360	99.1	2.162e-74
UCT124H	contig_1	504322	504820	498	renamed_GCF_000008685.2	chromosome	504297	504795	498	100.0	1.785e-107
UCT124H	contig_1	504823	505129	306	renamed_GCF_000008685.2	chromosome	504798	505104	306	100.0	1.468e-61
UCT124H	contig_1	505128	505566	438	renamed_GCF_000008685.2	chromosome	505103	505541	438	100.0	1.186e-93
UCT124H	contig_1	505578	506883	1305	renamed_GCF_000008685.2	chromosome	505553	506858	1305	100.0	4.133e-285
UCT124H	contig_1	506895	507009	114	renamed_GCF_000008685.2	chromosome	506864	506984	114	100.0	7.638e-22
UCT124H	contig_1	507026	507404	378	renamed_GCF_000008685.2	chromosome	507001	507379	378	100.0	8.763e-79
UCT124H	contig_1	516513	523014	6501	renamed_GCF_000008685.2	chromosome	516492	522993	6501	99.4	0.0
UCT124H	contig_1	524574	526275	1701	renamed_GCF_000008685.2	chromosome	524553	526254	1701	99.6	0.0
UCT124H	contig_1	551744	549662	2082	renamed_GCF_000008685.2	chromosome	551723	549641	2082	99.8	0.0
UCT124H	contig_1	553158	553809	651	renamed_GCF_000008685.2	chromosome	553138	553789	651	100.0	1.464e-143
UCT124H	contig_1	554011	555232	1221	renamed_GCF_000008685.2	chromosome	553991	555212	1221	100.0	5.34e-268
UCT124H	contig_1	555235	556600	1365	renamed_GCF_000008685.2	chromosome	555215	556580	1365	99.5	6.883e-307
UCT124H	contig_1	568170	569040	870	renamed_GCF_000008685.2	chromosome	568269	569139	870	99.6	3.86e-195
UCT124H	contig_1	569178	569439	261	renamed_GCF_000008685.2	chromosome	569277	569538	261	100.0	9.575e-51
UCT124H	contig_1	569459	571181	1722	renamed_GCF_000008685.2	chromosome	569558	571280	1722	100.0	0.0
UCT124H	contig_1	571183	571753	570	renamed_GCF_000008685.2	chromosome	571282	571852	570	100.0	1.471e-121
UCT124H	contig_2	12973	13558	585	renamed_GCF_000008685.2	lp54	12994	13579	585	100.0	1.763e-130
UCT124H	contig_2	14316	14862	546	renamed_GCF_000008685.2	lp54	14337	14883	546	100.0	1.338e-118
UCT124H	contig_2	16564	15979	585	renamed_GCF_000008685.2	lp54	16576	16000	585	77.0	9.401e-87
UCT124H	contig_2	27972	28890	918	renamed_GCF_000008685.2	lp54	28013	28931	918	99.6	1.041e-200
UCT124H	contig_2	30052	30592	540	renamed_GCF_000008685.2	lp54	30093	30633	540	100.0	4.969e-120
UCT124H	contig_2	31738	32161	423	renamed_GCF_000008685.2	lp54	31779	32202	423	100.0	5.086e-92
UCT124H	contig_2	32700	32919	219	renamed_GCF_000008685.2	lp54	32741	32960	219	100.0	7.958e-46
UCT124H	contig_2	42225	42432	207	renamed_GCF_000008685.2	lp54	42266	42473	207	100.0	9.856e-42
UCT124H	contig_2	44504	43655	849	renamed_GCF_000008685.2	lp54	44533	43684	849	100.0	7.054e-185
UCT124H	contig_4	8916	8220	696	renamed_GCF_000008685.2	lp36	8859	8163	696	100.0	1.275e-152
UCT124H	contig_4	10357	12004	1647	renamed_GCF_000008685.2	lp36	10300	11947	1647	99.8	0.0
UCT124H	contig_4	14384	13634	750	renamed_GCF_000008685.2	lp36	14326	13576	750	100.0	1.062e-163
UCT124H	contig_4	26829	26610	219	renamed_GCF_000008685.2	lp36	26803	26584	219	100.0	9.792e-44
UCT124H	contig_4	31563	30744	819	renamed_GCF_000008685.2	lp36	31585	30718	819	99.2	1.166e-165
UCT124H	contig_6	12026	11570	456	renamed_GCF_000008685.2	cp32-1	4941	5397	456	100.0	1.075e-97
UCT124H	contig_6	15662	14969	693	renamed_GCF_000008685.2	cp32-7	1304	1997	693	100.0	2.582e-144
UCT124H	contig_6	29091	30102	1011	renamed_GCF_000008685.2	cp32-7	18728	17711	1011	98.8	2.166e-225
UCT124H	contig_6	30569	30146	423	renamed_GCF_000008685.2	cp32-7	17244	17667	423	100.0	2.074e-93
UCT124H	contig_7	1334	779	555	renamed_GCF_000008685.2	cp32-8	16544	17099	555	100.0	3.776e-117
UCT124H	contig_7	2457	2109	348	renamed_GCF_000008685.2	cp32-8	15421	15769	348	100.0	8.822e-74
UCT124H	contig_7	2664	2460	204	renamed_GCF_000008685.2	cp32-3	15211	15415	204	100.0	2.578e-39
UCT124H	contig_7	6924	5982	942	renamed_GCF_000008685.2	cp32-7	10961	11903	942	100.0	2.456e-212
UCT124H	contig_7	24028	23602	426	renamed_GCF_000008685.2	cp32-1	24608	25034	426	100.0	1.627e-96
UCT124H	contig_7	26506	25873	633	renamed_GCF_000008685.2	cp32-1	22130	22763	633	100.0	1.275e-133
UCT124H	contig_7	27871	27130	741	renamed_GCF_000008685.2	cp32-1	20765	21506	741	100.0	1.112e-161
UCT124H	contig_7	29523	28422	1101	renamed_GCF_000008685.2	cp32-1	19113	20214	1101	100.0	1.773e-251
UCT124H	contig_8	164	731	567	renamed_GCF_000008685.2	cp32-4	6163	6730	567	99.4	5.214e-124
UCT124H	contig_8	1838	2267	429	renamed_GCF_000008685.2	lp56	11296	11725	429	100.0	5.601e-92
UCT124H	contig_9	20828	21419	591	renamed_GCF_000008685.2	cp32-3	22592	23183	591	100.0	1.16e-127
UCT124H	contig_9	23293	23719	426	renamed_GCF_000008685.2	cp32-3	25068	25494	426	99.2	8.056e-96
UCT124H	contig_9	25634	26144	510	renamed_GCF_000008685.2	cp32-3	27409	27919	510	99.4	1.964e-108
UCT124H	contig_9	26460	27099	639	renamed_GCF_000008685.2	cp32-3	28235	28874	639	100.0	1.943e-138
UCT124H	contig_10	1062	1944	882	renamed_GCF_000008685.2	lp28-2	1046	1928	882	100.0	1.741e-197
UCT124H	contig_10	5393	5966	573	renamed_GCF_000008685.2	lp28-2	5377	5950	573	100.0	1.602e-129
UCT124H	contig_10	24503	25970	1467	renamed_GCF_000008685.2	lp28-2	24488	25955	1467	99.3	0.0
UCT124H	contig_12	19282	19951	669	renamed_GCF_000008685.2	lp28-3	10516	9847	669	100.0	5.739e-140
UCT124H	contig_12	22070	25907	3837	renamed_GCF_000008685.2	lp28-3	7728	3891	3837	100.0	0.0
UCT124H	contig_12	29412	28938	474	renamed_GCF_000008685.2	lp56	52608	52134	474	100.0	1.788e-103
UCT124H	contig_13	3585	3348	237	renamed_GCF_000008685.2	cp32-6	8733	8970	237	100.0	7.893e-49
UCT124H	contig_13	5608	4495	1113	renamed_GCF_000008685.2	cp32-8	6700	7813	1113	99.4	3.394e-246
UCT124H	contig_13	6541	6151	390	renamed_GCF_000008685.2	cp32-4	5777	6167	390	100.0	3.229e-83
UCT124H	contig_13	7367	6911	456	renamed_GCF_000008685.2	cp32-7	4940	5396	456	100.0	1.075e-97
UCT124H	contig_16	13598	12845	753	renamed_GCF_000008685.2	lp28-4	12453	13206	753	98.0	1.343e-161
UCT124H	contig_16	15231	14124	1107	renamed_GCF_000008685.2	lp28-4	10814	11927	1107	98.6	1.157e-248
UCT124H	contig_16	18029	17507	522	renamed_GCF_000008685.2	lp28-4	7182	8538	522	100.0	3.275e-113
UCT124H	contig_16	23511	22695	816	renamed_GCF_000008685.2	lp28-4	2535	3351	816	100.0	8.08e-178
UCT124H	contig_19	9632	10193	561	renamed_GCF_000008685.2	cp32-9	21613	22174	561	100.0	6.308e-121
UCT124H	contig_19	10202	10742	540	renamed_GCF_000008685.2	cp32-9	22183	22723	540	99.4	3.963e-114
UCT124H	contig_19	11212	12538	1326	renamed_GCF_000008685.2	lp56	26920	28246	1326	98.8	8.571e-298
UCT124H	contig_19	21253	22021	768	renamed_GCF_000008685.2	cp32-9	2582	3350	768	100.0	6.66e-172
UCT124H	contig_20	590	947	357	renamed_GCF_000008685.2	lp17	1409	1766	357	100.0	1.532e-77
UCT124H	contig_20	1992	2229	237	renamed_GCF_000008685.2	lp17	3651	3819	237	100.0	8.4e-33
UCT124H	contig_20	3465	4149	684	renamed_GCF_000008685.2	lp17	5055	5739	684	99.1	6.297e-150
UCT124H	contig_20	4873	4294	579	renamed_GCF_000008685.2	lp17	6452	5873	579	98.9	5.735e-125
UCT124H	contig_22	7698	8226	528	renamed_GCF_000008685.2	cp9	6808	6280	528	100.0	2.158e-110
UCT124H	contig_22	8907	8526	381	renamed_GCF_000008685.2	lp21	16548	16227	381	38.2	7.159e-16
UCT124H	contig_1	122499	121887	612	renamed_GCF_000008685.2	chromosome	122491	121879	612	100.0	3.269e-128
UCT124H	contig_1	124822	124156	666	renamed_GCF_000008685.2	chromosome	124814	124148	666	100.0	8.347e-144
UCT124H	contig_1	126309	125541	768	renamed_GCF_000008685.2	chromosome	126301	125533	768	100.0	3.291e-171
UCT124H	contig_1	130140	127434	2706	renamed_GCF_000008685.2	chromosome	130132	127426	2706	100.0	0.0
UCT124H	contig_1	131305	132433	1128	renamed_GCF_000008685.2	chromosome	131297	132425	1128	100.0	3.566e-248
UCT124H	contig_1	133982	135872	1890	renamed_GCF_000008685.2	chromosome	133974	135864	1890	99.5	0.0
UCT124H	contig_1	138753	138441	312	renamed_GCF_000008685.2	chromosome	138745	138433	312	100.0	9.828e-67
UCT124H	contig_1	142942	141988	954	renamed_GCF_000008685.2	chromosome	142932	141978	954	100.0	1.517e-202
UCT124H	contig_1	144316	144607	291	renamed_GCF_000008685.2	chromosome	144306	144597	291	100.0	5.156e-62
UCT124H	contig_1	158066	158483	417	renamed_GCF_000008685.2	chromosome	158075	158474	417	100.0	2.72e-81
UCT124H	contig_1	202605	201078	1527	renamed_GCF_000008685.2	chromosome	202578	201051	1527	99.6	0.0
UCT124H	contig_1	204163	205099	936	renamed_GCF_000008685.2	chromosome	204136	205072	936	100.0	4.7e-204
UCT124H	contig_1	206555	208106	1551	renamed_GCF_000008685.2	chromosome	206528	208106	1551	99.8	0.0
UCT124H	contig_1	224811	223989	822	renamed_GCF_000008685.2	chromosome	224785	223963	822	100.0	3.638e-179
UCT124H	contig_1	227853	226635	1218	renamed_GCF_000008685.2	chromosome	227827	226609	1218	99.7	3.023e-265
UCT124H	contig_1	229242	230250	1008	renamed_GCF_000008685.2	chromosome	229216	230224	1008	99.1	1.478e-220
UCT124H	contig_1	231646	232348	702	renamed_GCF_000008685.2	chromosome	231620	232322	702	99.5	5.74e-154
UCT124H	contig_1	283891	282724	1167	renamed_GCF_000008685.2	chromosome	283865	282698	1167	100.0	1.172e-258
UCT124H	contig_1	287115	285996	1119	renamed_GCF_000008685.2	chromosome	287089	285970	1119	100.0	9.957e-244
UCT124H	contig_1	288199	287935	264	renamed_GCF_000008685.2	chromosome	288173	287909	264	100.0	2.025e-51
UCT124H	contig_1	289609	288982	627	renamed_GCF_000008685.2	chromosome	289583	288956	627	100.0	2.836e-132
UCT124H	contig_1	291047	289988	1059	renamed_GCF_000008685.2	chromosome	291021	289962	1059	100.0	3.164e-229
UCT124H	contig_1	300790	299755	1035	renamed_GCF_000008685.2	chromosome	300764	299729	1035	100.0	3.255e-216
UCT124H	contig_1	302862	302529	333	renamed_GCF_000008685.2	chromosome	302839	302503	333	99.0	1.253e-67
UCT124H	contig_1	303766	303358	408	renamed_GCF_000008685.2	chromosome	303740	303332	408	100.0	2.649e-88
UCT124H	contig_1	305687	305138	549	renamed_GCF_000008685.2	chromosome	305661	305112	549	100.0	9.24e-115
UCT124H	contig_1	307342	306649	693	renamed_GCF_000008685.2	chromosome	307317	306624	693	100.0	2.971e-151
UCT124H	contig_1	364143	362343	1800	renamed_GCF_000008685.2	chromosome	364117	362317	1800	100.0	0.0
UCT124H	contig_1	365629	365140	489	renamed_GCF_000008685.2	chromosome	365603	365114	489	100.0	3.787e-106
UCT124H	contig_1	366986	366254	732	renamed_GCF_000008685.2	chromosome	366960	366228	732	98.7	5.755e-159
UCT124H	contig_1	368481	368907	426	renamed_GCF_000008685.2	chromosome	368455	368881	426	99.2	1.931e-86
UCT124H	contig_1	370052	371039	987	renamed_GCF_000008685.2	chromosome	370026	371013	987	99.6	8.057e-224
UCT124H	contig_1	373165	373546	381	renamed_GCF_000008685.2	chromosome	373139	373520	381	100.0	1.683e-80
UCT124H	contig_1	374302	375679	1377	renamed_GCF_000008685.2	chromosome	374276	375653	1377	99.1	3.109e-309
UCT124H	contig_1	377045	375986	1059	renamed_GCF_000008685.2	chromosome	377019	375960	1059	100.0	5.328e-232
UCT124H	contig_1	380584	379366	1218	renamed_GCF_000008685.2	chromosome	380558	379340	1218	99.0	2.093e-269
UCT124H	contig_1	383408	381935	1473	renamed_GCF_000008685.2	chromosome	383382	381909	1473	100.0	0.0
UCT124H	contig_1	448619	448229	390	renamed_GCF_000008685.2	chromosome	448591	448201	390	100.0	7.926e-82
UCT124H	contig_1	449446	450199	753	renamed_GCF_000008685.2	chromosome	449418	450171	753	100.0	3.278e-160
UCT124H	contig_1	451949	451166	783	renamed_GCF_000008685.2	chromosome	451921	451138	783	100.0	1.017e-169
UCT124H	contig_1	456416	454511	1905	renamed_GCF_000008685.2	chromosome	456388	454483	1905	99.8	0.0
UCT124H	contig_1	458304	459462	1158	renamed_GCF_000008685.2	chromosome	458276	459434	1158	100.0	2.482e-257
UCT124H	contig_1	471248	469988	1260	renamed_GCF_000008685.2	chromosome	471220	469960	1260	99.7	1.253e-273
UCT124H	contig_1	472503	471798	705	renamed_GCF_000008685.2	chromosome	472358	471770	705	99.4	1.099e-121
UCT124H	contig_1	474584	473432	1152	renamed_GCF_000008685.2	chromosome	474556	473404	1152	100.0	7.714e-261
UCT124H	contig_1	475633	476239	606	renamed_GCF_000008685.2	chromosome	475605	476211	606	100.0	1.006e-131
UCT124H	contig_1	502215	502764	549	renamed_GCF_000008685.2	chromosome	502190	502739	549	100.0	1.698e-116
UCT124H	contig_1	507838	508873	1035	renamed_GCF_000008685.2	chromosome	507813	508848	1035	100.0	4.156e-222
UCT124H	contig_1	509338	510871	1533	renamed_GCF_000008685.2	chromosome	509313	510846	1533	100.0	0.0
UCT124H	contig_1	513250	514552	1302	renamed_GCF_000008685.2	chromosome	513225	514527	1302	99.5	3.945e-285
UCT124H	contig_1	535724	537548	1824	renamed_GCF_000008685.2	chromosome	535703	537527	1824	99.6	0.0
UCT124H	contig_1	539296	538348	948	renamed_GCF_000008685.2	chromosome	539275	538327	948	100.0	1.008e-214
UCT124H	contig_1	543069	543837	768	renamed_GCF_000008685.2	chromosome	543048	543816	768	100.0	8.433e-178
UCT124H	contig_1	557323	556582	741	renamed_GCF_000008685.2	chromosome	557423	556562	741	85.6	4.339e-155
UCT124H	contig_1	560632	557905	2727	renamed_GCF_000008685.2	chromosome	560732	558005	2727	99.7	0.0
UCT124H	contig_1	561454	561016	438	renamed_GCF_000008685.2	chromosome	561554	561116	438	100.0	1.44e-91
UCT124H	contig_1	562084	564067	1983	renamed_GCF_000008685.2	chromosome	562184	564167	1983	99.6	0.0
UCT124H	contig_1	565861	567724	1863	renamed_GCF_000008685.2	chromosome	565954	567823	1863	99.0	0.0
UCT124H	contig_1	577850	578162	312	renamed_GCF_000008685.2	chromosome	577949	578261	312	100.0	5.387e-65
UCT124H	contig_1	580386	581544	1158	renamed_GCF_000008685.2	chromosome	580485	581643	1158	100.0	7.971e-253
UCT124H	contig_1	583358	583733	375	renamed_GCF_000008685.2	chromosome	583457	583832	375	100.0	8.349e-79
UCT124H	contig_1	584992	586057	1065	renamed_GCF_000008685.2	chromosome	585079	586156	1065	99.7	1.659e-237
UCT124H	contig_1	586931	587783	852	renamed_GCF_000008685.2	chromosome	587030	587882	852	98.2	1.031e-189
UCT124H	contig_1	630674	631892	1218	renamed_GCF_000008685.2	chromosome	630795	631986	1218	99.4	4.366e-261
UCT124H	contig_1	645507	645042	465	renamed_GCF_000008685.2	chromosome	645601	645136	465	99.3	2.067e-100
UCT124H	contig_1	648232	646564	1668	renamed_GCF_000008685.2	chromosome	648254	646658	1668	99.8	0.0
UCT124H	contig_1	650293	649075	1218	renamed_GCF_000008685.2	chromosome	650387	649169	1218	100.0	2.758e-266
UCT124H	contig_1	653792	654755	963	renamed_GCF_000008685.2	chromosome	653886	654849	963	100.0	5.23e-216
UCT124H	contig_1	678851	677804	1047	renamed_GCF_000008685.2	chromosome	678938	677891	1047	99.1	1.373e-236
UCT124H	contig_1	680475	679665	810	renamed_GCF_000008685.2	chromosome	680557	679753	810	99.6	5.278e-173
UCT124H	contig_1	682436	681596	840	renamed_GCF_000008685.2	chromosome	682524	681684	840	100.0	1.641e-182
UCT124H	contig_1	683334	684879	1545	renamed_GCF_000008685.2	chromosome	683422	684967	1545	99.6	0.0
UCT124H	contig_1	714908	716519	1611	renamed_GCF_000008685.2	chromosome	715008	716619	1611	99.8	0.0
UCT124H	contig_1	717642	718569	927	renamed_GCF_000008685.2	chromosome	717742	718669	927	100.0	3.519e-197
UCT124H	contig_1	721018	722920	1902	renamed_GCF_000008685.2	chromosome	721118	723020	1902	100.0	0.0
UCT124H	contig_1	724123	725347	1224	renamed_GCF_000008685.2	chromosome	724223	725447	1224	99.7	7.158e-274
UCT124H	contig_1	726384	727653	1269	renamed_GCF_000008685.2	chromosome	726457	727753	1269	99.7	1.845e-279
UCT124H	contig_1	728565	729519	954	renamed_GCF_000008685.2	chromosome	728665	729619	954	100.0	1.334e-212
UCT124H	contig_1	730999	730531	468	renamed_GCF_000008685.2	chromosome	731099	730631	468	100.0	1.969e-101
UCT124H	contig_1	733979	735188	1209	renamed_GCF_000008685.2	chromosome	734080	735289	1209	100.0	8.188e-270
UCT124H	contig_1	736597	736858	261	renamed_GCF_000008685.2	chromosome	736698	736959	261	100.0	3.165e-54
UCT124H	contig_1	737110	737611	501	renamed_GCF_000008685.2	chromosome	737211	737712	501	99.3	2.062e-106
UCT124H	contig_1	760101	761547	1446	renamed_GCF_000008685.2	chromosome	760225	761647	1446	99.7	9.686e-317
UCT124H	contig_1	764270	765242	972	renamed_GCF_000008685.2	chromosome	764370	765342	972	100.0	2.973e-215
UCT124H	contig_1	767964	766632	1332	renamed_GCF_000008685.2	chromosome	768064	766732	1332	100.0	1.239e-294
UCT124H	contig_1	771039	769446	1593	renamed_GCF_000008685.2	chromosome	771139	769546	1593	100.0	0.0
UCT124H	contig_1	774268	771469	2799	renamed_GCF_000008685.2	chromosome	774368	771569	2799	99.7	0.0
UCT124H	contig_1	776579	775565	1014	renamed_GCF_000008685.2	chromosome	776679	775665	1014	99.7	8.011e-220
UCT124H	contig_1	777664	778654	990	renamed_GCF_000008685.2	chromosome	777764	778754	990	100.0	1.559e-225
UCT124H	contig_1	829132	830236	1104	renamed_GCF_000008685.2	chromosome	829217	830321	1104	99.1	5.448e-248
UCT124H	contig_1	847405	848254	849	renamed_GCF_000008685.2	chromosome	847490	848339	849	99.2	1.721e-183
UCT124H	contig_1	848733	850902	2169	renamed_GCF_000008685.2	chromosome	848836	850987	2169	99.8	0.0
UCT124H	contig_1	852403	853693	1290	renamed_GCF_000008685.2	chromosome	852488	853778	1290	99.7	1.474e-285
UCT124H	contig_1	854783	855911	1128	renamed_GCF_000008685.2	chromosome	854868	855996	1128	99.7	1.177e-260
UCT124H	contig_1	857420	858830	1410	renamed_GCF_000008685.2	chromosome	857505	858915	1410	99.1	1.821e-303
UCT124H	contig_1	869431	868648	783	renamed_GCF_000008685.2	chromosome	869380	868732	783	99.0	4.291e-145
UCT124H	contig_1	872499	870027	2472	renamed_GCF_000008685.2	chromosome	872583	870111	2472	99.8	0.0
UCT124H	contig_1	875122	876364	1242	renamed_GCF_000008685.2	chromosome	875206	876448	1242	99.7	2.455e-280
UCT124H	contig_1	879230	880166	936	renamed_GCF_000008685.2	chromosome	879314	880250	936	100.0	3.242e-208
UCT124H	contig_2	25421	26663	1242	renamed_GCF_000008685.2	lp54	25467	26694	1242	100.0	1.5e-268
UCT124H	contig_2	27348	27957	609	renamed_GCF_000008685.2	lp54	27389	27998	609	100.0	2.346e-131
UCT124H	contig_2	34946	35792	846	renamed_GCF_000008685.2	lp54	34987	35833	846	99.2	1.362e-185
UCT124H	contig_2	36226	36493	267	renamed_GCF_000008685.2	lp54	36255	36534	267	97.7	3.495e-54
UCT124H	contig_2	39364	38119	1245	renamed_GCF_000008685.2	lp54	39405	38160	1245	99.2	2.65e-271
UCT124H	contig_2	41004	40170	834	renamed_GCF_000008685.2	lp54	41045	40211	834	99.6	1.639e-181
UCT124H	contig_2	41978	41354	624	renamed_GCF_000008685.2	lp54	42019	41395	624	100.0	3.1e-139
UCT124H	contig_2	52530	53328	798	renamed_GCF_000008685.2	lp54	52705	53503	798	99.2	6.687e-177
UCT124H	contig_3	6109	6883	774	renamed_GCF_000008685.2	lp38	6088	6862	774	100.0	2.049e-160
UCT124H	contig_3	42250	42937	687	renamed_GCF_000008685.2	lp38	35591	34904	687	100.0	9.164e-155
UCT124H	contig_4	240	1134	894	renamed_GCF_000008685.2	lp36	187	1081	894	98.9	4.028e-190
UCT124H	contig_4	14899	14359	540	renamed_GCF_000008685.2	lp36	14841	14301	540	100.0	2.234e-120
UCT124H	contig_4	16333	16945	612	renamed_GCF_000008685.2	lp36	16274	16886	612	100.0	9.153e-134
UCT124H	contig_4	21988	22210	222	renamed_GCF_000008685.2	lp36	21911	22133	222	98.6	9.282e-45
UCT124H	contig_4	32847	31851	996	renamed_GCF_000008685.2	lp36	32822	31826	996	99.6	2.722e-220
UCT124H	contig_6	1201	865	336	renamed_GCF_000008685.2	cp32-7	15765	16101	336	100.0	5.348e-69
UCT124H	contig_6	1745	1541	204	renamed_GCF_000008685.2	cp32-8	15214	15418	204	100.0	2.578e-39
UCT124H	contig_6	8693	8237	456	renamed_GCF_000008685.2	cp32-7	8273	8729	456	100.0	8.859e-100
UCT124H	contig_6	18882	18315	567	renamed_GCF_000008685.2	cp32-7	28884	29451	567	100.0	5.734e-123
UCT124H	contig_6	20874	19782	1092	renamed_GCF_000008685.2	cp32-7	26892	27984	1092	100.0	4.257e-240
UCT124H	contig_9	7008	7245	237	renamed_GCF_000008685.2	cp32-3	8723	8960	237	100.0	7.893e-49
UCT124H	contig_9	8552	9236	684	renamed_GCF_000008685.2	cp32-3	10264	10948	684	100.0	6.297e-150
UCT124H	contig_9	10207	10753	546	renamed_GCF_000008685.2	cp32-8	11919	12465	546	100.0	7.28e-117
UCT124H	contig_9	11111	11990	879	renamed_GCF_000008685.2	cp32-1	12823	13699	879	100.0	6.452e-191
UCT124H	contig_9	11995	12601	606	renamed_GCF_000008685.2	cp32-4	13661	14267	606	100.0	5.47e-130
UCT124H	contig_10	11507	11078	429	renamed_GCF_000008685.2	lp28-2	11491	11062	429	100.0	3.057e-90
UCT124H	contig_10	12768	12324	444	renamed_GCF_000008685.2	lp28-2	12752	12308	444	100.0	8.866e-98
UCT124H	contig_10	13511	13172	339	renamed_GCF_000008685.2	lp28-2	13495	13156	339	100.0	3.422e-74
UCT124H	contig_10	14357	13523	834	renamed_GCF_000008685.2	lp28-2	14341	13507	834	100.0	1.239e-184
UCT124H	contig_10	15447	14901	546	renamed_GCF_000008685.2	lp28-2	15431	14885	546	100.0	9.693e-114
UCT124H	contig_11	19959	19380	579	renamed_GCF_000008685.2	cp32-6	21519	22098	579	100.0	5.735e-125
UCT124H	contig_11	20758	20008	750	renamed_GCF_000008685.2	cp32-6	20720	21470	750	100.0	4.35e-165
UCT124H	contig_11	21300	20733	567	renamed_GCF_000008685.2	cp32-6	20178	20745	567	100.0	6.547e-130
UCT124H	contig_11	22410	21309	1101	renamed_GCF_000008685.2	cp32-6	19068	20169	1101	100.0	1.945e-250
UCT124H	contig_11	22798	23746	948	renamed_GCF_000008685.2	cp32-6	18680	17732	948	100.0	7.628e-218
UCT124H	contig_11	24232	23782	450	renamed_GCF_000008685.2	cp32-6	17246	17696	450	100.0	3.616e-100
UCT124H	contig_11	24403	24886	483	renamed_GCF_000008685.2	cp32-6	17075	16592	483	100.0	5.056e-102
UCT124H	contig_13	11003	10310	693	renamed_GCF_000008685.2	cp32-8	1305	1998	693	100.0	2.582e-144
UCT124H	contig_13	19831	19258	573	renamed_GCF_000008685.2	cp32-7	22087	22660	573	100.0	7.629e-121
UCT124H	contig_13	21153	20403	750	renamed_GCF_000008685.2	cp32-7	20765	21515	750	100.0	2.593e-162
UCT124H	contig_13	22802	21704	1098	renamed_GCF_000008685.2	cp32-7	19116	20214	1098	99.1	2.233e-248
UCT124H	contig_14	20533	21748	1215	renamed_GCF_000008685.2	cp26	15107	13892	1215	99.7	5.333e-267
UCT124H	contig_14	24223	24721	498	renamed_GCF_000008685.2	cp26	11417	10919	498	99.3	1.785e-107
UCT124H	contig_14	26366	25604	762	renamed_GCF_000008685.2	cp26	9274	10036	762	100.0	1.063e-165
UCT124H	contig_16	4495	5125	630	renamed_GCF_000008685.2	lp28-4	21562	20770	630	100.0	4.977e-135
UCT124H	contig_18	13491	12300	1191	renamed_GCF_000008685.2	lp28-2	17684	16493	1191	99.7	6.781e-269
UCT124H	contig_21	835	2260	1425	renamed_GCF_000008685.2	chromosome	901833	903258	1425	99.7	2.69e-310
UCT124H	contig_21	7408	8593	1185	renamed_GCF_000008685.2	chromosome	908406	909591	1185	100.0	8.142e-266
UCT124H	contig_22	332	617	285	renamed_GCF_000008685.2	cp9	4788	4503	285	100.0	2.564e-60
UCT124H	contig_22	2317	1408	909	renamed_GCF_000008685.2	cp9	2803	3712	909	100.0	3.914e-210
UCT124H	contig_22	3839	3281	558	renamed_GCF_000008685.2	cp9	1281	1839	558	100.0	4.107e-125
UCT124H	contig_1	126	690	564	renamed_GCF_000008685.2	chromosome	104	677	564	100.0	4.108e-126
UCT124H	contig_1	12167	12767	600	renamed_GCF_000008685.2	chromosome	12153	12753	600	98.9	1.006e-130
UCT124H	contig_1	16008	16818	810	renamed_GCF_000008685.2	chromosome	15994	16804	810	99.2	5.278e-173
UCT124H	contig_1	22116	21072	1044	renamed_GCF_000008685.2	chromosome	22101	21057	1044	100.0	6.693e-227
UCT124H	contig_1	22754	22160	594	renamed_GCF_000008685.2	chromosome	22739	22145	594	99.4	7.271e-125
UCT124H	contig_1	22833	23973	1140	renamed_GCF_000008685.2	chromosome	22818	23958	1140	97.8	1.874e-257
UCT124H	contig_1	24711	23979	732	renamed_GCF_000008685.2	chromosome	24696	23964	732	100.0	2.844e-158
UCT124H	contig_1	25638	24711	927	renamed_GCF_000008685.2	chromosome	25623	24696	927	99.6	5.919e-200
UCT124H	contig_1	57273	57990	717	renamed_GCF_000008685.2	chromosome	57258	57975	717	98.7	3.592e-153
UCT124H	contig_1	60053	59114	939	renamed_GCF_000008685.2	chromosome	60039	59100	939	99.6	9.091e-206
UCT124H	contig_1	61271	60581	690	renamed_GCF_000008685.2	chromosome	61257	60567	690	98.6	7.606e-149
UCT124H	contig_1	63160	64042	882	renamed_GCF_000008685.2	chromosome	63146	64028	882	100.0	1.369e-191
UCT124H	contig_1	65304	65766	462	renamed_GCF_000008685.2	chromosome	65290	65752	462	100.0	3.193e-95
UCT124H	contig_1	67261	69583	2322	renamed_GCF_000008685.2	chromosome	67247	69569	2322	99.8	0.0
UCT124H	contig_1	69579	70140	561	renamed_GCF_000008685.2	chromosome	69565	70126	561	100.0	3.775e-118
UCT124H	contig_1	71214	72624	1410	renamed_GCF_000008685.2	chromosome	71200	72610	1410	99.7	5.687e-308
UCT124H	contig_1	75786	76467	681	renamed_GCF_000008685.2	chromosome	75773	76454	681	100.0	3.584e-147
UCT124H	contig_1	111576	111054	522	renamed_GCF_000008685.2	chromosome	111567	111045	522	100.0	1.783e-111
UCT124H	contig_1	112346	111896	450	renamed_GCF_000008685.2	chromosome	112338	111888	450	100.0	4.387e-98
UCT124H	contig_1	114611	112916	1695	renamed_GCF_000008685.2	chromosome	114603	112908	1695	100.0	0.0
UCT124H	contig_1	116814	115512	1302	renamed_GCF_000008685.2	chromosome	116806	115504	1302	98.6	1.053e-282
UCT124H	contig_1	118937	118382	555	renamed_GCF_000008685.2	chromosome	118929	118374	555	99.4	1.698e-117
UCT124H	contig_1	120597	119814	783	renamed_GCF_000008685.2	chromosome	120589	119806	783	100.0	5.024e-169
UCT124H	contig_1	146380	145480	900	renamed_GCF_000008685.2	chromosome	146370	145470	900	100.0	6.779e-194
UCT124H	contig_1	148669	147658	1011	renamed_GCF_000008685.2	chromosome	148659	147648	1011	100.0	5.463e-215
UCT124H	contig_1	152214	153021	807	renamed_GCF_000008685.2	chromosome	152205	153012	807	100.0	9.769e-183
UCT124H	contig_1	153695	153083	612	renamed_GCF_000008685.2	chromosome	153686	153074	612	100.0	4.712e-141
UCT124H	contig_1	211326	212094	768	renamed_GCF_000008685.2	chromosome	211300	212068	768	100.0	8.822e-169
UCT124H	contig_1	215452	217285	1833	renamed_GCF_000008685.2	chromosome	215426	217259	1833	100.0	0.0
UCT124H	contig_1	219104	218450	654	renamed_GCF_000008685.2	chromosome	219078	218424	654	100.0	1.052e-147
UCT124H	contig_1	220754	221663	909	renamed_GCF_000008685.2	chromosome	220728	221637	909	100.0	9.393e-192
UCT124H	contig_1	232363	235279	2916	renamed_GCF_000008685.2	chromosome	232337	235253	2916	100.0	0.0
UCT124H	contig_1	237168	235620	1548	renamed_GCF_000008685.2	chromosome	237142	235594	1548	99.6	0.0
UCT124H	contig_1	237982	237655	327	renamed_GCF_000008685.2	chromosome	237956	237629	327	99.0	4.183e-70
UCT124H	contig_1	239154	238326	828	renamed_GCF_000008685.2	chromosome	239128	238300	828	99.2	2.283e-185
UCT124H	contig_1	242315	240308	2007	renamed_GCF_000008685.2	chromosome	242289	240282	2007	99.8	0.0
UCT124H	contig_1	254970	255675	705	renamed_GCF_000008685.2	chromosome	254944	255649	705	99.5	1.615e-151
UCT124H	contig_1	899236	897619	1617	renamed_GCF_000008685.2	chromosome	899320	897703	1617	100.0	0.0
UCT124H	contig_2	1426	1936	510	renamed_GCF_000008685.2	lp54	1460	1970	510	99.4	4.368e-108
UCT124H	contig_2	10250	11141	891	renamed_GCF_000008685.2	lp54	10287	11178	891	100.0	1.898e-189
UCT124H	contig_2	13533	14286	753	renamed_GCF_000008685.2	lp54	13554	14307	753	100.0	4.561e-165
UCT124H	contig_2	15348	15780	432	renamed_GCF_000008685.2	lp54	15369	15801	432	97.2	4.841e-94
UCT124H	contig_2	17247	16683	564	renamed_GCF_000008685.2	lp54	17259	16695	564	99.4	1.171e-114
UCT124H	contig_2	28893	29346	453	renamed_GCF_000008685.2	lp54	28934	29387	453	100.0	2.51e-96
UCT124H	contig_2	29342	29717	375	renamed_GCF_000008685.2	lp54	29383	29758	375	100.0	1.685e-79
UCT124H	contig_3	19461	20157	696	renamed_GCF_000008685.2	lp38	19312	20008	696	100.0	6.303e-152
UCT124H	contig_3	21371	22097	726	renamed_GCF_000008685.2	lp38	21222	21948	726	100.0	1.164e-158
UCT124H	contig_4	6095	5342	753	renamed_GCF_000008685.2	lp36	6040	5287	753	100.0	7.287e-160
UCT124H	contig_4	6429	6705	276	renamed_GCF_000008685.2	lp36	6365	6650	276	100.0	1.214e-58
UCT124H	contig_4	9429	10056	627	renamed_GCF_000008685.2	lp36	9372	9999	627	98.5	5.218e-134
UCT124H	contig_4	12659	13295	636	renamed_GCF_000008685.2	lp36	12601	13237	636	100.0	3.41e-140
UCT124H	contig_4	24144	24321	177	renamed_GCF_000008685.2	lp36	24066	24243	177	100.0	7.659e-32
UCT124H	contig_4	25182	25683	501	renamed_GCF_000008685.2	lp36	25102	25657	501	90.2	2.498e-104
UCT124H	contig_4	26384	25838	546	renamed_GCF_000008685.2	lp36	26358	25812	546	100.0	8.009e-116
UCT124H	contig_5	27560	27212	348	renamed_GCF_000008685.2	cp32-9	15518	15866	348	100.0	8.822e-74
UCT124H	contig_5	27767	27563	204	renamed_GCF_000008685.2	cp32-9	15311	15515	204	100.0	2.578e-39
UCT124H	contig_6	13005	12045	960	renamed_GCF_000008685.2	cp32-8	3962	4922	960	100.0	6.593e-213
UCT124H	contig_8	711	1824	1113	renamed_GCF_000008685.2	cp32-4	6710	7823	1113	100.0	1.393e-247
UCT124H	contig_8	2282	2738	456	renamed_GCF_000008685.2	cp32-4	8281	8737	456	100.0	1.971e-99
UCT124H	contig_8	6857	7733	876	renamed_GCF_000008685.2	cp32-4	12776	13652	876	98.6	7.416e-189
UCT124H	contig_8	8357	9170	813	renamed_GCF_000008685.2	cp32-4	14276	15092	813	86.7	6.566e-154
UCT124H	contig_8	16909	18235	1326	renamed_GCF_000008685.2	cp32-4	22830	24156	1326	99.5	3.52e-299
UCT124H	contig_8	18287	18713	426	renamed_GCF_000008685.2	cp32-4	24209	24635	426	100.0	8.056e-96
UCT124H	contig_9	16038	16485	447	renamed_GCF_000008685.2	cp32-3	17802	18249	447	100.0	7.667e-100
UCT124H	contig_9	17840	18941	1101	renamed_GCF_000008685.2	cp32-3	19604	20705	1101	100.0	1.773e-251
UCT124H	contig_9	19492	20233	741	renamed_GCF_000008685.2	cp32-3	21256	21997	741	100.0	5.003e-162
UCT124H	contig_9	21915	23241	1326	renamed_GCF_000008685.2	cp32-3	23690	25016	1326	100.0	1.445e-300
UCT124H	contig_9	24501	23724	777	renamed_GCF_000008685.2	cp32-3	26276	25499	777	100.0	3.144e-173
UCT124H	contig_9	24932	25523	591	renamed_GCF_000008685.2	cp32-3	26707	27298	591	100.0	2.345e-128
UCT124H	contig_9	27095	28448	1353	renamed_GCF_000008685.2	cp32-3	28870	30223	1353	100.0	1.268e-306
UCT124H	contig_10	131	1025	894	renamed_GCF_000008685.2	lp28-2	115	1009	894	100.0	3.048e-193
UCT124H	contig_11	10335	9642	693	renamed_GCF_000008685.2	cp32-3	1305	1998	693	100.0	2.582e-144
UCT124H	contig_11	11575	10351	1224	renamed_GCF_000008685.2	cp32-8	65	1289	1224	100.0	2.096e-270
UCT124H	contig_11	13556	12989	567	renamed_GCF_000008685.2	cp32-6	27922	28489	567	100.0	2.836e-122
UCT124H	contig_11	13733	14402	669	renamed_GCF_000008685.2	cp32-6	27745	27076	669	100.0	4.521e-151
UCT124H	contig_11	15222	14463	759	renamed_GCF_000008685.2	cp32-6	26256	27015	759	100.0	2.986e-162
UCT124H	contig_11	18238	16912	1326	renamed_GCF_000008685.2	cp32-6	23240	24566	1326	100.0	1.445e-300
UCT124H	contig_12	26827	27538	711	renamed_GCF_000008685.2	lp28-3	2970	2259	711	100.0	1.615e-152
UCT124H	contig_13	1399	448	951	renamed_GCF_000008685.2	cp32-8	10951	11902	951	99.6	2.14e-215
UCT124H	contig_13	6912	6528	384	renamed_GCF_000008685.2	cp32-8	5396	5780	384	100.0	2.931e-83
UCT124H	contig_13	8346	7386	960	renamed_GCF_000008685.2	cp32-3	3962	4922	960	100.0	6.593e-213
UCT124H	contig_16	12787	12214	573	renamed_GCF_000008685.2	lp28-4	13264	13837	573	100.0	2.579e-124
UCT124H	contig_16	14128	13573	555	renamed_GCF_000008685.2	lp28-4	11923	12478	555	100.0	3.559e-126
UCT124H	contig_16	20919	20700	219	renamed_GCF_000008685.2	lp28-4	5127	5346	219	100.0	1.443e-47
UCT124H	contig_1	93433	92887	546	renamed_GCF_000008685.2	chromosome	93423	92877	546	100.0	2.704e-119
UCT124H	contig_1	94042	93442	600	renamed_GCF_000008685.2	chromosome	94032	93432	600	100.0	1.47e-126
UCT124H	contig_1	94615	94228	387	renamed_GCF_000008685.2	chromosome	94605	94218	387	100.0	1.031e-86
UCT124H	contig_1	97876	96952	924	renamed_GCF_000008685.2	chromosome	97866	96942	924	99.6	3.896e-204
UCT124H	contig_1	98825	100214	1389	renamed_GCF_000008685.2	chromosome	98816	100205	1389	100.0	9.726e-316
UCT124H	contig_1	101348	100754	594	renamed_GCF_000008685.2	chromosome	101339	100745	594	100.0	6.255e-135
UCT124H	contig_1	158636	159353	717	renamed_GCF_000008685.2	chromosome	158627	159344	717	100.0	1.01e-158
UCT124H	contig_1	160098	161217	1119	renamed_GCF_000008685.2	chromosome	160089	161208	1119	100.0	2.349e-251
UCT124H	contig_1	162886	163054	168	renamed_GCF_000008685.2	chromosome	162877	163045	168	100.0	5.294e-34
UCT124H	contig_1	165896	164909	987	renamed_GCF_000008685.2	chromosome	165887	164900	987	99.6	2.948e-209
UCT124H	contig_1	169408	167887	1521	renamed_GCF_000008685.2	chromosome	169399	167878	1521	99.4	0.0
UCT124H	contig_1	181415	179549	1866	renamed_GCF_000008685.2	chromosome	181405	179539	1866	100.0	0.0
UCT124H	contig_1	182895	183390	495	renamed_GCF_000008685.2	chromosome	182885	183380	495	100.0	9.271e-106
UCT124H	contig_1	186563	186956	393	renamed_GCF_000008685.2	chromosome	186553	186946	393	100.0	5.626e-86
UCT124H	contig_1	187841	187187	654	renamed_GCF_000008685.2	chromosome	187831	187177	654	99.5	1.397e-144
UCT124H	contig_1	195703	197707	2004	renamed_GCF_000008685.2	chromosome	195692	197696	2004	100.0	0.0
UCT124H	contig_1	245815	246580	765	renamed_GCF_000008685.2	chromosome	245789	246554	765	100.0	7.663e-170
UCT124H	contig_1	248552	250115	1563	renamed_GCF_000008685.2	chromosome	248505	250089	1563	99.8	0.0
UCT124H	contig_1	251237	250682	555	renamed_GCF_000008685.2	chromosome	251211	250656	555	100.0	3.12e-119
UCT124H	contig_1	252459	253065	606	renamed_GCF_000008685.2	chromosome	252433	253039	606	100.0	4.115e-133
UCT124H	contig_1	272706	270513	2193	renamed_GCF_000008685.2	chromosome	272641	270487	2193	99.8	0.0
UCT124H	contig_1	273879	275262	1383	renamed_GCF_000008685.2	chromosome	273856	275236	1383	99.7	2.662e-303
UCT124H	contig_1	276583	277090	507	renamed_GCF_000008685.2	chromosome	276671	277064	507	100.0	6.298e-87
UCT124H	contig_1	279084	278562	522	renamed_GCF_000008685.2	chromosome	279058	278536	522	100.0	3.966e-111
UCT124H	contig_1	281337	279432	1905	renamed_GCF_000008685.2	chromosome	281311	279406	1905	99.5	0.0
UCT124H	contig_1	281819	281339	480	renamed_GCF_000008685.2	chromosome	281793	281313	480	98.7	1.181e-100
UCT124H	contig_1	319662	319131	531	renamed_GCF_000008685.2	chromosome	319636	319105	531	100.0	1.699e-113
UCT124H	contig_1	320334	321378	1044	renamed_GCF_000008685.2	chromosome	320308	321352	1044	99.7	6.693e-227
UCT124H	contig_1	322872	322065	807	renamed_GCF_000008685.2	chromosome	322846	322039	807	98.8	1.019e-173
UCT124H	contig_1	325262	323801	1461	renamed_GCF_000008685.2	chromosome	325236	323775	1461	99.7	0.0
UCT124H	contig_1	342360	343233	873	renamed_GCF_000008685.2	chromosome	342334	343207	873	100.0	1.573e-188
UCT124H	contig_1	345088	346390	1302	renamed_GCF_000008685.2	chromosome	345062	346364	1302	99.5	6.653e-288
UCT124H	contig_1	348186	347376	810	renamed_GCF_000008685.2	chromosome	348160	347350	810	99.6	9.327e-184
UCT124H	contig_1	351074	349625	1449	renamed_GCF_000008685.2	chromosome	351045	349599	1449	99.3	1.563e-320
UCT124H	contig_1	365106	364155	951	renamed_GCF_000008685.2	chromosome	364972	364129	951	99.6	1.174e-187
UCT124H	contig_1	397502	397127	375	renamed_GCF_000008685.2	chromosome	397476	397101	375	100.0	1.385e-81
UCT124H	contig_1	405643	405268	375	renamed_GCF_000008685.2	chromosome	405617	405242	375	99.1	2.753e-74
UCT124H	contig_1	406887	406206	681	renamed_GCF_000008685.2	chromosome	406861	406180	681	100.0	2.702e-150
UCT124H	contig_1	417127	417739	612	renamed_GCF_000008685.2	chromosome	417101	417713	612	100.0	4.975e-132
UCT124H	contig_1	419532	418413	1119	renamed_GCF_000008685.2	chromosome	419506	418387	1119	100.0	8.015e-255
UCT124H	contig_1	421579	422209	630	renamed_GCF_000008685.2	chromosome	421553	422183	630	97.6	7.579e-139
UCT124H	contig_1	424474	423850	624	renamed_GCF_000008685.2	chromosome	424442	423821	624	99.5	4.527e-135
UCT124H	contig_1	425611	426739	1128	renamed_GCF_000008685.2	chromosome	425583	426711	1128	100.0	1.044e-244
UCT124H	contig_1	448732	449338	606	renamed_GCF_000008685.2	chromosome	448707	449310	606	99.5	2.46e-130
UCT124H	contig_1	510860	511649	789	renamed_GCF_000008685.2	chromosome	510835	511624	789	100.0	3.149e-175
UCT124H	contig_1	513164	512417	747	renamed_GCF_000008685.2	chromosome	513139	512392	747	100.0	7.284e-159
UCT124H	contig_1	514548	515808	1260	renamed_GCF_000008685.2	chromosome	514523	515783	1260	99.5	1.335e-281
UCT124H	contig_1	535621	535198	423	renamed_GCF_000008685.2	chromosome	535600	535177	423	100.0	5.606e-91
UCT124H	contig_1	537540	538329	789	renamed_GCF_000008685.2	chromosome	537543	538308	789	99.2	6.654e-167
UCT124H	contig_1	542283	543045	762	renamed_GCF_000008685.2	chromosome	542262	543024	762	99.2	1.347e-171
UCT124H	contig_1	543852	544626	774	renamed_GCF_000008685.2	chromosome	543831	544605	774	99.6	1.962e-169
UCT124H	contig_1	557924	557306	618	renamed_GCF_000008685.2	chromosome	558024	557406	618	100.0	1.216e-131
UCT124H	contig_1	592393	595837	3444	renamed_GCF_000008685.2	chromosome	592445	595931	3444	99.9	0.0
UCT124H	contig_1	599282	598493	789	renamed_GCF_000008685.2	chromosome	599376	598587	789	99.2	1.175e-177
UCT124H	contig_1	600915	602250	1335	renamed_GCF_000008685.2	chromosome	601009	602344	1335	100.0	3.161e-293
UCT124H	contig_1	618465	616317	2148	renamed_GCF_000008685.2	chromosome	618559	616411	2148	100.0	0.0
UCT124H	contig_1	621859	620950	909	renamed_GCF_000008685.2	chromosome	621953	621044	909	99.3	3.709e-202
UCT124H	contig_1	623356	624913	1557	renamed_GCF_000008685.2	chromosome	623450	625007	1557	98.2	0.0
UCT124H	contig_1	626191	626944	753	renamed_GCF_000008685.2	chromosome	626285	627038	753	100.0	9.23e-166
UCT124H	contig_1	630604	629101	1503	renamed_GCF_000008685.2	chromosome	630698	629195	1503	100.0	0.0
UCT124H	contig_1	644677	645046	369	renamed_GCF_000008685.2	chromosome	644771	645140	369	100.0	1.529e-79
UCT124H	contig_1	645624	646587	963	renamed_GCF_000008685.2	chromosome	645718	646681	963	100.0	1.162e-215
UCT124H	contig_1	701296	701707	411	renamed_GCF_000008685.2	chromosome	701394	701805	411	98.5	1.377e-87
UCT124H	contig_1	702868	702184	684	renamed_GCF_000008685.2	chromosome	702951	702282	684	99.0	4.984e-144
UCT124H	contig_1	703832	704861	1029	renamed_GCF_000008685.2	chromosome	703960	704959	1029	99.3	3.786e-222
UCT124H	contig_1	705479	706505	1026	renamed_GCF_000008685.2	chromosome	705579	706605	1026	100.0	2.737e-225
UCT124H	contig_1	709173	710574	1401	renamed_GCF_000008685.2	chromosome	709273	710674	1401	99.7	9.148e-310
UCT124H	contig_1	711110	711551	441	renamed_GCF_000008685.2	chromosome	711210	711651	441	100.0	1.245e-93
UCT124H	contig_1	713150	712103	1047	renamed_GCF_000008685.2	chromosome	713250	712203	1047	99.7	8.437e-225
UCT124H	contig_1	714666	714003	663	renamed_GCF_000008685.2	chromosome	714766	714103	663	99.5	6.591e-146
UCT124H	contig_1	716519	717671	1152	renamed_GCF_000008685.2	chromosome	716619	717771	1152	100.0	1.261e-246
UCT124H	contig_1	718726	720988	2262	renamed_GCF_000008685.2	chromosome	718826	721088	2262	99.8	0.0
UCT124H	contig_1	740138	740321	183	renamed_GCF_000008685.2	chromosome	740239	740422	183	100.0	1.805e-39
UCT124H	contig_1	740586	741324	738	renamed_GCF_000008685.2	chromosome	740687	741425	738	100.0	4.772e-162
UCT124H	contig_1	742642	744415	1773	renamed_GCF_000008685.2	chromosome	742743	744516	1773	99.1	0.0
UCT124H	contig_1	745200	746232	1032	renamed_GCF_000008685.2	chromosome	745301	746333	1032	99.1	2.74e-226
UCT124H	contig_1	749930	750689	759	renamed_GCF_000008685.2	chromosome	750030	750789	759	100.0	2.255e-165
UCT124H	contig_1	752069	753119	1050	renamed_GCF_000008685.2	chromosome	752169	753219	1050	100.0	6.109e-229
UCT124H	contig_1	753967	754450	483	renamed_GCF_000008685.2	chromosome	754067	754550	483	99.3	6.952e-107
UCT124H	contig_1	756253	757570	1317	renamed_GCF_000008685.2	chromosome	756353	757670	1317	99.5	6.378e-291
UCT124H	contig_1	759485	760115	630	renamed_GCF_000008685.2	chromosome	759585	760215	630	99.0	1.853e-137
UCT124H	contig_1	763478	764261	783	renamed_GCF_000008685.2	chromosome	763578	764361	783	100.0	1.874e-171
UCT124H	contig_1	765272	766616	1344	renamed_GCF_000008685.2	chromosome	765372	766716	1344	100.0	2.685e-305
UCT124H	contig_1	769370	767978	1392	renamed_GCF_000008685.2	chromosome	769470	768078	1392	99.5	8.367e-292
UCT124H	contig_1	771463	771061	402	renamed_GCF_000008685.2	chromosome	771563	771161	402	100.0	3.917e-83
UCT124H	contig_1	774576	775362	786	renamed_GCF_000008685.2	chromosome	774676	775462	786	100.0	1.17e-168
UCT124H	contig_1	776684	777473	789	renamed_GCF_000008685.2	chromosome	776784	777573	789	99.2	2.06e-171
UCT124H	contig_1	778657	781285	2628	renamed_GCF_000008685.2	chromosome	778757	781385	2628	99.8	0.0
UCT124H	contig_1	783148	782875	273	renamed_GCF_000008685.2	chromosome	783248	782975	273	100.0	3.858e-54
UCT124H	contig_1	807867	806820	1047	renamed_GCF_000008685.2	chromosome	807966	806919	1047	99.4	5.83e-229
UCT124H	contig_1	809453	808361	1092	renamed_GCF_000008685.2	chromosome	809552	808460	1092	99.4	1.916e-240
UCT124H	contig_1	811411	810370	1041	renamed_GCF_000008685.2	chromosome	811510	810469	1041	99.7	3.047e-235
UCT124H	contig_1	813140	812339	801	renamed_GCF_000008685.2	chromosome	813239	812438	801	100.0	9.279e-174
UCT124H	contig_1	814607	813599	1008	renamed_GCF_000008685.2	chromosome	814697	813689	1008	99.7	5.719e-214
UCT124H	contig_1	822258	822609	351	renamed_GCF_000008685.2	chromosome	822343	822694	351	100.0	6.889e-77
UCT124H	contig_1	823177	823726	549	renamed_GCF_000008685.2	chromosome	823262	823811	549	99.4	8.399e-116
UCT124H	contig_1	824296	825619	1323	renamed_GCF_000008685.2	chromosome	824381	825704	1323	100.0	8.966e-297
UCT124H	contig_1	827545	829027	1482	renamed_GCF_000008685.2	chromosome	827630	829112	1482	99.5	0.0
UCT124H	contig_1	830856	830232	624	renamed_GCF_000008685.2	chromosome	830941	830317	624	99.5	5.702e-141
UCT124H	contig_1	848452	848719	267	renamed_GCF_000008685.2	chromosome	848537	848804	267	100.0	3.495e-54
UCT124H	contig_1	850908	852429	1521	renamed_GCF_000008685.2	chromosome	850993	852514	1521	99.6	0.0
UCT124H	contig_1	853689	854757	1068	renamed_GCF_000008685.2	chromosome	853774	854842	1068	100.0	1.362e-231
UCT124H	contig_1	855903	857424	1521	renamed_GCF_000008685.2	chromosome	855988	857509	1521	99.4	0.0
UCT124H	contig_1	860026	858853	1173	renamed_GCF_000008685.2	chromosome	860111	858938	1173	99.4	3.135e-257
UCT124H	contig_1	869939	869423	516	renamed_GCF_000008685.2	chromosome	870023	869507	516	98.8	8.019e-111
UCT124H	contig_1	875048	872501	2547	renamed_GCF_000008685.2	chromosome	875132	872585	2547	100.0	0.0
UCT124H	contig_1	876344	879197	2853	renamed_GCF_000008685.2	chromosome	876491	879281	2853	99.8	0.0
UCT124H	contig_1	881007	880182	825	renamed_GCF_000008685.2	chromosome	881091	880266	825	98.1	3.813e-179
UCT124H	contig_1	886363	884143	2220	renamed_GCF_000008685.2	chromosome	886447	884227	2220	99.5	0.0
UCT124H	contig_2	4223	2969	1254	renamed_GCF_000008685.2	lp54	4256	3002	1254	100.0	3.245e-279
UCT124H	contig_2	5608	6481	873	renamed_GCF_000008685.2	lp54	5645	6518	873	100.0	2.408e-192
UCT124H	contig_2	40071	39831	240	renamed_GCF_000008685.2	lp54	40112	39872	240	100.0	3.722e-49
UCT124H	contig_2	51530	52304	774	renamed_GCF_000008685.2	lp54	51705	52479	774	100.0	9.219e-161
UCT124H	contig_3	4562	5483	921	renamed_GCF_000008685.2	lp38	4575	5496	921	99.6	1.905e-194
UCT124H	contig_3	11245	10657	588	renamed_GCF_000008685.2	lp38	11105	10517	588	100.0	1.006e-128
UCT124H	contig_3	28201	27142	1059	renamed_GCF_000008685.2	lp38	28053	26994	1059	98.8	7.708e-228
UCT124H	contig_3	31370	32288	918	renamed_GCF_000008685.2	lp38	31219	32140	918	99.6	1.1e-208
UCT124H	contig_4	20447	21530	1083	renamed_GCF_000008685.2	lp36	20388	21453	1083	97.7	5.037e-228
UCT124H	contig_4	34105	33106	999	renamed_GCF_000008685.2	lp36	34079	33080	999	99.6	4.532e-215
UCT124H	contig_5	5426	4313	1113	renamed_GCF_000008685.2	cp32-7	6702	7815	1113	100.0	3.095e-247
UCT124H	contig_5	17040	17817	777	renamed_GCF_000008685.2	lp56	29506	28729	777	97.6	2.057e-169
UCT124H	contig_6	8241	8004	237	renamed_GCF_000008685.2	cp32-7	8725	8962	237	100.0	7.893e-49
UCT124H	contig_6	9137	8708	429	renamed_GCF_000008685.2	cp32-6	7837	8266	429	100.0	5.601e-92
UCT124H	contig_6	18319	16966	1353	renamed_GCF_000008685.2	cp32-7	29447	30800	1353	100.0	5.71e-307
UCT124H	contig_6	21615	20925	690	renamed_GCF_000008685.2	cp32-7	26151	26841	690	100.0	3.421e-149
UCT124H	contig_6	23254	22828	426	renamed_GCF_000008685.2	cp32-7	24512	24938	426	100.0	8.056e-96
UCT124H	contig_7	19802	19235	567	renamed_GCF_000008685.2	cp32-1	28834	29401	567	97.3	8.392e-119
UCT124H	contig_7	20521	19981	540	renamed_GCF_000008685.2	cp32-8	28250	28790	540	100.0	1.472e-116
UCT124H	contig_7	21841	20704	1137	renamed_GCF_000008685.2	cp32-1	26795	27932	1137	100.0	3.741e-249
UCT124H	contig_7	22390	21868	522	renamed_GCF_000008685.2	cp32-8	26381	26903	522	100.0	1.338e-114
UCT124H	contig_7	22820	23597	777	renamed_GCF_000008685.2	cp32-1	25816	25039	777	100.0	2.863e-174
UCT124H	contig_8	9245	9449	204	renamed_GCF_000008685.2	cp32-4	15166	15370	204	100.0	2.578e-39
UCT124H	contig_8	9789	10125	336	renamed_GCF_000008685.2	cp32-8	15758	16094	336	100.0	5.348e-69
UCT124H	contig_8	10117	10471	354	renamed_GCF_000008685.2	cp32-4	16038	16392	354	100.0	6.554e-78
UCT124H	contig_8	10575	11076	501	renamed_GCF_000008685.2	cp32-4	16496	16997	501	100.0	5.048e-105
UCT124H	contig_9	6556	7012	456	renamed_GCF_000008685.2	cp32-6	8281	8737	456	100.0	1.971e-99
UCT124H	contig_9	7252	8530	1278	renamed_GCF_000008685.2	cp32-3	8967	10242	1278	99.0	1.815e-272
UCT124H	contig_9	9239	10190	951	renamed_GCF_000008685.2	cp32-6	10961	11912	951	99.3	2.14e-215
UCT124H	contig_9	10782	11115	333	renamed_GCF_000008685.2	cp32-8	12494	12827	333	100.0	8.424e-72
UCT124H	contig_10	6752	7304	552	renamed_GCF_000008685.2	lp28-2	6736	7288	552	100.0	2.704e-120
UCT124H	contig_10	12335	11516	819	renamed_GCF_000008685.2	lp28-2	12319	11500	819	100.0	1.075e-183
UCT124H	contig_10	13157	12764	393	renamed_GCF_000008685.2	lp28-2	13141	12748	393	100.0	6.841e-84
UCT124H	contig_10	14901	14391	510	renamed_GCF_000008685.2	lp28-2	14885	14375	510	100.0	3.606e-110
UCT124H	contig_10	16498	15472	1026	renamed_GCF_000008685.2	lp28-2	16482	15456	1026	100.0	1.723e-230
UCT124H	contig_14	13716	13020	696	renamed_GCF_000008685.2	cp26	21897	22593	696	99.5	6.925e-151
UCT124H	contig_14	14249	14756	507	renamed_GCF_000008685.2	cp26	21364	20857	507	100.0	3.123e-111
UCT124H	contig_14	16292	17648	1356	renamed_GCF_000008685.2	cp26	19321	17965	1356	98.6	1.168e-290
UCT124H	contig_14	18970	20509	1539	renamed_GCF_000008685.2	cp26	16667	15131	1539	98.6	0.0
UCT124H	contig_14	23627	22034	1593	renamed_GCF_000008685.2	cp26	12013	13606	1593	99.8	0.0
UCT124H	contig_14	25537	24988	549	renamed_GCF_000008685.2	cp26	10103	10652	549	99.4	1.544e-117
UCT124H	contig_17	13487	12923	564	renamed_GCF_000008685.2	lp25	13393	12829	564	100.0	4.519e-125
UCT124H	contig_17	15672	15135	537	renamed_GCF_000008685.2	lp25	15545	15041	537	99.4	7.638e-115
UCT124H	contig_17	22776	22044	732	renamed_GCF_000008685.2	lp25	22677	21945	732	100.0	5.239e-160
UCT124H	contig_19	4205	4559	354	renamed_GCF_000008685.2	cp32-9	16183	16537	354	98.2	1.61e-76
UCT124H	contig_19	5323	5752	429	renamed_GCF_000008685.2	cp32-9	17301	17730	429	100.0	2.284e-93
UCT124H	contig_1	10594	11434	840	renamed_GCF_000008685.2	chromosome	10580	11420	840	100.0	7.775e-191
UCT124H	contig_1	11434	12175	741	renamed_GCF_000008685.2	chromosome	11420	12161	741	99.5	9.218e-164
UCT124H	contig_1	12759	14742	1983	renamed_GCF_000008685.2	chromosome	12745	14728	1983	100.0	0.0
UCT124H	contig_1	15359	14738	621	renamed_GCF_000008685.2	chromosome	15345	14724	621	100.0	3.249e-138
UCT124H	contig_1	15736	15358	378	renamed_GCF_000008685.2	chromosome	15716	15344	378	100.0	1.768e-79
UCT124H	contig_1	18318	17805	513	renamed_GCF_000008685.2	chromosome	18304	17791	513	100.0	1.701e-110
UCT124H	contig_1	39653	38150	1503	renamed_GCF_000008685.2	chromosome	39638	38135	1503	100.0	0.0
UCT124H	contig_1	42498	41457	1041	renamed_GCF_000008685.2	chromosome	42483	41442	1041	99.7	4.413e-231
UCT124H	contig_1	59051	58043	1008	renamed_GCF_000008685.2	chromosome	58982	58028	1008	99.6	2.659e-205
UCT124H	contig_1	60547	60049	498	renamed_GCF_000008685.2	chromosome	60533	60035	498	99.3	3.608e-108
UCT124H	contig_1	64051	65290	1239	renamed_GCF_000008685.2	chromosome	64037	65276	1239	100.0	5.707e-279
UCT124H	contig_1	70384	71233	849	renamed_GCF_000008685.2	chromosome	70141	71219	849	98.9	5.332e-188
UCT124H	contig_1	72660	73506	846	renamed_GCF_000008685.2	chromosome	72646	73492	846	99.6	1.292e-177
UCT124H	contig_1	76463	77714	1251	renamed_GCF_000008685.2	chromosome	76450	77701	1251	100.0	1.724e-268
UCT124H	contig_1	79365	79014	351	renamed_GCF_000008685.2	chromosome	79322	79001	351	100.0	3.732e-67
UCT124H	contig_1	112777	112357	420	renamed_GCF_000008685.2	chromosome	112769	112349	420	99.2	1.444e-88
UCT124H	contig_1	114814	115516	702	renamed_GCF_000008685.2	chromosome	114806	115508	702	98.2	5.74e-154
UCT124H	contig_1	118378	117685	693	renamed_GCF_000008685.2	chromosome	118370	117677	693	98.6	1.337e-151
UCT124H	contig_1	119811	118971	840	renamed_GCF_000008685.2	chromosome	119803	118963	840	99.6	2.17e-179
UCT124H	contig_1	147505	146386	1119	renamed_GCF_000008685.2	chromosome	147495	146376	1119	99.7	8.28e-246
UCT124H	contig_1	150982	152188	1206	renamed_GCF_000008685.2	chromosome	150973	152179	1206	99.5	5.928e-273
UCT124H	contig_1	156409	153709	2700	renamed_GCF_000008685.2	chromosome	156400	153700	2700	100.0	0.0
UCT124H	contig_1	156470	157607	1137	renamed_GCF_000008685.2	chromosome	156461	157598	1137	100.0	1.164e-253
UCT124H	contig_1	217306	218338	1032	renamed_GCF_000008685.2	chromosome	217277	218312	1032	99.7	4.772e-220
UCT124H	contig_1	219660	219081	579	renamed_GCF_000008685.2	chromosome	219634	219055	579	100.0	8.388e-121
UCT124H	contig_1	219825	220665	840	renamed_GCF_000008685.2	chromosome	219799	220639	840	99.6	8.103e-182
UCT124H	contig_1	221659	223204	1545	renamed_GCF_000008685.2	chromosome	221741	223178	1545	98.9	3.462e-310
UCT124H	contig_1	235560	235314	246	renamed_GCF_000008685.2	chromosome	235534	235288	246	98.7	3.025e-52
UCT124H	contig_1	237655	237247	408	renamed_GCF_000008685.2	chromosome	237629	237221	408	100.0	2.649e-88
UCT124H	contig_1	238252	237994	258	renamed_GCF_000008685.2	chromosome	238226	237968	258	100.0	9.113e-51
UCT124H	contig_1	297495	297063	432	renamed_GCF_000008685.2	chromosome	297469	297037	432	99.3	2.176e-94
UCT124H	contig_1	298802	297491	1311	renamed_GCF_000008685.2	chromosome	298776	297465	1311	100.0	6.981e-289
UCT124H	contig_1	310548	309804	744	renamed_GCF_000008685.2	chromosome	310523	309779	744	99.5	1.166e-161
UCT124H	contig_1	311678	310583	1095	renamed_GCF_000008685.2	chromosome	311617	310558	1095	99.7	2.491e-229
UCT124H	contig_1	314149	312757	1392	renamed_GCF_000008685.2	chromosome	314123	312728	1392	99.7	5.166e-306
UCT124H	contig_1	316169	315332	837	renamed_GCF_000008685.2	chromosome	316143	315306	837	100.0	2.887e-184
UCT124H	contig_1	327753	326724	1029	renamed_GCF_000008685.2	chromosome	327757	326698	1029	99.4	3.658e-231
UCT124H	contig_1	328057	329191	1134	renamed_GCF_000008685.2	chromosome	328031	329165	1134	100.0	5.485e-253
UCT124H	contig_1	329287	329647	360	renamed_GCF_000008685.2	chromosome	329261	329621	360	100.0	1.609e-77
UCT124H	contig_1	330778	329668	1110	renamed_GCF_000008685.2	chromosome	330752	329642	1110	99.4	5.455e-249
UCT124H	contig_1	355516	356935	1419	renamed_GCF_000008685.2	chromosome	355490	356909	1419	100.0	1.415e-316
UCT124H	contig_1	357032	358466	1434	renamed_GCF_000008685.2	chromosome	357006	358440	1434	100.0	9.657e-315
UCT124H	contig_1	358483	359224	741	renamed_GCF_000008685.2	chromosome	358457	359198	741	100.0	9.218e-164
UCT124H	contig_1	359521	359242	279	renamed_GCF_000008685.2	chromosome	359495	359216	279	100.0	2.841e-58
UCT124H	contig_1	361104	359538	1566	renamed_GCF_000008685.2	chromosome	361078	359512	1566	100.0	0.0
UCT124H	contig_1	361225	362347	1122	renamed_GCF_000008685.2	chromosome	361187	362321	1122	100.0	1.01e-252
UCT124H	contig_1	384312	385452	1140	renamed_GCF_000008685.2	chromosome	384286	385426	1140	100.0	7.242e-251
UCT124H	contig_1	385474	386188	714	renamed_GCF_000008685.2	chromosome	385448	386162	714	100.0	3.427e-153
UCT124H	contig_1	386184	387363	1179	renamed_GCF_000008685.2	chromosome	386158	387337	1179	100.0	1.981e-263
UCT124H	contig_1	387359	387833	474	renamed_GCF_000008685.2	chromosome	387333	387807	474	100.0	1.339e-106
UCT124H	contig_1	410812	411472	660	renamed_GCF_000008685.2	chromosome	410786	411446	660	98.6	5.474e-139
UCT124H	contig_1	413026	411481	1545	renamed_GCF_000008685.2	chromosome	413006	411455	1545	99.4	0.0
UCT124H	contig_1	413138	414341	1203	renamed_GCF_000008685.2	chromosome	413112	414315	1203	100.0	6.394e-263
UCT124H	contig_1	415819	414352	1467	renamed_GCF_000008685.2	chromosome	415793	414326	1467	99.5	0.0
UCT124H	contig_1	416549	415871	678	renamed_GCF_000008685.2	chromosome	416478	415845	678	99.5	1.008e-143
UCT124H	contig_1	416714	417131	417	renamed_GCF_000008685.2	chromosome	416688	417105	417	100.0	1.248e-89
UCT124H	contig_1	426763	427978	1215	renamed_GCF_000008685.2	chromosome	426735	427950	1215	99.7	8.445e-262
UCT124H	contig_1	428014	428650	636	renamed_GCF_000008685.2	chromosome	427986	428622	636	100.0	3.41e-140
UCT124H	contig_1	428673	429702	1029	renamed_GCF_000008685.2	chromosome	428645	429674	1029	100.0	3.872e-239
UCT124H	contig_1	430644	429720	924	renamed_GCF_000008685.2	chromosome	430616	429692	924	100.0	4.275e-203
UCT124H	contig_1	462846	463914	1068	renamed_GCF_000008685.2	chromosome	462818	463886	1068	99.7	4.927e-243
UCT124H	contig_1	464080	465160	1080	renamed_GCF_000008685.2	chromosome	464052	465132	1080	100.0	9.122e-247
UCT124H	contig_1	467306	465545	1761	renamed_GCF_000008685.2	chromosome	467278	465517	1761	100.0	0.0
UCT124H	contig_1	469415	467309	2106	renamed_GCF_000008685.2	chromosome	469387	467281	2106	100.0	0.0
UCT124H	contig_1	469693	469417	276	renamed_GCF_000008685.2	chromosome	469665	469389	276	100.0	1.644e-55
UCT124H	contig_1	469999	469705	294	renamed_GCF_000008685.2	chromosome	469971	469677	294	100.0	2.2e-63
UCT124H	contig_1	489516	489744	228	renamed_GCF_000008685.2	chromosome	489539	489719	228	98.3	7.248e-33
UCT124H	contig_1	489757	490579	822	renamed_GCF_000008685.2	chromosome	489732	490554	822	99.6	6.11e-182
UCT124H	contig_1	490668	491952	1284	renamed_GCF_000008685.2	chromosome	490643	491927	1284	99.7	9.564e-281
UCT124H	contig_1	492612	493977	1365	renamed_GCF_000008685.2	chromosome	492587	493952	1365	100.0	1.721e-296
UCT124H	contig_1	529218	528123	1095	renamed_GCF_000008685.2	chromosome	529198	528103	1095	100.0	3.934e-250
UCT124H	contig_1	531125	529217	1908	renamed_GCF_000008685.2	chromosome	531105	529197	1908	100.0	0.0
UCT124H	contig_1	531712	531148	564	renamed_GCF_000008685.2	chromosome	531692	531128	564	100.0	2.704e-122
UCT124H	contig_1	534321	535176	855	renamed_GCF_000008685.2	chromosome	534300	535155	855	100.0	8.967e-192
UCT124H	contig_1	544606	547408	2802	renamed_GCF_000008685.2	chromosome	544585	547387	2802	99.0	0.0
UCT124H	contig_1	548511	547866	645	renamed_GCF_000008685.2	chromosome	548490	547845	645	100.0	1.056e-137
UCT124H	contig_1	548906	548507	399	renamed_GCF_000008685.2	chromosome	548885	548486	399	100.0	1.521e-84
UCT124H	contig_1	549639	548940	699	renamed_GCF_000008685.2	chromosome	549618	548919	699	99.5	5.226e-146
UCT124H	contig_1	573641	571790	1851	renamed_GCF_000008685.2	chromosome	573740	571889	1851	100.0	0.0
UCT124H	contig_1	573753	575148	1395	renamed_GCF_000008685.2	chromosome	573852	575247	1395	99.1	3.123e-312
UCT124H	contig_1	575717	575174	543	renamed_GCF_000008685.2	chromosome	575816	575273	543	98.8	7.636e-116
UCT124H	contig_1	576427	575881	546	renamed_GCF_000008685.2	chromosome	576499	575980	546	100.0	1.781e-115
UCT124H	contig_1	577088	576482	606	renamed_GCF_000008685.2	chromosome	577187	576581	606	100.0	4.975e-131
UCT124H	contig_1	888095	886385	1710	renamed_GCF_000008685.2	chromosome	888179	886469	1710	99.4	0.0
UCT124H	contig_1	897611	897011	600	renamed_GCF_000008685.2	chromosome	897695	897095	600	99.4	6.881e-135
UCT124H	contig_1	899414	900647	1233	renamed_GCF_000008685.2	chromosome	899498	900731	1233	100.0	1.522e-275
UCT124H	contig_2	9419	10241	822	renamed_GCF_000008685.2	lp54	9456	10278	822	99.6	1.415e-172
UCT124H	contig_2	47199	46443	756	renamed_GCF_000008685.2	lp54	47228	46472	756	100.0	2.151e-165
UCT124H	contig_2	49920	49677	243	renamed_GCF_000008685.2	lp54	50077	49852	243	95.9	7.261e-43
UCT124H	contig_3	12029	11291	738	renamed_GCF_000008685.2	lp38	11889	11151	738	100.0	8.004e-165
UCT124H	contig_3	13580	12584	996	renamed_GCF_000008685.2	lp38	13440	12444	996	99.6	1.879e-224
UCT124H	contig_3	17536	18319	783	renamed_GCF_000008685.2	lp38	17387	18170	783	99.6	1.707e-172
UCT124H	contig_3	18362	19403	1041	renamed_GCF_000008685.2	lp38	18213	19254	1041	100.0	2.778e-236
UCT124H	contig_3	20149	21379	1230	renamed_GCF_000008685.2	lp38	20000	21230	1230	99.7	3.642e-265
UCT124H	contig_3	22119	23157	1038	renamed_GCF_000008685.2	lp38	22042	23008	1038	99.0	2.836e-218
UCT124H	contig_5	7188	6732	456	renamed_GCF_000008685.2	cp32-8	4941	5397	456	100.0	1.075e-97
UCT124H	contig_5	22246	21505	741	renamed_GCF_000008685.2	cp32-8	20739	21480	741	99.5	5.003e-162
UCT124H	contig_5	24277	25294	1017	renamed_GCF_000008685.2	cp32-1	18728	17714	1017	99.7	1.801e-228
UCT124H	contig_5	27223	26887	336	renamed_GCF_000008685.2	cp32-9	15855	16191	336	100.0	5.348e-69
UCT124H	contig_8	2734	2971	237	renamed_GCF_000008685.2	cp32-9	8741	8978	237	100.0	1.76e-48
UCT124H	contig_8	5944	6499	555	renamed_GCF_000008685.2	cp32-4	11863	12418	555	97.2	8.397e-117
UCT124H	contig_8	15493	16039	546	renamed_GCF_000008685.2	cp32-4	21414	21960	546	100.0	3.273e-117
UCT124H	contig_8	19513	18718	795	renamed_GCF_000008685.2	cp32-4	25435	24640	795	99.6	6.379e-177
UCT124H	contig_8	20082	20898	816	renamed_GCF_000008685.2	cp32-4	26004	26820	816	99.6	2.278e-183
UCT124H	contig_8	20930	21605	675	renamed_GCF_000008685.2	cp32-4	26852	27527	675	100.0	3.937e-145
UCT124H	contig_8	26388	26952	564	renamed_GCF_000008685.2	cp32-4	2012	2576	564	100.0	2.235e-124
UCT124H	contig_8	27751	28327	576	renamed_GCF_000008685.2	cp32-4	3375	3951	576	100.0	1.005e-126
UCT124H	contig_8	29327	29783	456	renamed_GCF_000008685.2	cp32-4	4951	5407	456	99.3	5.32e-97
UCT124H	contig_9	14045	14381	336	renamed_GCF_000008685.2	cp32-4	15710	16046	336	100.0	5.348e-69
UCT124H	contig_9	15378	15933	555	renamed_GCF_000008685.2	cp32-3	17088	17697	555	91.0	2.485e-113
UCT124H	contig_9	17464	16522	942	renamed_GCF_000008685.2	cp32-3	19228	18286	942	100.0	4.129e-215
UCT124H	contig_9	18950	19517	567	renamed_GCF_000008685.2	cp32-3	20714	21281	567	100.0	2.944e-130
UCT124H	contig_13	10298	9740	558	renamed_GCF_000008685.2	cp32-1	2010	2568	558	100.0	1.105e-122
UCT124H	contig_13	28182	27576	606	renamed_GCF_000008685.2	cp32-1	13708	14314	606	100.0	5.47e-130
UCT124H	contig_13	29396	29063	333	renamed_GCF_000008685.2	cp32-3	12494	12827	333	100.0	8.424e-72
UCT124H	contig_14	2439	1401	1038	renamed_GCF_000008685.2	cp26	6676	7714	1038	99.7	1.895e-231
UCT124H	contig_14	4347	3249	1098	renamed_GCF_000008685.2	cp26	4768	5866	1098	99.7	1.005e-248
UCT124H	contig_15	24603	23604	999	renamed_GCF_000008685.2	lp28-1	466	1465	999	100.0	6.954e-219
UCT124H	contig_19	12590	13016	426	renamed_GCF_000008685.2	cp32-9	24571	24997	426	100.0	1.627e-96
UCT124H	contig_19	14229	14790	561	renamed_GCF_000008685.2	cp32-9	26209	26770	561	100.0	4.739e-124
UCT124H	contig_19	14817	15849	1032	renamed_GCF_000008685.2	cp32-9	26797	27829	1032	99.7	6.089e-226
UCT124H	contig_19	16045	16564	519	renamed_GCF_000008685.2	cp32-9	28025	28544	519	99.4	3.122e-113
UCT124H	contig_19	16860	17322	462	renamed_GCF_000008685.2	cp32-9	28849	29302	462	99.3	3.193e-95
UCT124H	contig_19	17318	18671	1353	renamed_GCF_000008685.2	cp32-9	29298	30651	1353	99.5	1.524e-304
UCT124H	contig_19	18736	19963	1227	renamed_GCF_000008685.2	cp32-9	65	1292	1227	99.5	2.407e-269
UCT124H	contig_19	19979	20672	693	renamed_GCF_000008685.2	cp32-9	1308	2001	693	100.0	5.226e-145
UCT124H	contig_19	20683	21250	567	renamed_GCF_000008685.2	cp32-9	2012	2579	567	99.4	2.344e-124
UCT124H	contig_23	2976	4077	1101	renamed_GCF_000008685.2	lp28-1	15451	14350	1101	99.4	5.702e-247
UCT124H	contig_23	4098	4659	561	renamed_GCF_000008685.2	lp28-1	14329	13768	561	100.0	4.308e-125
UCT124H	contig_23	4634	5399	765	renamed_GCF_000008685.2	lp28-1	13793	13028	765	100.0	1.871e-168
UCT124H	contig_23	5435	5987	552	renamed_GCF_000008685.2	lp28-1	12992	12440	552	100.0	6.015e-120
UCT124H	contig_23	7436	7730	294	renamed_GCF_000008685.2	lp28-1	10895	10697	294	100.0	9.155e-41
UCT124H	contig_24	659	290	369	renamed_GCF_000008685.2	lp28-4	735	1104	369	99.1	7.577e-79
UCT124H	contig_24	1152	786	366	renamed_GCF_000008685.2	lp21	252	618	366	98.3	3.947e-77
UCT124H	contig_33	394	28	366	renamed_GCF_000008685.2	lp28-4	26359	26914	366	92.6	1.18e-73
UCT124H	contig_1	96963	94620	2343	renamed_GCF_000008685.2	chromosome	96953	94610	2343	99.4	0.0
UCT124H	contig_1	98790	97872	918	renamed_GCF_000008685.2	chromosome	98648	97862	918	99.2	2.343e-174
UCT124H	contig_1	100236	100758	522	renamed_GCF_000008685.2	chromosome	100227	100749	522	100.0	2.976e-114
UCT124H	contig_1	121090	120811	279	renamed_GCF_000008685.2	chromosome	121082	120803	279	100.0	1.411e-57
UCT124H	contig_1	159376	160051	675	renamed_GCF_000008685.2	chromosome	159367	160042	675	100.0	1.946e-144
UCT124H	contig_1	162810	161208	1602	renamed_GCF_000008685.2	chromosome	162801	161199	1602	100.0	0.0
UCT124H	contig_1	164829	163080	1749	renamed_GCF_000008685.2	chromosome	164820	163071	1749	100.0	0.0
UCT124H	contig_1	167768	165923	1845	renamed_GCF_000008685.2	chromosome	167759	165914	1845	99.5	0.0
UCT124H	contig_1	179553	178926	627	renamed_GCF_000008685.2	chromosome	179543	178916	627	100.0	1.275e-132
UCT124H	contig_1	182812	181417	1395	renamed_GCF_000008685.2	chromosome	182802	181407	1395	100.0	4.219e-300
UCT124H	contig_1	186958	187204	246	renamed_GCF_000008685.2	chromosome	186948	187194	246	100.0	9.168e-49
UCT124H	contig_1	188247	187833	414	renamed_GCF_000008685.2	chromosome	188237	187823	414	99.2	2.918e-88
UCT124H	contig_1	245405	244802	603	renamed_GCF_000008685.2	chromosome	245382	244776	603	99.5	7.936e-134
UCT124H	contig_1	246622	248128	1506	renamed_GCF_000008685.2	chromosome	246596	248102	1506	100.0	0.0
UCT124H	contig_1	250696	250201	495	renamed_GCF_000008685.2	chromosome	250670	250175	495	99.3	1.124e-103
UCT124H	contig_1	252263	251237	1026	renamed_GCF_000008685.2	chromosome	252237	251211	1026	99.7	2.737e-225
UCT124H	contig_1	253184	254957	1773	renamed_GCF_000008685.2	chromosome	253158	254931	1773	99.8	0.0
UCT124H	contig_1	273673	272659	1014	renamed_GCF_000008685.2	chromosome	273647	272633	1014	99.7	6.069e-223
UCT124H	contig_1	276522	275268	1254	renamed_GCF_000008685.2	chromosome	276496	275242	1254	99.7	2.463e-282
UCT124H	contig_1	278585	277115	1470	renamed_GCF_000008685.2	chromosome	278559	277089	1470	100.0	8.9e-322
UCT124H	contig_1	279406	279103	303	renamed_GCF_000008685.2	chromosome	279380	279077	303	98.0	2.549e-63
UCT124H	contig_1	282713	281825	888	renamed_GCF_000008685.2	chromosome	282687	281799	888	100.0	4.025e-189
UCT124H	contig_1	319142	318302	840	renamed_GCF_000008685.2	chromosome	319116	318276	840	99.6	1.977e-180
UCT124H	contig_1	320284	319705	579	renamed_GCF_000008685.2	chromosome	320249	319679	579	99.4	6.936e-123
UCT124H	contig_1	321377	322064	687	renamed_GCF_000008685.2	chromosome	321351	322038	687	99.5	6.603e-150
UCT124H	contig_1	323805	322872	933	renamed_GCF_000008685.2	chromosome	323779	322846	933	100.0	1.839e-205
UCT124H	contig_1	326314	325261	1053	renamed_GCF_000008685.2	chromosome	326288	325235	1053	100.0	4.032e-234
UCT124H	contig_1	341299	342349	1050	renamed_GCF_000008685.2	chromosome	341273	342323	1050	100.0	1.489e-227
UCT124H	contig_1	343233	344205	972	renamed_GCF_000008685.2	chromosome	343207	344179	972	100.0	3.579e-213
UCT124H	contig_1	346867	346456	411	renamed_GCF_000008685.2	chromosome	346841	346430	411	100.0	6.821e-87
UCT124H	contig_1	347327	346886	441	renamed_GCF_000008685.2	chromosome	347301	346860	441	100.0	1.706e-98
UCT124H	contig_1	349636	348178	1458	renamed_GCF_000008685.2	chromosome	349610	348152	1458	100.0	0.0
UCT124H	contig_1	395192	394130	1062	renamed_GCF_000008685.2	chromosome	395166	394104	1062	100.0	1.904e-235
UCT124H	contig_1	397103	396629	474	renamed_GCF_000008685.2	chromosome	397077	396603	474	100.0	4.822e-101
UCT124H	contig_1	401703	397569	4134	renamed_GCF_000008685.2	chromosome	401677	397543	4134	99.7	0.0
UCT124H	contig_1	406202	405713	489	renamed_GCF_000008685.2	chromosome	406176	405687	489	100.0	1.238e-101
UCT124H	contig_1	407318	406886	432	renamed_GCF_000008685.2	chromosome	407292	406860	432	100.0	3.534e-89
UCT124H	contig_1	417749	418361	612	renamed_GCF_000008685.2	chromosome	417723	418335	612	99.5	1.531e-136
UCT124H	contig_1	421406	419528	1878	renamed_GCF_000008685.2	chromosome	421380	419502	1878	99.0	0.0
UCT124H	contig_1	423083	423863	780	renamed_GCF_000008685.2	chromosome	423054	423834	780	100.0	3.296e-173
UCT124H	contig_1	424721	425579	858	renamed_GCF_000008685.2	chromosome	424693	425551	858	100.0	1.579e-194
UCT124H	contig_1	479733	481044	1311	renamed_GCF_000008685.2	chromosome	479708	481019	1311	100.0	7.438e-297
UCT124H	contig_1	482624	484307	1683	renamed_GCF_000008685.2	chromosome	482599	484282	1683	99.8	0.0
UCT124H	contig_1	484787	485291	504	renamed_GCF_000008685.2	chromosome	484756	485266	504	100.0	1.216e-112
UCT124H	contig_1	486098	486794	696	renamed_GCF_000008685.2	chromosome	486073	486769	696	100.0	2.835e-152
UCT124H	contig_1	487559	488249	690	renamed_GCF_000008685.2	chromosome	487534	488224	690	100.0	9.609e-155
UCT124H	contig_1	489007	489520	513	renamed_GCF_000008685.2	chromosome	488982	489495	513	99.4	3.437e-111
UCT124H	contig_1	499080	499359	279	renamed_GCF_000008685.2	chromosome	499055	499334	279	100.0	1.411e-57
UCT124H	contig_1	499731	500613	882	renamed_GCF_000008685.2	chromosome	499706	500588	882	98.9	3.34e-190
UCT124H	contig_1	501036	501237	201	renamed_GCF_000008685.2	chromosome	501014	501212	201	96.9	5.468e-39
UCT124H	contig_1	501521	501890	369	renamed_GCF_000008685.2	chromosome	501496	501865	369	99.1	4.571e-76
UCT124H	contig_1	590109	589584	525	renamed_GCF_000008685.2	chromosome	590208	589683	525	99.4	1.233e-107
UCT124H	contig_1	591093	592263	1170	renamed_GCF_000008685.2	chromosome	591187	592357	1170	99.7	9.606e-253
UCT124H	contig_1	595848	596427	579	renamed_GCF_000008685.2	chromosome	595942	596521	579	99.4	1.865e-120
UCT124H	contig_1	596436	598497	2061	renamed_GCF_000008685.2	chromosome	596530	598591	2061	99.8	0.0
UCT124H	contig_1	599400	600750	1350	renamed_GCF_000008685.2	chromosome	599494	600844	1350	99.7	1.968e-292
UCT124H	contig_1	602279	603635	1356	renamed_GCF_000008685.2	chromosome	602373	603729	1356	99.3	5.612e-299
UCT124H	contig_1	618733	620941	2208	renamed_GCF_000008685.2	chromosome	618827	621035	2208	100.0	0.0
UCT124H	contig_1	621910	623353	1443	renamed_GCF_000008685.2	chromosome	622004	623447	1443	98.7	0.0
UCT124H	contig_1	624912	626166	1254	renamed_GCF_000008685.2	chromosome	625006	626260	1254	99.7	9.499e-276
UCT124H	contig_1	628854	626997	1857	renamed_GCF_000008685.2	chromosome	628948	627091	1857	99.5	0.0
UCT124H	contig_1	686419	685888	531	renamed_GCF_000008685.2	chromosome	686507	685976	531	100.0	1.053e-118
UCT124H	contig_1	699867	698301	1566	renamed_GCF_000008685.2	chromosome	699965	698399	1566	99.4	0.0
UCT124H	contig_1	700930	701287	357	renamed_GCF_000008685.2	chromosome	701028	701385	357	99.1	2.301e-81
UCT124H	contig_1	701726	702176	450	renamed_GCF_000008685.2	chromosome	701824	702274	450	99.3	2.172e-97
UCT124H	contig_1	702910	703870	960	renamed_GCF_000008685.2	chromosome	703008	703968	960	100.0	6.008e-214
UCT124H	contig_1	704850	705402	552	renamed_GCF_000008685.2	chromosome	704948	705500	552	97.8	2.975e-119
UCT124H	contig_1	706572	709167	2595	renamed_GCF_000008685.2	chromosome	706672	709267	2595	99.8	0.0
UCT124H	contig_1	710585	711071	486	renamed_GCF_000008685.2	chromosome	710685	711171	486	100.0	5.304e-102
UCT124H	contig_1	712107	711591	516	renamed_GCF_000008685.2	chromosome	712207	711691	516	98.8	3.968e-110
UCT124H	contig_1	714007	713143	864	renamed_GCF_000008685.2	chromosome	714107	713243	864	100.0	1.134e-190
UCT124H	contig_1	738304	738670	366	renamed_GCF_000008685.2	chromosome	738405	738771	366	97.5	2.382e-74
UCT124H	contig_1	739583	740075	492	renamed_GCF_000008685.2	chromosome	739684	740176	492	99.3	9.73e-105
UCT124H	contig_1	740344	740587	243	renamed_GCF_000008685.2	chromosome	740445	740688	243	100.0	1.755e-49
UCT124H	contig_1	742527	741294	1233	renamed_GCF_000008685.2	chromosome	742628	741395	1233	99.2	9.028e-273
UCT124H	contig_1	744420	744744	324	renamed_GCF_000008685.2	chromosome	744521	744845	324	100.0	1.32e-65
UCT124H	contig_1	748022	749918	1896	renamed_GCF_000008685.2	chromosome	748122	750018	1896	99.8	0.0
UCT124H	contig_1	751090	752059	969	renamed_GCF_000008685.2	chromosome	751190	752159	969	100.0	4.772e-218
UCT124H	contig_1	753122	753968	846	renamed_GCF_000008685.2	chromosome	753291	754068	846	99.6	1.473e-167
UCT124H	contig_1	754449	756249	1800	renamed_GCF_000008685.2	chromosome	754636	756349	1800	100.0	0.0
UCT124H	contig_1	782729	782051	678	renamed_GCF_000008685.2	chromosome	782829	782151	678	99.5	1.055e-151
UCT124H	contig_1	806824	805675	1149	renamed_GCF_000008685.2	chromosome	806923	805774	1149	99.7	5.42e-247
UCT124H	contig_1	808365	807876	489	renamed_GCF_000008685.2	chromosome	808464	807975	489	100.0	6.125e-101
UCT124H	contig_1	810396	809601	795	renamed_GCF_000008685.2	chromosome	810495	809700	795	100.0	1.877e-173
UCT124H	contig_1	812289	811407	882	renamed_GCF_000008685.2	chromosome	812388	811506	882	99.3	6.162e-192
UCT124H	contig_1	813616	813286	330	renamed_GCF_000008685.2	chromosome	813706	813385	330	97.2	1.608e-64
UCT124H	contig_1	821099	822284	1185	renamed_GCF_000008685.2	chromosome	821184	822369	1185	100.0	1.177e-261
UCT124H	contig_1	822724	823018	294	renamed_GCF_000008685.2	chromosome	822809	823103	294	100.0	1.207e-61
UCT124H	contig_1	823730	824297	567	renamed_GCF_000008685.2	chromosome	823815	824382	567	100.0	1.275e-122
UCT124H	contig_1	825615	827535	1920	renamed_GCF_000008685.2	chromosome	825700	827620	1920	99.8	0.0
UCT124H	contig_1	884129	881000	3129	renamed_GCF_000008685.2	chromosome	884213	881084	3129	99.8	0.0
UCT124H	contig_2	2860	2011	849	renamed_GCF_000008685.2	lp54	2893	2044	849	99.2	1.301e-186
UCT124H	contig_2	5200	4633	567	renamed_GCF_000008685.2	lp54	5140	4666	567	90.4	5.384e-90
UCT124H	contig_2	5276	5612	336	renamed_GCF_000008685.2	lp54	5313	5649	336	100.0	1.784e-72
UCT124H	contig_2	6483	7110	627	renamed_GCF_000008685.2	lp54	6520	7147	627	100.0	4.747e-135
UCT124H	contig_2	8228	8408	180	renamed_GCF_000008685.2	lp54	8265	8445	180	100.0	1.452e-33
UCT124H	contig_2	18712	20065	1353	renamed_GCF_000008685.2	lp54	18724	20077	1353	99.7	3.386e-304
UCT124H	contig_2	21052	21592	540	renamed_GCF_000008685.2	lp54	21086	21626	540	99.4	1.96e-113
UCT124H	contig_2	23742	24384	642	renamed_GCF_000008685.2	lp54	23776	24415	642	99.5	2.461e-136
UCT124H	contig_3	9145	8869	276	renamed_GCF_000008685.2	lp38	9155	8876	276	98.9	6.666e-57
UCT124H	contig_3	23514	24237	723	renamed_GCF_000008685.2	lp38	23365	24088	723	99.1	1.472e-155
UCT124H	contig_3	26556	25485	1071	renamed_GCF_000008685.2	lp38	26407	25336	1071	100.0	4.439e-236
UCT124H	contig_3	30919	30052	867	renamed_GCF_000008685.2	lp28-4	25089	24222	867	99.6	5.869e-190
UCT124H	contig_3	32645	33368	723	renamed_GCF_000008685.2	lp38	32497	33220	723	99.5	1.34e-156
UCT124H	contig_3	36648	37116	468	renamed_GCF_000008685.2	lp5	4387	4819	468	52.8	8.599e-44
UCT124H	contig_5	4299	3870	429	renamed_GCF_000008685.2	cp32-1	7827	8256	429	100.0	5.601e-92
UCT124H	contig_5	20873	20294	579	renamed_GCF_000008685.2	cp32-8	22112	22691	579	100.0	3.43e-122
UCT124H	contig_5	28658	27842	816	renamed_GCF_000008685.2	cp32-7	14330	15146	816	100.0	1.636e-178
UCT124H	contig_6	22046	22823	777	renamed_GCF_000008685.2	cp32-7	25720	24943	777	100.0	1.414e-173
UCT124H	contig_7	10056	9627	429	renamed_GCF_000008685.2	cp32-7	7829	8258	429	100.0	5.601e-92
UCT124H	contig_8	13038	14136	1098	renamed_GCF_000008685.2	cp32-4	18959	20057	1098	100.0	8.352e-251
UCT124H	contig_9	3226	3682	456	renamed_GCF_000008685.2	cp32-3	4941	5397	456	100.0	1.075e-97
UCT124H	contig_9	4438	5005	567	renamed_GCF_000008685.2	cp32-9	6169	6736	567	98.9	1.159e-123
UCT124H	contig_9	6112	6541	429	renamed_GCF_000008685.2	cp32-8	7827	8256	429	100.0	5.601e-92
UCT124H	contig_10	18843	18045	798	renamed_GCF_000008685.2	lp28-2	18827	18029	798	100.0	7.719e-184
UCT124H	contig_10	22320	19635	2685	renamed_GCF_000008685.2	lp28-2	22259	19619	2685	99.8	0.0
UCT124H	contig_10	23049	22674	375	renamed_GCF_000008685.2	lp28-2	23033	22658	375	100.0	2.05e-77
UCT124H	contig_10	24124	23737	387	renamed_GCF_000008685.2	lp28-2	24108	23721	387	100.0	1.013e-78
UCT124H	contig_11	5873	5483	390	renamed_GCF_000008685.2	cp32-6	5774	6164	390	99.2	7.187e-83
UCT124H	contig_11	25704	25368	336	renamed_GCF_000008685.2	cp32-6	15774	16110	336	100.0	5.348e-69
UCT124H	contig_11	26041	25693	348	renamed_GCF_000008685.2	cp32-6	15437	15785	348	100.0	8.822e-74
UCT124H	contig_12	3451	4366	915	renamed_GCF_000008685.2	lp28-3	26371	25432	915	99.6	1.441e-196
UCT124H	contig_12	7120	6844	276	renamed_GCF_000008685.2	lp28-3	22677	22953	276	100.0	6.026e-58
UCT124H	contig_12	8328	7578	750	renamed_GCF_000008685.2	lp28-3	21469	22219	750	100.0	6.33e-161
UCT124H	contig_12	11000	10370	630	renamed_GCF_000008685.2	lp28-3	18797	19427	630	100.0	1.007e-135
UCT124H	contig_12	11851	11095	756	renamed_GCF_000008685.2	lp28-3	17946	18702	756	100.0	8.81e-167
UCT124H	contig_12	12390	11823	567	renamed_GCF_000008685.2	lp28-3	17407	17974	567	100.0	1.938e-126
UCT124H	contig_12	13279	12382	897	renamed_GCF_000008685.2	lp28-3	16518	17415	897	100.0	1.518e-201
UCT124H	contig_13	25804	25450	354	renamed_GCF_000008685.2	cp32-3	16083	16437	354	100.0	1.459e-77
UCT124H	contig_14	5317	6640	1323	renamed_GCF_000008685.2	cp26	3798	2475	1323	100.0	1.419e-291
UCT124H	contig_14	8364	8808	444	renamed_GCF_000008685.2	cp26	751	307	444	100.0	2.98e-101
UCT124H	contig_14	10789	9160	1629	renamed_GCF_000008685.2	cp26	24824	26453	1629	99.8	0.0
UCT124H	contig_14	12459	13011	552	renamed_GCF_000008685.2	cp26	23154	22602	552	98.9	7.279e-118
UCT124H	contig_14	13789	14275	486	renamed_GCF_000008685.2	cp26	21833	21338	486	99.3	1.623e-106
UCT124H	contig_14	14827	16183	1356	renamed_GCF_000008685.2	cp26	20786	19430	1356	99.1	4.378e-293
UCT124H	contig_14	18737	18101	636	renamed_GCF_000008685.2	cp26	16902	17535	636	79.7	1.618e-97
UCT124H	contig_16	6873	7539	666	renamed_GCF_000008685.2	lp28-4	19183	18517	666	99.5	1.537e-145
UCT124H	contig_17	6990	7854	864	renamed_GCF_000008685.2	lp25	6897	7761	864	100.0	7.808e-195
UCT124H	contig_17	10802	10292	510	renamed_GCF_000008685.2	lp25	10694	10199	510	99.3	8.021e-110
UCT124H	contig_17	12948	12189	759	renamed_GCF_000008685.2	lp25	12854	12095	759	99.6	1.114e-164
UCT124H	contig_17	14570	13496	1074	renamed_GCF_000008685.2	lp25	14530	13402	1074	99.1	1.202e-242
UCT124H	contig_19	4663	5218	555	renamed_GCF_000008685.2	cp32-9	16641	17196	555	100.0	1.867e-116
UCT124H	contig_19	7185	8283	1098	renamed_GCF_000008685.2	cp32-9	19163	20264	1098	99.1	4.96e-248
UCT124H	contig_19	8835	9591	756	renamed_GCF_000008685.2	cp32-9	20816	21572	756	100.0	2.151e-165
UCT124H	contig_20	6684	7797	1113	renamed_GCF_000008685.2	lp17	8266	9379	1113	98.3	8.27e-245
UCT124H	contig_20	9824	9161	663	renamed_GCF_000008685.2	lp17	11646	10983	663	100.0	1.005e-149