QUERY_ID	QUERY_NAME	QUERY_START	QUERY_END	QUERY_LENGTH	REF_ID	REF_NAME	REF_START	REF_END	REF_LENGTH	IDENTITY	EVALUE
GCF_040790795.1_ASM4079079v1_genomic	NZ_CP161158.1	22576	21982	594	renamed_GCF_000008685.2	chromosome	22739	22145	594	99.4	7.271e-125
GCF_040790795.1_ASM4079079v1_genomic	NZ_CP161158.1	24533	23801	732	renamed_GCF_000008685.2	chromosome	24696	23964	732	100.0	2.844e-158
GCF_040790795.1_ASM4079079v1_genomic	NZ_CP161158.1	25460	24533	927	renamed_GCF_000008685.2	chromosome	25623	24696	927	98.0	3.519e-197
GCF_040790795.1_ASM4079079v1_genomic	NZ_CP161158.1	26235	27285	1050	renamed_GCF_000008685.2	chromosome	26398	27448	1050	100.0	7.794e-235
GCF_040790795.1_ASM4079079v1_genomic	NZ_CP161158.1	28327	27691	636	renamed_GCF_000008685.2	chromosome	28490	27854	636	100.0	8.334e-139
GCF_040790795.1_ASM4079079v1_genomic	NZ_CP161158.1	29379	30861	1482	renamed_GCF_000008685.2	chromosome	29542	31015	1482	98.1	0.0
GCF_040790795.1_ASM4079079v1_genomic	NZ_CP161158.1	31935	31395	540	renamed_GCF_000008685.2	chromosome	32089	31549	540	100.0	3.274e-116
GCF_040790795.1_ASM4079079v1_genomic	NZ_CP161158.1	35682	33882	1800	renamed_GCF_000008685.2	chromosome	35836	34036	1800	100.0	0.0
GCF_040790795.1_ASM4079079v1_genomic	NZ_CP161158.1	39668	40520	852	renamed_GCF_000008685.2	chromosome	39825	40677	852	99.6	5.092e-189
GCF_040790795.1_ASM4079079v1_genomic	NZ_CP161158.1	59880	58941	939	renamed_GCF_000008685.2	chromosome	60039	59100	939	99.3	9.091e-206
GCF_040790795.1_ASM4079079v1_genomic	NZ_CP161158.1	60374	59876	498	renamed_GCF_000008685.2	chromosome	60533	60035	498	98.7	8.026e-108
GCF_040790795.1_ASM4079079v1_genomic	NZ_CP161158.1	63878	65117	1239	renamed_GCF_000008685.2	chromosome	64037	65276	1239	99.5	1.39e-277
GCF_040790795.1_ASM4079079v1_genomic	NZ_CP161158.1	67088	69413	2325	renamed_GCF_000008685.2	chromosome	67247	69569	2325	99.4	0.0
GCF_040790795.1_ASM4079079v1_genomic	NZ_CP161158.1	80825	81251	426	renamed_GCF_000008685.2	chromosome	80982	81408	426	99.2	2.643e-91
GCF_040790795.1_ASM4079079v1_genomic	NZ_CP161158.1	83763	82812	951	renamed_GCF_000008685.2	chromosome	83920	82969	951	99.6	3.736e-209
GCF_040790795.1_ASM4079079v1_genomic	NZ_CP161158.1	86697	85722	975	renamed_GCF_000008685.2	chromosome	86854	85879	975	100.0	4.354e-220
GCF_040790795.1_ASM4079079v1_genomic	NZ_CP161158.1	108149	109514	1365	renamed_GCF_000008685.2	chromosome	108306	109671	1365	99.7	2.146e-311
GCF_040790795.1_ASM4079079v1_genomic	NZ_CP161158.1	111410	110888	522	renamed_GCF_000008685.2	chromosome	111567	111045	522	100.0	1.783e-111
GCF_040790795.1_ASM4079079v1_genomic	NZ_CP161158.1	111717	111426	291	renamed_GCF_000008685.2	chromosome	111875	111584	291	100.0	1.894e-64
GCF_040790795.1_ASM4079079v1_genomic	NZ_CP161158.1	112180	111730	450	renamed_GCF_000008685.2	chromosome	112338	111888	450	99.3	9.762e-98
GCF_040790795.1_ASM4079079v1_genomic	NZ_CP161158.1	133829	135719	1890	renamed_GCF_000008685.2	chromosome	133974	135864	1890	99.2	0.0
GCF_040790795.1_ASM4079079v1_genomic	NZ_CP161158.1	138596	138284	312	renamed_GCF_000008685.2	chromosome	138745	138433	312	99.0	2.189e-66
GCF_040790795.1_ASM4079079v1_genomic	NZ_CP161158.1	144032	142796	1236	renamed_GCF_000008685.2	chromosome	144230	142943	1236	99.5	6.15e-269
GCF_040790795.1_ASM4079079v1_genomic	NZ_CP161158.1	146223	145323	900	renamed_GCF_000008685.2	chromosome	146370	145470	900	100.0	6.779e-194
GCF_040790795.1_ASM4079079v1_genomic	NZ_CP161158.1	159217	159892	675	renamed_GCF_000008685.2	chromosome	159367	160042	675	98.6	4.754e-143
GCF_040790795.1_ASM4079079v1_genomic	NZ_CP161158.1	162651	161049	1602	renamed_GCF_000008685.2	chromosome	162801	161199	1602	99.8	0.0
GCF_040790795.1_ASM4079079v1_genomic	NZ_CP161158.1	164670	162921	1749	renamed_GCF_000008685.2	chromosome	164820	163071	1749	99.1	0.0
GCF_040790795.1_ASM4079079v1_genomic	NZ_CP161158.1	169249	167728	1521	renamed_GCF_000008685.2	chromosome	169399	167878	1521	99.4	0.0
GCF_040790795.1_ASM4079079v1_genomic	NZ_CP161158.1	181255	179389	1866	renamed_GCF_000008685.2	chromosome	181405	179539	1866	99.6	0.0
GCF_040790795.1_ASM4079079v1_genomic	NZ_CP161158.1	182735	183230	495	renamed_GCF_000008685.2	chromosome	182885	183380	495	100.0	9.271e-106
GCF_040790795.1_ASM4079079v1_genomic	NZ_CP161158.1	186798	187044	246	renamed_GCF_000008685.2	chromosome	186948	187194	246	100.0	9.168e-49
GCF_040790795.1_ASM4079079v1_genomic	NZ_CP161158.1	188087	187673	414	renamed_GCF_000008685.2	chromosome	188237	187823	414	100.0	2.918e-88
GCF_040790795.1_ASM4079079v1_genomic	NZ_CP161158.1	189126	188925	201	renamed_GCF_000008685.2	chromosome	189276	189075	201	98.4	4.922e-40
GCF_040790795.1_ASM4079079v1_genomic	NZ_CP161158.1	310218	309474	744	renamed_GCF_000008685.2	chromosome	310523	309779	744	100.0	5.245e-162
GCF_040790795.1_ASM4079079v1_genomic	NZ_CP161158.1	315010	314119	891	renamed_GCF_000008685.2	chromosome	315314	314423	891	99.6	4.455e-197
GCF_040790795.1_ASM4079079v1_genomic	NZ_CP161158.1	315839	315002	837	renamed_GCF_000008685.2	chromosome	316143	315306	837	99.6	1.426e-183
GCF_040790795.1_ASM4079079v1_genomic	NZ_CP161158.1	316912	315835	1077	renamed_GCF_000008685.2	chromosome	317216	316139	1077	99.7	9.003e-238
GCF_040790795.1_ASM4079079v1_genomic	NZ_CP161158.1	317701	316942	759	renamed_GCF_000008685.2	chromosome	318005	317246	759	100.0	1.223e-163
GCF_040790795.1_ASM4079079v1_genomic	NZ_CP161158.1	342029	342902	873	renamed_GCF_000008685.2	chromosome	342334	343207	873	99.6	7.766e-188
GCF_040790795.1_ASM4079079v1_genomic	NZ_CP161158.1	342902	343874	972	renamed_GCF_000008685.2	chromosome	343207	344179	972	100.0	3.579e-213
GCF_040790795.1_ASM4079079v1_genomic	NZ_CP161158.1	344757	346059	1302	renamed_GCF_000008685.2	chromosome	345062	346364	1302	99.3	3.283e-287
GCF_040790795.1_ASM4079079v1_genomic	NZ_CP161158.1	346536	346125	411	renamed_GCF_000008685.2	chromosome	346841	346430	411	100.0	6.821e-87
GCF_040790795.1_ASM4079079v1_genomic	NZ_CP161158.1	346996	346555	441	renamed_GCF_000008685.2	chromosome	347301	346860	441	100.0	1.706e-98
GCF_040790795.1_ASM4079079v1_genomic	NZ_CP161158.1	347855	347045	810	renamed_GCF_000008685.2	chromosome	348160	347350	810	99.6	4.196e-184
GCF_040790795.1_ASM4079079v1_genomic	NZ_CP161158.1	349305	347847	1458	renamed_GCF_000008685.2	chromosome	349610	348152	1458	99.5	5e-324
GCF_040790795.1_ASM4079079v1_genomic	NZ_CP161158.1	350743	349294	1449	renamed_GCF_000008685.2	chromosome	351045	349599	1449	99.7	6.4e-322
GCF_040790795.1_ASM4079079v1_genomic	NZ_CP161158.1	351026	350750	276	renamed_GCF_000008685.2	chromosome	351331	351055	276	98.9	1.819e-54
GCF_040790795.1_ASM4079079v1_genomic	NZ_CP161158.1	364775	363824	951	renamed_GCF_000008685.2	chromosome	364972	364129	951	99.2	5.797e-187
GCF_040790795.1_ASM4079079v1_genomic	NZ_CP161158.1	365299	364810	489	renamed_GCF_000008685.2	chromosome	365603	365114	489	100.0	3.787e-106
GCF_040790795.1_ASM4079079v1_genomic	NZ_CP161158.1	366656	365924	732	renamed_GCF_000008685.2	chromosome	366960	366228	732	98.7	5.755e-159
GCF_040790795.1_ASM4079079v1_genomic	NZ_CP161158.1	390037	388672	1365	renamed_GCF_000008685.2	chromosome	390341	388976	1365	99.3	3.579e-288
GCF_040790795.1_ASM4079079v1_genomic	NZ_CP161158.1	391515	390090	1425	renamed_GCF_000008685.2	chromosome	391819	390391	1425	99.5	0.0
GCF_040790795.1_ASM4079079v1_genomic	NZ_CP161158.1	392653	391627	1026	renamed_GCF_000008685.2	chromosome	392957	391931	1026	99.4	6.082e-225
GCF_040790795.1_ASM4079079v1_genomic	NZ_CP161158.1	393759	392739	1020	renamed_GCF_000008685.2	chromosome	394063	393043	1020	100.0	6.665e-223
GCF_040790795.1_ASM4079079v1_genomic	NZ_CP161158.1	394862	393800	1062	renamed_GCF_000008685.2	chromosome	395166	394104	1062	99.7	9.401e-235
GCF_040790795.1_ASM4079079v1_genomic	NZ_CP161158.1	407790	407619	171	renamed_GCF_000008685.2	chromosome	408092	407921	171	100.0	1.118e-34
GCF_040790795.1_ASM4079079v1_genomic	NZ_CP161158.1	408088	407908	180	renamed_GCF_000008685.2	chromosome	408380	408200	180	100.0	2.118e-37
GCF_040790795.1_ASM4079079v1_genomic	NZ_CP161158.1	409110	408261	849	renamed_GCF_000008685.2	chromosome	409402	408553	849	99.6	2.186e-189
GCF_040790795.1_ASM4079079v1_genomic	NZ_CP161158.1	410155	409123	1032	renamed_GCF_000008685.2	chromosome	410447	409415	1032	97.3	8.518e-231
GCF_040790795.1_ASM4079079v1_genomic	NZ_CP161158.1	410494	411154	660	renamed_GCF_000008685.2	chromosome	410786	411446	660	98.1	2.462e-139
GCF_040790795.1_ASM4079079v1_genomic	NZ_CP161158.1	422765	423545	780	renamed_GCF_000008685.2	chromosome	423054	423834	780	99.6	1.628e-172
GCF_040790795.1_ASM4079079v1_genomic	NZ_CP161158.1	424156	423532	624	renamed_GCF_000008685.2	chromosome	424442	423821	624	99.5	4.527e-135
GCF_040790795.1_ASM4079079v1_genomic	NZ_CP161158.1	424403	425261	858	renamed_GCF_000008685.2	chromosome	424693	425551	858	100.0	1.579e-194
GCF_040790795.1_ASM4079079v1_genomic	NZ_CP161158.1	425293	426421	1128	renamed_GCF_000008685.2	chromosome	425583	426711	1128	99.7	5.155e-244
GCF_040790795.1_ASM4079079v1_genomic	NZ_CP161158.1	445058	444668	390	renamed_GCF_000008685.2	chromosome	448591	448201	390	100.0	7.926e-82
GCF_040790795.1_ASM4079079v1_genomic	NZ_CP161158.1	445171	445777	606	renamed_GCF_000008685.2	chromosome	448707	449310	606	99.5	2.46e-130
GCF_040790795.1_ASM4079079v1_genomic	NZ_CP161158.1	445885	446638	753	renamed_GCF_000008685.2	chromosome	449418	450171	753	100.0	3.278e-160
GCF_040790795.1_ASM4079079v1_genomic	NZ_CP161158.1	448388	447605	783	renamed_GCF_000008685.2	chromosome	451921	451138	783	99.2	5.024e-169
GCF_040790795.1_ASM4079079v1_genomic	NZ_CP161158.1	471078	472068	990	renamed_GCF_000008685.2	chromosome	474612	475602	990	99.6	3.939e-215
GCF_040790795.1_ASM4079079v1_genomic	NZ_CP161158.1	472071	472677	606	renamed_GCF_000008685.2	chromosome	475605	476211	606	100.0	1.006e-131
GCF_040790795.1_ASM4079079v1_genomic	NZ_CP161158.1	474540	472728	1812	renamed_GCF_000008685.2	chromosome	478005	476262	1812	99.4	0.0
GCF_040790795.1_ASM4079079v1_genomic	NZ_CP161158.1	477112	477496	384	renamed_GCF_000008685.2	chromosome	479708	481019	384	100.0	5.364e-85
GCF_040790795.1_ASM4079079v1_genomic	NZ_CP161158.1	485968	486196	228	renamed_GCF_000008685.2	chromosome	489539	489719	228	100.0	1.455e-33
GCF_040790795.1_ASM4079079v1_genomic	NZ_CP161158.1	486209	487031	822	renamed_GCF_000008685.2	chromosome	489732	490554	822	98.9	1.491e-180
GCF_040790795.1_ASM4079079v1_genomic	NZ_CP161158.1	487120	488404	1284	renamed_GCF_000008685.2	chromosome	490643	491927	1284	100.0	9.564e-281
GCF_040790795.1_ASM4079079v1_genomic	NZ_CP161158.1	489064	490429	1365	renamed_GCF_000008685.2	chromosome	492587	493952	1365	100.0	1.721e-296
GCF_040790795.1_ASM4079079v1_genomic	NZ_CP161158.1	491019	490626	393	renamed_GCF_000008685.2	chromosome	494539	494149	393	100.0	4.545e-80
GCF_040790795.1_ASM4079079v1_genomic	NZ_CP161158.1	501275	501581	306	renamed_GCF_000008685.2	chromosome	504798	505104	306	99.0	3.271e-61
GCF_040790795.1_ASM4079079v1_genomic	NZ_CP161158.1	501580	502018	438	renamed_GCF_000008685.2	chromosome	505103	505541	438	100.0	1.186e-93
GCF_040790795.1_ASM4079079v1_genomic	NZ_CP161158.1	502030	503335	1305	renamed_GCF_000008685.2	chromosome	505553	506858	1305	100.0	4.133e-285
GCF_040790795.1_ASM4079079v1_genomic	NZ_CP161158.1	503347	503461	114	renamed_GCF_000008685.2	chromosome	506864	506984	114	100.0	7.638e-22
GCF_040790795.1_ASM4079079v1_genomic	NZ_CP161158.1	503478	503856	378	renamed_GCF_000008685.2	chromosome	507001	507379	378	100.0	8.763e-79
GCF_040790795.1_ASM4079079v1_genomic	NZ_CP161158.1	512962	519463	6501	renamed_GCF_000008685.2	chromosome	516492	522993	6501	99.3	0.0
GCF_040790795.1_ASM4079079v1_genomic	NZ_CP161158.1	521023	522724	1701	renamed_GCF_000008685.2	chromosome	524553	526254	1701	99.1	0.0
GCF_040790795.1_ASM4079079v1_genomic	NZ_CP161158.1	538732	539494	762	renamed_GCF_000008685.2	chromosome	542262	543024	762	99.2	1.347e-171
GCF_040790795.1_ASM4079079v1_genomic	NZ_CP161158.1	539518	540286	768	renamed_GCF_000008685.2	chromosome	543048	543816	768	99.6	4.167e-177
GCF_040790795.1_ASM4079079v1_genomic	NZ_CP161158.1	540301	541075	774	renamed_GCF_000008685.2	chromosome	543831	544605	774	99.6	1.962e-169
GCF_040790795.1_ASM4079079v1_genomic	NZ_CP161158.1	553896	553038	858	renamed_GCF_000008685.2	chromosome	557423	556562	858	97.9	4.402e-183
GCF_040790795.1_ASM4079079v1_genomic	NZ_CP161158.1	554497	553879	618	renamed_GCF_000008685.2	chromosome	558024	557406	618	99.0	1.47e-129
GCF_040790795.1_ASM4079079v1_genomic	NZ_CP161158.1	557205	554478	2727	renamed_GCF_000008685.2	chromosome	560732	558005	2727	99.7	0.0
GCF_040790795.1_ASM4079079v1_genomic	NZ_CP161158.1	557600	557201	399	renamed_GCF_000008685.2	chromosome	561127	560728	399	96.2	1.01e-80
GCF_040790795.1_ASM4079079v1_genomic	NZ_CP161158.1	558009	557589	420	renamed_GCF_000008685.2	chromosome	561554	561116	420	93.0	2.589e-82
GCF_040790795.1_ASM4079079v1_genomic	NZ_CP161158.1	581334	580644	690	renamed_GCF_000008685.2	chromosome	584880	584190	690	99.1	4.749e-154
GCF_040790795.1_ASM4079079v1_genomic	NZ_CP161158.1	581545	582610	1065	renamed_GCF_000008685.2	chromosome	585079	586156	1065	98.0	9.851e-235
GCF_040790795.1_ASM4079079v1_genomic	NZ_CP161158.1	583484	584336	852	renamed_GCF_000008685.2	chromosome	587030	587882	852	98.5	4.638e-190
GCF_040790795.1_ASM4079079v1_genomic	NZ_CP161158.1	584519	586121	1602	renamed_GCF_000008685.2	chromosome	588065	589667	1602	99.8	0.0
GCF_040790795.1_ASM4079079v1_genomic	NZ_CP161158.1	601218	600174	1044	renamed_GCF_000008685.2	chromosome	604769	603725	1044	99.4	1.577e-234
GCF_040790795.1_ASM4079079v1_genomic	NZ_CP161158.1	603432	601227	2205	renamed_GCF_000008685.2	chromosome	606983	604778	2205	99.5	0.0
GCF_040790795.1_ASM4079079v1_genomic	NZ_CP161158.1	603586	604384	798	renamed_GCF_000008685.2	chromosome	607137	607935	798	99.6	4.801e-172
GCF_040790795.1_ASM4079079v1_genomic	NZ_CP161158.1	606355	605509	846	renamed_GCF_000008685.2	chromosome	609906	609060	846	100.0	3.324e-184
GCF_040790795.1_ASM4079079v1_genomic	NZ_CP161158.1	664965	661455	3510	renamed_GCF_000008685.2	chromosome	668517	665007	3510	99.4	0.0
GCF_040790795.1_ASM4079079v1_genomic	NZ_CP161158.1	669659	668213	1446	renamed_GCF_000008685.2	chromosome	673167	671766	1446	99.1	2.204e-307
GCF_040790795.1_ASM4079079v1_genomic	NZ_CP161158.1	669788	671225	1437	renamed_GCF_000008685.2	chromosome	673341	674778	1437	99.3	0.0
GCF_040790795.1_ASM4079079v1_genomic	NZ_CP161158.1	671481	672825	1344	renamed_GCF_000008685.2	chromosome	675034	676378	1344	99.7	1.793e-292
GCF_040790795.1_ASM4079079v1_genomic	NZ_CP161158.1	672914	674303	1389	renamed_GCF_000008685.2	chromosome	676471	677860	1389	100.0	1.442e-302
GCF_040790795.1_ASM4079079v1_genomic	NZ_CP161158.1	675381	674334	1047	renamed_GCF_000008685.2	chromosome	678938	677891	1047	100.0	5.633e-238
GCF_040790795.1_ASM4079079v1_genomic	NZ_CP161158.1	676193	675401	792	renamed_GCF_000008685.2	chromosome	679750	678958	792	99.2	7.656e-166
GCF_040790795.1_ASM4079079v1_genomic	NZ_CP161158.1	677006	676196	810	renamed_GCF_000008685.2	chromosome	680557	679753	810	99.6	5.278e-173
GCF_040790795.1_ASM4079079v1_genomic	NZ_CP161158.1	678049	677005	1044	renamed_GCF_000008685.2	chromosome	681606	680562	1044	100.0	8.539e-233
GCF_040790795.1_ASM4079079v1_genomic	NZ_CP161158.1	689072	689972	900	renamed_GCF_000008685.2	chromosome	692628	693528	900	99.6	4.423e-190
GCF_040790795.1_ASM4079079v1_genomic	NZ_CP161158.1	689997	691140	1143	renamed_GCF_000008685.2	chromosome	693553	694696	1143	100.0	3.979e-258
GCF_040790795.1_ASM4079079v1_genomic	NZ_CP161158.1	691967	691136	831	renamed_GCF_000008685.2	chromosome	695523	694692	831	99.2	6.41e-183
GCF_040790795.1_ASM4079079v1_genomic	NZ_CP161158.1	692065	693199	1134	renamed_GCF_000008685.2	chromosome	695630	696764	1134	99.2	3.457e-258
GCF_040790795.1_ASM4079079v1_genomic	NZ_CP161158.1	693872	693185	687	renamed_GCF_000008685.2	chromosome	697437	696750	687	100.0	2.97e-150
GCF_040790795.1_ASM4079079v1_genomic	NZ_CP161158.1	694020	694767	747	renamed_GCF_000008685.2	chromosome	697585	698332	747	100.0	1.547e-167
GCF_040790795.1_ASM4079079v1_genomic	NZ_CP161158.1	696400	694834	1566	renamed_GCF_000008685.2	chromosome	699965	698399	1566	99.6	0.0
GCF_040790795.1_ASM4079079v1_genomic	NZ_CP161158.1	697359	696486	873	renamed_GCF_000008685.2	chromosome	700924	700051	873	99.3	1.433e-189
GCF_040790795.1_ASM4079079v1_genomic	NZ_CP161158.1	697463	697820	357	renamed_GCF_000008685.2	chromosome	701028	701385	357	99.1	2.301e-81
GCF_040790795.1_ASM4079079v1_genomic	NZ_CP161158.1	697829	698240	411	renamed_GCF_000008685.2	chromosome	701394	701805	411	98.5	1.377e-87
GCF_040790795.1_ASM4079079v1_genomic	NZ_CP161158.1	708640	708124	516	renamed_GCF_000008685.2	chromosome	712207	711691	516	99.4	8.019e-111
GCF_040790795.1_ASM4079079v1_genomic	NZ_CP161158.1	709683	708636	1047	renamed_GCF_000008685.2	chromosome	713250	712203	1047	100.0	4.165e-224
GCF_040790795.1_ASM4079079v1_genomic	NZ_CP161158.1	710540	709676	864	renamed_GCF_000008685.2	chromosome	714107	713243	864	100.0	1.134e-190
GCF_040790795.1_ASM4079079v1_genomic	NZ_CP161158.1	711199	710536	663	renamed_GCF_000008685.2	chromosome	714766	714103	663	98.1	3.581e-144
GCF_040790795.1_ASM4079079v1_genomic	NZ_CP161158.1	711441	713052	1611	renamed_GCF_000008685.2	chromosome	715008	716619	1611	99.8	0.0
GCF_040790795.1_ASM4079079v1_genomic	NZ_CP161158.1	713052	714204	1152	renamed_GCF_000008685.2	chromosome	716619	717771	1152	100.0	1.261e-246
GCF_040790795.1_ASM4079079v1_genomic	NZ_CP161158.1	714175	715102	927	renamed_GCF_000008685.2	chromosome	717742	718669	927	100.0	3.519e-197
GCF_040790795.1_ASM4079079v1_genomic	NZ_CP161158.1	715259	717518	2259	renamed_GCF_000008685.2	chromosome	718826	721088	2259	99.7	0.0
GCF_040790795.1_ASM4079079v1_genomic	NZ_CP161158.1	717548	719450	1902	renamed_GCF_000008685.2	chromosome	721118	723020	1902	99.8	0.0
GCF_040790795.1_ASM4079079v1_genomic	NZ_CP161158.1	720560	719492	1068	renamed_GCF_000008685.2	chromosome	724130	723062	1068	99.7	1.68e-246
GCF_040790795.1_ASM4079079v1_genomic	NZ_CP161158.1	731780	733115	1335	renamed_GCF_000008685.2	chromosome	735351	736686	1335	99.5	6.578e-285
GCF_040790795.1_ASM4079079v1_genomic	NZ_CP161158.1	733127	733388	261	renamed_GCF_000008685.2	chromosome	736698	736959	261	100.0	3.165e-54
GCF_040790795.1_ASM4079079v1_genomic	NZ_CP161158.1	733388	733637	249	renamed_GCF_000008685.2	chromosome	736959	737208	249	100.0	2.148e-48
GCF_040790795.1_ASM4079079v1_genomic	NZ_CP161158.1	733640	734141	501	renamed_GCF_000008685.2	chromosome	737211	737712	501	98.1	2.269e-105
GCF_040790795.1_ASM4079079v1_genomic	NZ_CP161158.1	734137	734857	720	renamed_GCF_000008685.2	chromosome	737708	738428	720	99.5	4.764e-159
GCF_040790795.1_ASM4079079v1_genomic	NZ_CP161158.1	734834	735200	366	renamed_GCF_000008685.2	chromosome	738405	738771	366	100.0	9.695e-76
GCF_040790795.1_ASM4079079v1_genomic	NZ_CP161158.1	735572	736112	540	renamed_GCF_000008685.2	chromosome	739143	739683	540	100.0	2.458e-119
GCF_040790795.1_ASM4079079v1_genomic	NZ_CP161158.1	736113	736605	492	renamed_GCF_000008685.2	chromosome	739684	740176	492	99.3	2.164e-104
GCF_040790795.1_ASM4079079v1_genomic	NZ_CP161158.1	736668	736851	183	renamed_GCF_000008685.2	chromosome	740239	740422	183	100.0	1.805e-39
GCF_040790795.1_ASM4079079v1_genomic	NZ_CP161158.1	736874	737117	243	renamed_GCF_000008685.2	chromosome	740445	740688	243	100.0	1.755e-49
GCF_040790795.1_ASM4079079v1_genomic	NZ_CP161158.1	749652	750498	846	renamed_GCF_000008685.2	chromosome	753291	754068	846	99.6	1.473e-167
GCF_040790795.1_ASM4079079v1_genomic	NZ_CP161158.1	750497	750980	483	renamed_GCF_000008685.2	chromosome	754067	754550	483	99.3	6.952e-107
GCF_040790795.1_ASM4079079v1_genomic	NZ_CP161158.1	750979	752779	1800	renamed_GCF_000008685.2	chromosome	754636	756349	1800	100.0	0.0
GCF_040790795.1_ASM4079079v1_genomic	NZ_CP161158.1	752783	754100	1317	renamed_GCF_000008685.2	chromosome	756353	757670	1317	99.7	1.293e-291
GCF_040790795.1_ASM4079079v1_genomic	NZ_CP161158.1	756015	756645	630	renamed_GCF_000008685.2	chromosome	759585	760215	630	99.5	1.853e-137
GCF_040790795.1_ASM4079079v1_genomic	NZ_CP161158.1	756631	758077	1446	renamed_GCF_000008685.2	chromosome	760225	761647	1446	99.1	5.737e-314
GCF_040790795.1_ASM4079079v1_genomic	NZ_CP161158.1	760008	760791	783	renamed_GCF_000008685.2	chromosome	763578	764361	783	99.6	1.874e-171
GCF_040790795.1_ASM4079079v1_genomic	NZ_CP161158.1	774137	775127	990	renamed_GCF_000008685.2	chromosome	777764	778754	990	99.6	1.559e-225
GCF_040790795.1_ASM4079079v1_genomic	NZ_CP161158.1	775130	777758	2628	renamed_GCF_000008685.2	chromosome	778757	781385	2628	98.8	0.0
GCF_040790795.1_ASM4079079v1_genomic	NZ_CP161158.1	779202	778524	678	renamed_GCF_000008685.2	chromosome	782829	782151	678	99.1	5.213e-151
GCF_040790795.1_ASM4079079v1_genomic	NZ_CP161158.1	779621	779348	273	renamed_GCF_000008685.2	chromosome	783248	782975	273	100.0	3.858e-54
GCF_040790795.1_ASM4079079v1_genomic	NZ_CP161158.1	779762	781394	1632	renamed_GCF_000008685.2	chromosome	783389	785021	1632	99.8	0.0
GCF_040790795.1_ASM4079079v1_genomic	NZ_CP161158.1	781429	783127	1698	renamed_GCF_000008685.2	chromosome	785056	786754	1698	99.4	0.0
GCF_040790795.1_ASM4079079v1_genomic	NZ_CP161158.1	783232	785335	2103	renamed_GCF_000008685.2	chromosome	786859	788962	2103	99.4	0.0
GCF_040790795.1_ASM4079079v1_genomic	NZ_CP161158.1	785691	786309	618	renamed_GCF_000008685.2	chromosome	789302	789938	618	99.5	3.406e-137
GCF_040790795.1_ASM4079079v1_genomic	NZ_CP161158.1	787178	786317	861	renamed_GCF_000008685.2	chromosome	790807	789946	861	100.0	1.57e-186
GCF_040790795.1_ASM4079079v1_genomic	NZ_CP161158.1	797381	798149	768	renamed_GCF_000008685.2	chromosome	801118	801778	768	98.1	1.322e-138
GCF_040790795.1_ASM4079079v1_genomic	NZ_CP161158.1	799170	798312	858	renamed_GCF_000008685.2	chromosome	802798	801940	858	99.2	3.799e-176
GCF_040790795.1_ASM4079079v1_genomic	NZ_CP161158.1	799539	799209	330	renamed_GCF_000008685.2	chromosome	803167	802837	330	100.0	2.178e-69
GCF_040790795.1_ASM4079079v1_genomic	NZ_CP161158.1	803295	802146	1149	renamed_GCF_000008685.2	chromosome	806923	805774	1149	99.7	5.42e-247
GCF_040790795.1_ASM4079079v1_genomic	NZ_CP161158.1	804338	803291	1047	renamed_GCF_000008685.2	chromosome	807966	806919	1047	100.0	5.315e-230
GCF_040790795.1_ASM4079079v1_genomic	NZ_CP161158.1	804836	804347	489	renamed_GCF_000008685.2	chromosome	808464	807975	489	100.0	6.125e-101
GCF_040790795.1_ASM4079079v1_genomic	NZ_CP161158.1	805924	804832	1092	renamed_GCF_000008685.2	chromosome	809552	808460	1092	99.7	8.623e-241
GCF_040790795.1_ASM4079079v1_genomic	NZ_CP161158.1	806867	806072	795	renamed_GCF_000008685.2	chromosome	810495	809700	795	100.0	1.877e-173
GCF_040790795.1_ASM4079079v1_genomic	NZ_CP161158.1	815006	815318	312	renamed_GCF_000008685.2	chromosome	818604	818916	312	100.0	1.086e-65
GCF_040790795.1_ASM4079079v1_genomic	NZ_CP161158.1	815323	815644	321	renamed_GCF_000008685.2	chromosome	819035	819242	321	97.0	1.267e-41
GCF_040790795.1_ASM4079079v1_genomic	NZ_CP161158.1	815643	815889	246	renamed_GCF_000008685.2	chromosome	819241	819487	246	100.0	8.275e-50
GCF_040790795.1_ASM4079079v1_genomic	NZ_CP161158.1	815943	816930	987	renamed_GCF_000008685.2	chromosome	819541	820528	987	100.0	5.255e-220
GCF_040790795.1_ASM4079079v1_genomic	NZ_CP161158.1	817008	817590	582	renamed_GCF_000008685.2	chromosome	820606	821188	582	100.0	9.143e-129
GCF_040790795.1_ASM4079079v1_genomic	NZ_CP161158.1	817586	818771	1185	renamed_GCF_000008685.2	chromosome	821184	822369	1185	99.7	1.177e-261
GCF_040790795.1_ASM4079079v1_genomic	NZ_CP161158.1	818745	819096	351	renamed_GCF_000008685.2	chromosome	822343	822694	351	99.1	1.534e-76
GCF_040790795.1_ASM4079079v1_genomic	NZ_CP161158.1	819211	819505	294	renamed_GCF_000008685.2	chromosome	822809	823103	294	100.0	1.207e-61
GCF_040790795.1_ASM4079079v1_genomic	NZ_CP161158.1	819664	820213	549	renamed_GCF_000008685.2	chromosome	823262	823811	549	98.3	4.154e-115
GCF_040790795.1_ASM4079079v1_genomic	NZ_CP161158.1	820217	820784	567	renamed_GCF_000008685.2	chromosome	823815	824382	567	100.0	1.275e-122
GCF_040790795.1_ASM4079079v1_genomic	NZ_CP161158.1	838235	838853	618	renamed_GCF_000008685.2	chromosome	841833	842451	618	100.0	1.393e-138
GCF_040790795.1_ASM4079079v1_genomic	NZ_CP161158.1	838953	839391	438	renamed_GCF_000008685.2	chromosome	842500	842989	438	98.6	2.908e-92
GCF_040790795.1_ASM4079079v1_genomic	NZ_CP161158.1	839404	840853	1449	renamed_GCF_000008685.2	chromosome	843002	844451	1449	99.5	1.877e-318
GCF_040790795.1_ASM4079079v1_genomic	NZ_CP161158.1	840855	843474	2619	renamed_GCF_000008685.2	chromosome	844453	847102	2619	97.7	0.0
GCF_040790795.1_ASM4079079v1_genomic	NZ_CP161158.1	843497	843860	363	renamed_GCF_000008685.2	chromosome	847125	847488	363	99.1	5.052e-74
GCF_040790795.1_ASM4079079v1_genomic	NZ_CP161158.1	843862	844711	849	renamed_GCF_000008685.2	chromosome	847490	848339	849	99.6	1.428e-185
GCF_040790795.1_ASM4079079v1_genomic	NZ_CP161158.1	844909	845176	267	renamed_GCF_000008685.2	chromosome	848537	848804	267	100.0	3.495e-54
GCF_040790795.1_ASM4079079v1_genomic	NZ_CP161158.1	845190	847359	2169	renamed_GCF_000008685.2	chromosome	848836	850987	2169	99.8	0.0
GCF_040790795.1_ASM4079079v1_genomic	NZ_CP161158.1	847365	848886	1521	renamed_GCF_000008685.2	chromosome	850993	852514	1521	99.6	0.0
GCF_040790795.1_ASM4079079v1_genomic	NZ_CP161158.1	848860	850150	1290	renamed_GCF_000008685.2	chromosome	852488	853778	1290	99.7	1.474e-285
GCF_040790795.1_ASM4079079v1_genomic	NZ_CP161158.1	862289	862832	543	renamed_GCF_000008685.2	chromosome	865915	866458	543	98.8	6.309e-118
GCF_040790795.1_ASM4079079v1_genomic	NZ_CP161158.1	862867	863068	201	renamed_GCF_000008685.2	chromosome	866493	866694	201	100.0	2.206e-40
GCF_040790795.1_ASM4079079v1_genomic	NZ_CP161158.1	863054	863975	921	renamed_GCF_000008685.2	chromosome	866680	867601	921	99.3	3.387e-205
GCF_040790795.1_ASM4079079v1_genomic	NZ_CP161158.1	864488	864116	372	renamed_GCF_000008685.2	chromosome	868114	867742	372	99.1	1.771e-78
GCF_040790795.1_ASM4079079v1_genomic	NZ_CP161158.1	864568	865114	546	renamed_GCF_000008685.2	chromosome	868194	868740	546	100.0	1.846e-123
GCF_040790795.1_ASM4079079v1_genomic	NZ_CP161158.1	865889	865106	783	renamed_GCF_000008685.2	chromosome	869380	868732	783	99.5	1.931e-145
GCF_040790795.1_ASM4079079v1_genomic	NZ_CP161158.1	866397	865881	516	renamed_GCF_000008685.2	chromosome	870023	869507	516	100.0	1.621e-111
GCF_040790795.1_ASM4079079v1_genomic	NZ_CP161158.1	868957	866485	2472	renamed_GCF_000008685.2	chromosome	872583	870111	2472	100.0	0.0
GCF_040790795.1_ASM4079079v1_genomic	NZ_CP161158.1	871506	868959	2547	renamed_GCF_000008685.2	chromosome	875132	872585	2547	100.0	0.0
GCF_040790795.1_ASM4079079v1_genomic	NZ_CP161158.1	871580	872822	1242	renamed_GCF_000008685.2	chromosome	875206	876448	1242	98.3	3.236e-277
GCF_040790795.1_ASM4079079v1_genomic	NZ_CP161158.1	894069	893469	600	renamed_GCF_000008685.2	chromosome	897695	897095	600	99.4	6.881e-135
GCF_040790795.1_ASM4079079v1_genomic	NZ_CP161158.1	895694	894077	1617	renamed_GCF_000008685.2	chromosome	899320	897703	1617	99.6	0.0
GCF_040790795.1_ASM4079079v1_genomic	NZ_CP161158.1	895872	897105	1233	renamed_GCF_000008685.2	chromosome	899498	900731	1233	100.0	1.522e-275
GCF_040790795.1_ASM4079079v1_genomic	NZ_CP161158.1	897172	898156	984	renamed_GCF_000008685.2	chromosome	900798	901782	984	100.0	5.014e-220
GCF_040790795.1_ASM4079079v1_genomic	NZ_CP161158.1	898207	899632	1425	renamed_GCF_000008685.2	chromosome	901833	903258	1425	99.7	2.69e-310
GCF_040790795.1_ASM4079079v1_genomic	NZ_CP161158.1	901274	900302	972	renamed_GCF_000008685.2	chromosome	904900	903928	972	99.3	1.264e-207
GCF_040790795.1_ASM4079079v1_genomic	NZ_CP161158.1	902684	903473	789	renamed_GCF_000008685.2	lp21	2867	3656	789	99.6	6.373e-176
GCF_040790795.1_ASM4079079v1_genomic	NZ_CP161158.1	912643	913231	588	renamed_GCF_000008685.2	lp21	14647	15235	588	100.0	4.973e-128
GCF_040790795.1_ASM4079079v1_genomic	NZ_CP161158.1	913344	913809	465	renamed_GCF_000008685.2	lp21	15348	15813	465	99.3	4.176e-101
GCF_040790795.1_ASM4079079v1_genomic	NZ_CP161158.1	913786	914080	294	renamed_GCF_000008685.2	lp21	15790	16084	294	100.0	2.432e-62
GCF_040790795.1_ASM4079079v1_genomic	NZ_CP161167.1	6674	7712	1038	renamed_GCF_000008685.2	cp26	6676	7714	1038	99.4	4.211e-231
GCF_040790795.1_ASM4079079v1_genomic	NZ_CP161167.1	7833	8763	930	renamed_GCF_000008685.2	cp26	7835	8765	930	97.7	1.145e-201
GCF_040790795.1_ASM4079079v1_genomic	NZ_CP161167.1	9272	10034	762	renamed_GCF_000008685.2	cp26	9274	10036	762	98.8	5.77e-164
GCF_040790795.1_ASM4079079v1_genomic	NZ_CP161167.1	10101	10650	549	renamed_GCF_000008685.2	cp26	10103	10652	549	99.4	1.544e-117
GCF_040790795.1_ASM4079079v1_genomic	NZ_CP161167.1	11418	10920	498	renamed_GCF_000008685.2	cp26	11417	10919	498	98.1	4.372e-106
GCF_040790795.1_ASM4079079v1_genomic	NZ_CP161167.1	12013	13606	1593	renamed_GCF_000008685.2	cp26	12013	13606	1593	99.4	0.0
GCF_040790795.1_ASM4079079v1_genomic	NZ_CP161167.1	15107	13892	1215	renamed_GCF_000008685.2	cp26	15107	13892	1215	97.7	4.167e-261
GCF_040790795.1_ASM4079079v1_genomic	NZ_CP161167.1	16670	15131	1539	renamed_GCF_000008685.2	cp26	16667	15131	1539	98.0	0.0
GCF_040790795.1_ASM4079079v1_genomic	NZ_CP161173.1	354	966	612	renamed_GCF_000008685.2	lp56	20843	21455	612	88.6	4.774e-124
GCF_040790795.1_ASM4079079v1_genomic	NZ_CP161173.1	1993	1042	951	renamed_GCF_000008685.2	cp32-3	19228	18286	951	88.3	7.644e-184
GCF_040790795.1_ASM4079079v1_genomic	NZ_CP161173.1	2368	3466	1098	renamed_GCF_000008685.2	cp32-7	19116	20214	1098	98.3	1.326e-245
GCF_040790795.1_ASM4079079v1_genomic	NZ_CP161173.1	3475	4042	567	renamed_GCF_000008685.2	cp32-3	20714	21281	567	99.4	6.547e-130
GCF_040790795.1_ASM4079079v1_genomic	NZ_CP161173.1	7769	8195	426	renamed_GCF_000008685.2	cp32-7	24512	24938	426	100.0	8.056e-96
GCF_040790795.1_ASM4079079v1_genomic	NZ_CP161173.1	8977	8200	777	renamed_GCF_000008685.2	cp32-7	25720	24943	777	100.0	1.414e-173
GCF_040790795.1_ASM4079079v1_genomic	NZ_CP161173.1	9408	10110	702	renamed_GCF_000008685.2	cp32-7	26151	26841	702	81.59	3.385e-117
GCF_040790795.1_ASM4079079v1_genomic	NZ_CP161173.1	10904	10211	693	renamed_GCF_000008685.2	cp32-6	27745	27076	693	27.6	2.503e-09
GCF_040790795.1_ASM4079079v1_genomic	NZ_CP161162.1	2	1289	1287	renamed_GCF_000008685.2	cp32-6	65	1289	1287	99.7	2.746e-269
GCF_040790795.1_ASM4079079v1_genomic	NZ_CP161162.1	1305	1998	693	renamed_GCF_000008685.2	cp32-6	1305	1998	693	99.5	5.741e-144
GCF_040790795.1_ASM4079079v1_genomic	NZ_CP161162.1	2009	2573	564	renamed_GCF_000008685.2	cp32-4	2012	2576	564	98.9	1.105e-123
GCF_040790795.1_ASM4079079v1_genomic	NZ_CP161162.1	2576	3344	768	renamed_GCF_000008685.2	cp32-6	2576	3344	768	98.8	8.033e-170
GCF_040790795.1_ASM4079079v1_genomic	NZ_CP161162.1	3372	3948	576	renamed_GCF_000008685.2	lp56	6835	7411	576	98.9	2.236e-126
GCF_040790795.1_ASM4079079v1_genomic	NZ_CP161162.1	3969	4929	960	renamed_GCF_000008685.2	cp32-6	3969	4929	960	100.0	6.008e-214
GCF_040790795.1_ASM4079079v1_genomic	NZ_CP161162.1	10946	11888	942	renamed_GCF_000008685.2	cp32-7	10961	11903	942	95.5	4.704e-205
GCF_040790795.1_ASM4079079v1_genomic	NZ_CP161162.1	12824	13703	879	renamed_GCF_000008685.2	cp32-7	12831	13710	879	96.2	1.027e-185
GCF_040790795.1_ASM4079079v1_genomic	NZ_CP161162.1	13708	14314	606	renamed_GCF_000008685.2	cp32-7	13715	14321	606	95.5	4.344e-124
GCF_040790795.1_ASM4079079v1_genomic	NZ_CP161162.1	15212	15416	204	renamed_GCF_000008685.2	cp32-1	15214	15418	204	100.0	2.578e-39
GCF_040790795.1_ASM4079079v1_genomic	NZ_CP161162.1	15419	15767	348	renamed_GCF_000008685.2	cp32-6	15437	15785	348	99.1	1.964e-73
GCF_040790795.1_ASM4079079v1_genomic	NZ_CP161162.1	15756	16092	336	renamed_GCF_000008685.2	cp32-3	15755	16091	336	100.0	5.348e-69
GCF_040790795.1_ASM4079079v1_genomic	NZ_CP161162.1	16084	16438	354	renamed_GCF_000008685.2	cp32-3	16083	16437	354	100.0	1.459e-77
GCF_040790795.1_ASM4079079v1_genomic	NZ_CP161161.1	3973	4933	960	renamed_GCF_000008685.2	lp56	7432	8392	960	100.0	6.008e-214
GCF_040790795.1_ASM4079079v1_genomic	NZ_CP161161.1	4952	5408	456	renamed_GCF_000008685.2	cp32-6	4948	5404	456	99.3	5.32e-97
GCF_040790795.1_ASM4079079v1_genomic	NZ_CP161161.1	5778	6168	390	renamed_GCF_000008685.2	cp32-9	5783	6173	390	100.0	3.229e-83
GCF_040790795.1_ASM4079079v1_genomic	NZ_CP161161.1	6164	6731	567	renamed_GCF_000008685.2	cp32-9	6169	6736	567	99.4	4.74e-125
GCF_040790795.1_ASM4079079v1_genomic	NZ_CP161161.1	6711	7824	1113	renamed_GCF_000008685.2	cp32-4	6710	7823	1113	98.9	1.837e-244
GCF_040790795.1_ASM4079079v1_genomic	NZ_CP161161.1	16809	16326	483	renamed_GCF_000008685.2	cp32-6	17075	16592	483	69.29	4.924e-69
GCF_040790795.1_ASM4079079v1_genomic	NZ_CP161161.1	21183	21939	756	renamed_GCF_000008685.2	cp32-4	20608	21364	756	98.8	4.353e-166
GCF_040790795.1_ASM4079079v1_genomic	NZ_CP161161.1	21989	22535	546	renamed_GCF_000008685.2	cp32-4	21414	21960	546	100.0	3.273e-117
GCF_040790795.1_ASM4079079v1_genomic	NZ_CP161161.1	26532	27639	1107	renamed_GCF_000008685.2	lp56	29936	30974	1107	35.4	1.587e-55
GCF_040790795.1_ASM4079079v1_genomic	NZ_CP161161.1	28390	28957	567	renamed_GCF_000008685.2	cp32-1	28834	29401	567	94.1	2.483e-115
GCF_040790795.1_ASM4079079v1_genomic	NZ_CP161171.1	6740	6944	204	renamed_GCF_000008685.2	cp32-7	15221	15425	204	100.0	2.578e-39
GCF_040790795.1_ASM4079079v1_genomic	NZ_CP161171.1	6947	7295	348	renamed_GCF_000008685.2	cp32-1	15421	15769	348	99.1	4.373e-73
GCF_040790795.1_ASM4079079v1_genomic	NZ_CP161171.1	7284	7620	336	renamed_GCF_000008685.2	lp56	19256	19592	336	100.0	5.348e-69
GCF_040790795.1_ASM4079079v1_genomic	NZ_CP161171.1	8070	8646	576	renamed_GCF_000008685.2	cp32-7	16551	17139	576	91.2	4.184e-111
GCF_040790795.1_ASM4079079v1_genomic	NZ_CP161171.1	8751	9186	435	renamed_GCF_000008685.2	cp32-1	17231	17678	435	78.2	1.59e-73
GCF_040790795.1_ASM4079079v1_genomic	NZ_CP161171.1	10170	9222	948	renamed_GCF_000008685.2	cp32-6	18680	17732	948	96.4	7.219e-210
GCF_040790795.1_ASM4079079v1_genomic	NZ_CP161171.1	11667	12234	567	renamed_GCF_000008685.2	lp56	23975	24542	567	99.4	3.238e-129
GCF_040790795.1_ASM4079079v1_genomic	NZ_CP161171.1	12209	12959	750	renamed_GCF_000008685.2	cp32-7	20765	21515	750	100.0	2.593e-162
GCF_040790795.1_ASM4079079v1_genomic	NZ_CP161172.1	6223	6907	684	renamed_GCF_000008685.2	lp17	5055	5739	684	99.5	1.274e-150
GCF_040790795.1_ASM4079079v1_genomic	NZ_CP161172.1	7631	7052	579	renamed_GCF_000008685.2	lp17	6452	5873	579	99.4	1.16e-125
GCF_040790795.1_ASM4079079v1_genomic	NZ_CP161172.1	8962	9289	327	renamed_GCF_000008685.2	lp17	7784	8111	327	99.0	2.291e-68
GCF_040790795.1_ASM4079079v1_genomic	NZ_CP161172.1	9444	10557	1113	renamed_GCF_000008685.2	lp17	8266	9379	1113	93.7	5.062e-233
GCF_040790795.1_ASM4079079v1_genomic	NZ_CP161172.1	11067	10773	294	renamed_GCF_000008685.2	lp17	9980	9590	294	95.8	5.989e-61
GCF_040790795.1_ASM4079079v1_genomic	NZ_CP161172.1	12586	11923	663	renamed_GCF_000008685.2	lp17	11646	10983	663	100.0	1.005e-149
GCF_040790795.1_ASM4079079v1_genomic	NZ_CP161172.1	14408	15149	741	renamed_GCF_000008685.2	lp17	13338	14079	741	100.0	7.64e-166
GCF_040790795.1_ASM4079079v1_genomic	NZ_CP161172.1	15139	15409	270	renamed_GCF_000008685.2	lp17	14069	14339	270	100.0	1.489e-55
GCF_040790795.1_ASM4079079v1_genomic	NZ_CP161172.1	17192	16961	231	renamed_GCF_000008685.2	lp17	16119	15888	231	98.6	8.774e-47
GCF_040790795.1_ASM4079079v1_genomic	NZ_CP161169.1	10189	9568	621	renamed_GCF_000008685.2	lp25	10187	9566	621	97.0	1.766e-136
GCF_040790795.1_ASM4079079v1_genomic	NZ_CP161169.1	10708	10201	507	renamed_GCF_000008685.2	lp25	10694	10199	507	96.3	2.496e-105
GCF_040790795.1_ASM4079079v1_genomic	NZ_CP161169.1	11828	11246	582	renamed_GCF_000008685.2	lp25	12079	11497	582	98.9	1.106e-126
GCF_040790795.1_ASM4079079v1_genomic	NZ_CP161169.1	12603	11844	759	renamed_GCF_000008685.2	lp25	12854	12095	759	98.4	5.504e-164
GCF_040790795.1_ASM4079079v1_genomic	NZ_CP161169.1	13142	12578	564	renamed_GCF_000008685.2	lp25	13393	12829	564	94.6	2.975e-121
GCF_040790795.1_ASM4079079v1_genomic	NZ_CP161169.1	14237	13151	1086	renamed_GCF_000008685.2	lp25	14530	13402	1086	93.3	2.166e-229
GCF_040790795.1_ASM4079079v1_genomic	NZ_CP161169.1	15309	14805	504	renamed_GCF_000008685.2	lp25	15545	15041	504	94.0	7.29e-110
GCF_040790795.1_ASM4079079v1_genomic	NZ_CP161169.1	20278	19546	732	renamed_GCF_000008685.2	lp25	22677	21945	732	84.0	3.237e-131
GCF_040790795.1_ASM4079079v1_genomic	NZ_CP161168.1	11067	10506	561	renamed_GCF_000008685.2	lp28-1	14329	13768	561	98.9	4.739e-124
GCF_040790795.1_ASM4079079v1_genomic	NZ_CP161168.1	12190	11122	1068	renamed_GCF_000008685.2	lp28-1	15451	14350	1068	96.0	6.722e-231
GCF_040790795.1_ASM4079079v1_genomic	NZ_CP161168.1	21917	19937	1980	renamed_GCF_000008685.2	lp28-1	26996	28073	1980	50.4	2.903e-45
GCF_040790795.1_ASM4079079v1_genomic	NZ_CP161164.1	411	837	426	renamed_GCF_000008685.2	lp56	52608	52134	426	97.7	4.735e-85
GCF_040790795.1_ASM4079079v1_genomic	NZ_CP161164.1	17487	18054	567	renamed_GCF_000008685.2	lp28-3	17407	17974	567	99.4	9.584e-126
GCF_040790795.1_ASM4079079v1_genomic	NZ_CP161164.1	18026	18782	756	renamed_GCF_000008685.2	lp28-3	17946	18702	756	100.0	8.81e-167
GCF_040790795.1_ASM4079079v1_genomic	NZ_CP161164.1	18877	19507	630	renamed_GCF_000008685.2	lp28-3	18797	19427	630	100.0	1.007e-135
GCF_040790795.1_ASM4079079v1_genomic	NZ_CP161164.1	21549	22299	750	renamed_GCF_000008685.2	lp28-3	21469	22219	750	100.0	6.33e-161
GCF_040790795.1_ASM4079079v1_genomic	NZ_CP161164.1	22759	23035	276	renamed_GCF_000008685.2	lp28-3	22677	22953	276	100.0	6.026e-58
GCF_040790795.1_ASM4079079v1_genomic	NZ_CP161164.1	26380	25513	867	renamed_GCF_000008685.2	lp28-3	26371	25432	867	99.6	1.571e-187
GCF_040790795.1_ASM4079079v1_genomic	NZ_CP161164.1	27525	27057	468	renamed_GCF_000008685.2	lp28-3	27445	26977	468	98.7	2.979e-105
GCF_040790795.1_ASM4079079v1_genomic	NZ_CP161164.1	27848	28403	555	renamed_GCF_000008685.2	lp28-4	26359	26914	555	98.9	1.054e-122
GCF_040790795.1_ASM4079079v1_genomic	NZ_CP161163.1	25975	25108	867	renamed_GCF_000008685.2	lp28-4	25089	24222	867	96.1	1.236e-181
GCF_040790795.1_ASM4079079v1_genomic	NZ_CP161163.1	29617	28723	894	renamed_GCF_000008685.2	lp36	187	1081	894	98.6	8.951e-190
GCF_040790795.1_ASM4079079v1_genomic	NZ_CP161166.1	9270	8841	429	renamed_GCF_000008685.2	lp28-2	11491	11062	429	99.2	1.514e-89
GCF_040790795.1_ASM4079079v1_genomic	NZ_CP161166.1	10098	9279	819	renamed_GCF_000008685.2	lp28-2	12319	11500	819	100.0	1.075e-183
GCF_040790795.1_ASM4079079v1_genomic	NZ_CP161166.1	10531	10087	444	renamed_GCF_000008685.2	lp28-2	12752	12308	444	100.0	8.866e-98
GCF_040790795.1_ASM4079079v1_genomic	NZ_CP161166.1	10920	10527	393	renamed_GCF_000008685.2	lp28-2	13141	12748	393	99.2	3.389e-83
GCF_040790795.1_ASM4079079v1_genomic	NZ_CP161166.1	11274	10935	339	renamed_GCF_000008685.2	lp28-2	13495	13156	339	96.4	2.068e-71
GCF_040790795.1_ASM4079079v1_genomic	NZ_CP161166.1	12120	11286	834	renamed_GCF_000008685.2	lp28-2	14341	13507	834	97.1	3.643e-181
GCF_040790795.1_ASM4079079v1_genomic	NZ_CP161166.1	12665	12155	510	renamed_GCF_000008685.2	lp28-2	14885	14375	510	97.6	2.379e-106
GCF_040790795.1_ASM4079079v1_genomic	NZ_CP161166.1	13211	12665	546	renamed_GCF_000008685.2	lp28-2	15431	14885	546	99.4	4.794e-113
GCF_040790795.1_ASM4079079v1_genomic	NZ_CP161166.1	22320	23778	1458	renamed_GCF_000008685.2	lp28-2	24488	25955	1458	64.8	2.654e-200
GCF_040790795.1_ASM4079079v1_genomic	NZ_CP161166.1	23802	24195	393	renamed_GCF_000008685.2	lp28-2	25979	26390	393	83.8	4.469e-72
GCF_040790795.1_ASM4079079v1_genomic	NZ_CP161166.1	24346	24883	537	renamed_GCF_000008685.2	lp28-2	26569	27085	537	52.2	3.419e-56
GCF_040790795.1_ASM4079079v1_genomic	NZ_CP161166.1	24942	25851	909	renamed_GCF_000008685.2	lp28-2	28030	28831	909	70.8	7.319e-125
GCF_040790795.1_ASM4079079v1_genomic	NZ_CP161166.1	26637	25872	765	renamed_GCF_000008685.2	lp28-2	29618	28853	765	77.5	1.436e-128
GCF_040790795.1_ASM4079079v1_genomic	NZ_CP161170.1	757	1129	372	renamed_GCF_000008685.2	lp5	1207	1576	372	81.29	1.564e-63
GCF_040790795.1_ASM4079079v1_genomic	NZ_CP161170.1	3491	2738	753	renamed_GCF_000008685.2	lp36	6040	5287	753	99.6	3.6e-159
GCF_040790795.1_ASM4079079v1_genomic	NZ_CP161170.1	3825	4101	276	renamed_GCF_000008685.2	lp36	6365	6650	276	98.9	6.026e-58
GCF_040790795.1_ASM4079079v1_genomic	NZ_CP161170.1	15628	16720	1092	renamed_GCF_000008685.2	lp36	20388	21453	1092	96.9	5.792e-228
GCF_040790795.1_ASM4079079v1_genomic	NZ_CP161170.1	17178	17400	222	renamed_GCF_000008685.2	lp36	21911	22133	222	100.0	1.866e-45
GCF_040790795.1_ASM4079079v1_genomic	NZ_CP161170.1	17561	17735	174	renamed_GCF_000008685.2	lp36	22293	22467	174	92.9	1.178e-34
GCF_040790795.1_ASM4079079v1_genomic	NZ_CP161170.1	18366	18660	294	renamed_GCF_000008685.2	lp28-1	10895	10697	294	98.4	2.041e-40
GCF_040790795.1_ASM4079079v1_genomic	NZ_CP161170.1	20469	20127	342	renamed_GCF_000008685.2	lp28-3	8017	8431	342	61.5	0.0002439
GCF_040790795.1_ASM4079079v1_genomic	NZ_CP161170.1	22260	21411	849	renamed_GCF_000008685.2	lp36	35443	34594	849	98.2	2.634e-187
GCF_040790795.1_ASM4079079v1_genomic	NZ_CP161170.1	22808	22256	552	renamed_GCF_000008685.2	lp56	855	1407	552	96.7	3.6e-117
GCF_040790795.1_ASM4079079v1_genomic	NZ_CP161160.1	23298	24288	990	renamed_GCF_000008685.2	lp38	13440	12444	990	82.2	3.09e-183
GCF_040790795.1_ASM4079079v1_genomic	NZ_CP161160.1	24280	24871	591	renamed_GCF_000008685.2	lp38	12452	11861	591	89.6	1.347e-117
GCF_040790795.1_ASM4079079v1_genomic	NZ_CP161160.1	24843	25581	738	renamed_GCF_000008685.2	lp38	11889	11151	738	91.8	4.993e-153
GCF_040790795.1_ASM4079079v1_genomic	NZ_CP161160.1	25626	26220	594	renamed_GCF_000008685.2	lp38	11105	10517	594	89.3	1.877e-114
GCF_040790795.1_ASM4079079v1_genomic	NZ_CP161160.1	28700	27614	1086	renamed_GCF_000008685.2	lp38	26407	25336	1086	71.9	9.594e-160
GCF_040790795.1_ASM4079079v1_genomic	NZ_CP161159.1	653	1139	486	renamed_GCF_000008685.2	lp28-3	28197	27624	486	47.8	4.56e-45
GCF_040790795.1_ASM4079079v1_genomic	NZ_CP161159.1	1461	1971	510	renamed_GCF_000008685.2	lp54	1460	1970	510	100.0	8.829e-109
GCF_040790795.1_ASM4079079v1_genomic	NZ_CP161159.1	2895	2046	849	renamed_GCF_000008685.2	lp54	2893	2044	849	98.9	7.054e-185
GCF_040790795.1_ASM4079079v1_genomic	NZ_CP161159.1	10288	11179	891	renamed_GCF_000008685.2	lp54	10287	11178	891	99.3	1.029e-187
GCF_040790795.1_ASM4079079v1_genomic	NZ_CP161159.1	13059	13644	585	renamed_GCF_000008685.2	lp54	12994	13579	585	100.0	1.763e-130
GCF_040790795.1_ASM4079079v1_genomic	NZ_CP161159.1	13619	14372	753	renamed_GCF_000008685.2	lp54	13554	14307	753	100.0	4.561e-165
GCF_040790795.1_ASM4079079v1_genomic	NZ_CP161159.1	14402	14948	546	renamed_GCF_000008685.2	lp54	14337	14883	546	100.0	1.338e-118
GCF_040790795.1_ASM4079079v1_genomic	NZ_CP161159.1	15434	15866	432	renamed_GCF_000008685.2	lp54	15369	15801	432	97.2	9.777e-95
GCF_040790795.1_ASM4079079v1_genomic	NZ_CP161159.1	17346	16782	564	renamed_GCF_000008685.2	lp54	17259	16695	564	99.4	2.368e-115
GCF_040790795.1_ASM4079079v1_genomic	NZ_CP161159.1	18214	18808	594	renamed_GCF_000008685.2	lp54	18127	18721	594	99.4	7.271e-125
GCF_040790795.1_ASM4079079v1_genomic	NZ_CP161159.1	20759	20954	195	renamed_GCF_000008685.2	lp54	20717	20912	195	100.0	2.214e-39
GCF_040790795.1_ASM4079079v1_genomic	NZ_CP161159.1	44599	43750	849	renamed_GCF_000008685.2	lp54	44533	43684	849	100.0	7.054e-185
GCF_040790795.1_ASM4079079v1_genomic	NZ_CP161159.1	46013	44777	1236	renamed_GCF_000008685.2	lp54	45947	44711	1236	99.2	3.647e-266
GCF_040790795.1_ASM4079079v1_genomic	NZ_CP161159.1	49391	48599	792	renamed_GCF_000008685.2	lp54	48267	47475	792	99.2	5.269e-170
GCF_040790795.1_ASM4079079v1_genomic	NZ_CP161159.1	50250	50025	225	renamed_GCF_000008685.2	lp54	50077	49852	225	97.2	1.083e-43
GCF_040790795.1_ASM4079079v1_genomic	NZ_CP161159.1	51878	52652	774	renamed_GCF_000008685.2	lp54	51705	52479	774	100.0	9.219e-161
GCF_040790795.1_ASM4079079v1_genomic	NZ_CP161158.1	70016	71063	1047	renamed_GCF_000008685.2	chromosome	70141	71219	1047	99.7	6.395e-228
GCF_040790795.1_ASM4079079v1_genomic	NZ_CP161158.1	76293	77544	1251	renamed_GCF_000008685.2	chromosome	76450	77701	1251	99.7	8.508e-268
GCF_040790795.1_ASM4079079v1_genomic	NZ_CP161158.1	79195	78844	351	renamed_GCF_000008685.2	chromosome	79322	79001	351	99.0	3.732e-67
GCF_040790795.1_ASM4079079v1_genomic	NZ_CP161158.1	130955	130010	945	renamed_GCF_000008685.2	chromosome	131114	130169	945	100.0	6.888e-210
GCF_040790795.1_ASM4079079v1_genomic	NZ_CP161158.1	147348	146229	1119	renamed_GCF_000008685.2	chromosome	147495	146376	1119	100.0	3.727e-246
GCF_040790795.1_ASM4079079v1_genomic	NZ_CP161158.1	150822	152028	1206	renamed_GCF_000008685.2	chromosome	150973	152179	1206	99.7	1.095e-274
GCF_040790795.1_ASM4079079v1_genomic	NZ_CP161158.1	153535	152923	612	renamed_GCF_000008685.2	chromosome	153686	153074	612	100.0	4.712e-141
GCF_040790795.1_ASM4079079v1_genomic	NZ_CP161158.1	156311	157448	1137	renamed_GCF_000008685.2	chromosome	156461	157598	1137	100.0	1.164e-253
GCF_040790795.1_ASM4079079v1_genomic	NZ_CP161158.1	157907	158324	417	renamed_GCF_000008685.2	chromosome	158075	158474	417	100.0	2.72e-81
GCF_040790795.1_ASM4079079v1_genomic	NZ_CP161158.1	171100	171334	234	renamed_GCF_000008685.2	chromosome	171262	171484	234	97.2	1.134e-44
GCF_040790795.1_ASM4079079v1_genomic	NZ_CP161158.1	173430	171381	2049	renamed_GCF_000008685.2	chromosome	173535	171531	2049	99.2	0.0
GCF_040790795.1_ASM4079079v1_genomic	NZ_CP161158.1	174934	173947	987	renamed_GCF_000008685.2	chromosome	174970	174097	987	99.6	1.701e-189
GCF_040790795.1_ASM4079079v1_genomic	NZ_CP161158.1	177703	176827	876	renamed_GCF_000008685.2	chromosome	177853	176977	876	100.0	9.427e-195
GCF_040790795.1_ASM4079079v1_genomic	NZ_CP161158.1	232025	234941	2916	renamed_GCF_000008685.2	chromosome	232337	235253	2916	99.8	0.0
GCF_040790795.1_ASM4079079v1_genomic	NZ_CP161158.1	236830	235282	1548	renamed_GCF_000008685.2	chromosome	237142	235594	1548	99.8	0.0
GCF_040790795.1_ASM4079079v1_genomic	NZ_CP161158.1	237644	237317	327	renamed_GCF_000008685.2	chromosome	237956	237629	327	99.0	4.183e-70
GCF_040790795.1_ASM4079079v1_genomic	NZ_CP161158.1	238816	237988	828	renamed_GCF_000008685.2	chromosome	239128	238300	828	98.9	1.128e-184
GCF_040790795.1_ASM4079079v1_genomic	NZ_CP161158.1	241977	239970	2007	renamed_GCF_000008685.2	chromosome	242289	240282	2007	99.4	0.0
GCF_040790795.1_ASM4079079v1_genomic	NZ_CP161158.1	255332	255947	615	renamed_GCF_000008685.2	chromosome	255645	256260	615	99.5	1.275e-130
GCF_040790795.1_ASM4079079v1_genomic	NZ_CP161158.1	263399	260978	2421	renamed_GCF_000008685.2	chromosome	263712	261291	2421	100.0	0.0
GCF_040790795.1_ASM4079079v1_genomic	NZ_CP161158.1	266752	266962	210	renamed_GCF_000008685.2	chromosome	267065	267275	210	100.0	4.647e-42
GCF_040790795.1_ASM4079079v1_genomic	NZ_CP161158.1	270160	269359	801	renamed_GCF_000008685.2	chromosome	270473	269672	801	99.6	3.29e-168
GCF_040790795.1_ASM4079079v1_genomic	NZ_CP161158.1	292122	291339	783	renamed_GCF_000008685.2	chromosome	292426	291643	783	100.0	1.874e-171
GCF_040790795.1_ASM4079079v1_genomic	NZ_CP161158.1	324932	323471	1461	renamed_GCF_000008685.2	chromosome	325236	323775	1461	99.7	0.0
GCF_040790795.1_ASM4079079v1_genomic	NZ_CP161158.1	327422	326393	1029	renamed_GCF_000008685.2	chromosome	327757	326698	1029	99.4	1.646e-231
GCF_040790795.1_ASM4079079v1_genomic	NZ_CP161158.1	327726	328863	1137	renamed_GCF_000008685.2	chromosome	328031	329165	1137	99.7	1.4e-251
GCF_040790795.1_ASM4079079v1_genomic	NZ_CP161158.1	330450	329340	1110	renamed_GCF_000008685.2	chromosome	330752	329642	1110	100.0	1.105e-249
GCF_040790795.1_ASM4079079v1_genomic	NZ_CP161158.1	333305	330500	2805	renamed_GCF_000008685.2	chromosome	333598	330802	2805	99.6	0.0
GCF_040790795.1_ASM4079079v1_genomic	NZ_CP161158.1	334643	336215	1572	renamed_GCF_000008685.2	chromosome	334936	336508	1572	99.6	0.0
GCF_040790795.1_ASM4079079v1_genomic	NZ_CP161158.1	338052	339678	1626	renamed_GCF_000008685.2	chromosome	338357	339983	1626	99.8	0.0
GCF_040790795.1_ASM4079079v1_genomic	NZ_CP161158.1	340968	342018	1050	renamed_GCF_000008685.2	chromosome	341273	342323	1050	100.0	1.489e-227
GCF_040790795.1_ASM4079079v1_genomic	NZ_CP161158.1	353135	351035	2100	renamed_GCF_000008685.2	chromosome	353437	351340	2100	98.1	0.0
GCF_040790795.1_ASM4079079v1_genomic	NZ_CP161158.1	354993	354342	651	renamed_GCF_000008685.2	chromosome	355298	354647	651	100.0	1.769e-141
GCF_040790795.1_ASM4079079v1_genomic	NZ_CP161158.1	405874	405385	489	renamed_GCF_000008685.2	chromosome	406176	405687	489	99.3	6.125e-101
GCF_040790795.1_ASM4079079v1_genomic	NZ_CP161158.1	406990	406558	432	renamed_GCF_000008685.2	chromosome	407292	406860	432	99.3	1.75e-88
GCF_040790795.1_ASM4079079v1_genomic	NZ_CP161158.1	426445	427660	1215	renamed_GCF_000008685.2	chromosome	426735	427950	1215	99.7	1.711e-262
GCF_040790795.1_ASM4079079v1_genomic	NZ_CP161158.1	428355	429384	1029	renamed_GCF_000008685.2	chromosome	428645	429674	1029	99.1	2.098e-237
GCF_040790795.1_ASM4079079v1_genomic	NZ_CP161158.1	434813	430328	4485	renamed_GCF_000008685.2	chromosome	435103	430618	4485	98.1	0.0
GCF_040790795.1_ASM4079079v1_genomic	NZ_CP161158.1	443341	442792	549	renamed_GCF_000008685.2	chromosome	446875	446326	549	98.9	2.344e-121
GCF_040790795.1_ASM4079079v1_genomic	NZ_CP161158.1	444321	444639	318	renamed_GCF_000008685.2	chromosome	447854	448172	318	98.0	4.406e-68
GCF_040790795.1_ASM4079079v1_genomic	NZ_CP161158.1	456382	456538	156	renamed_GCF_000008685.2	chromosome	459915	460071	156	100.0	2.965e-30
GCF_040790795.1_ASM4079079v1_genomic	NZ_CP161158.1	458511	459240	729	renamed_GCF_000008685.2	chromosome	462044	462773	729	98.7	1.34e-157
GCF_040790795.1_ASM4079079v1_genomic	NZ_CP161158.1	481239	481743	504	renamed_GCF_000008685.2	chromosome	484756	485266	504	99.4	1.338e-111
GCF_040790795.1_ASM4079079v1_genomic	NZ_CP161158.1	509616	508869	747	renamed_GCF_000008685.2	chromosome	513139	512392	747	100.0	7.284e-159
GCF_040790795.1_ASM4079079v1_genomic	NZ_CP161158.1	541055	543857	2802	renamed_GCF_000008685.2	chromosome	544585	547387	2802	98.8	0.0
GCF_040790795.1_ASM4079079v1_genomic	NZ_CP161158.1	545355	544956	399	renamed_GCF_000008685.2	chromosome	548885	548486	399	99.2	3.385e-84
GCF_040790795.1_ASM4079079v1_genomic	NZ_CP161158.1	550467	551688	1221	renamed_GCF_000008685.2	chromosome	553991	555212	1221	100.0	5.34e-268
GCF_040790795.1_ASM4079079v1_genomic	NZ_CP161158.1	564725	565595	870	renamed_GCF_000008685.2	chromosome	568269	569139	870	100.0	1.737e-195
GCF_040790795.1_ASM4079079v1_genomic	NZ_CP161158.1	627147	625644	1503	renamed_GCF_000008685.2	chromosome	630698	629195	1503	100.0	0.0
GCF_040790795.1_ASM4079079v1_genomic	NZ_CP161158.1	1790	761	1029	renamed_GCF_000008685.2	chromosome	1796	767	1029	100.0	4.829e-228
GCF_040790795.1_ASM4079079v1_genomic	NZ_CP161158.1	3389	5183	1794	renamed_GCF_000008685.2	chromosome	3418	5188	1794	99.4	0.0
GCF_040790795.1_ASM4079079v1_genomic	NZ_CP161158.1	7392	6303	1089	renamed_GCF_000008685.2	chromosome	7397	6308	1089	99.7	9.025e-240
GCF_040790795.1_ASM4079079v1_genomic	NZ_CP161158.1	8421	9192	771	renamed_GCF_000008685.2	chromosome	8426	9197	771	100.0	1.781e-161
GCF_040790795.1_ASM4079079v1_genomic	NZ_CP161158.1	10197	10572	375	renamed_GCF_000008685.2	chromosome	10202	10577	375	99.1	8.349e-79
GCF_040790795.1_ASM4079079v1_genomic	NZ_CP161158.1	11415	12156	741	renamed_GCF_000008685.2	chromosome	11420	12161	741	99.1	4.555e-163
GCF_040790795.1_ASM4079079v1_genomic	NZ_CP161158.1	12740	14723	1983	renamed_GCF_000008685.2	chromosome	12745	14728	1983	99.8	0.0
GCF_040790795.1_ASM4079079v1_genomic	NZ_CP161158.1	15717	15339	378	renamed_GCF_000008685.2	chromosome	15716	15344	378	99.1	3.937e-79
GCF_040790795.1_ASM4079079v1_genomic	NZ_CP161158.1	41275	40603	672	renamed_GCF_000008685.2	chromosome	41432	40760	672	100.0	1.856e-144
GCF_040790795.1_ASM4079079v1_genomic	NZ_CP161158.1	42724	42322	402	renamed_GCF_000008685.2	chromosome	42881	42479	402	100.0	2.405e-88
GCF_040790795.1_ASM4079079v1_genomic	NZ_CP161158.1	45288	45834	546	renamed_GCF_000008685.2	chromosome	45445	45991	546	100.0	3.273e-117
GCF_040790795.1_ASM4079079v1_genomic	NZ_CP161158.1	47009	47684	675	renamed_GCF_000008685.2	chromosome	47166	47841	675	98.6	2.138e-143
GCF_040790795.1_ASM4079079v1_genomic	NZ_CP161158.1	49102	48445	657	renamed_GCF_000008685.2	chromosome	49259	48602	657	98.1	5.738e-138
GCF_040790795.1_ASM4079079v1_genomic	NZ_CP161158.1	50316	49953	363	renamed_GCF_000008685.2	chromosome	50474	50111	363	100.0	4.578e-75
GCF_040790795.1_ASM4079079v1_genomic	NZ_CP161158.1	52276	51094	1182	renamed_GCF_000008685.2	chromosome	52434	51252	1182	99.4	1.623e-257
GCF_040790795.1_ASM4079079v1_genomic	NZ_CP161158.1	55346	53375	1971	renamed_GCF_000008685.2	chromosome	55504	53533	1971	99.6	0.0
GCF_040790795.1_ASM4079079v1_genomic	NZ_CP161158.1	56590	56122	468	renamed_GCF_000008685.2	chromosome	56748	56280	468	99.3	1.969e-101
GCF_040790795.1_ASM4079079v1_genomic	NZ_CP161158.1	57100	57817	717	renamed_GCF_000008685.2	chromosome	57258	57975	717	98.7	3.592e-153
GCF_040790795.1_ASM4079079v1_genomic	NZ_CP161158.1	96797	94454	2343	renamed_GCF_000008685.2	chromosome	96953	94610	2343	98.8	0.0
GCF_040790795.1_ASM4079079v1_genomic	NZ_CP161158.1	98659	100048	1389	renamed_GCF_000008685.2	chromosome	98816	100205	1389	99.5	1.169e-313
GCF_040790795.1_ASM4079079v1_genomic	NZ_CP161158.1	101182	100588	594	renamed_GCF_000008685.2	chromosome	101339	100745	594	100.0	6.255e-135
GCF_040790795.1_ASM4079079v1_genomic	NZ_CP161158.1	103614	102858	756	renamed_GCF_000008685.2	chromosome	103771	103015	756	99.6	2.151e-165
GCF_040790795.1_ASM4079079v1_genomic	NZ_CP161158.1	105689	105260	429	renamed_GCF_000008685.2	chromosome	105846	105417	429	98.5	1.668e-88
GCF_040790795.1_ASM4079079v1_genomic	NZ_CP161158.1	110885	109517	1368	renamed_GCF_000008685.2	chromosome	111042	109674	1368	100.0	1.976e-295
GCF_040790795.1_ASM4079079v1_genomic	NZ_CP161158.1	132609	132312	297	renamed_GCF_000008685.2	chromosome	133842	132471	297	98.9	1.037e-63
GCF_040790795.1_ASM4079079v1_genomic	NZ_CP161158.1	137621	135728	1893	renamed_GCF_000008685.2	chromosome	137766	135873	1893	99.6	0.0
GCF_040790795.1_ASM4079079v1_genomic	NZ_CP161158.1	142785	141831	954	renamed_GCF_000008685.2	chromosome	142932	141978	954	99.0	1.826e-200
GCF_040790795.1_ASM4079079v1_genomic	NZ_CP161158.1	187681	187027	654	renamed_GCF_000008685.2	chromosome	187831	187177	654	100.0	1.397e-144
GCF_040790795.1_ASM4079079v1_genomic	NZ_CP161158.1	188344	188083	261	renamed_GCF_000008685.2	chromosome	188494	188233	261	98.8	1.572e-53
GCF_040790795.1_ASM4079079v1_genomic	NZ_CP161158.1	189709	189148	561	renamed_GCF_000008685.2	chromosome	189859	189298	561	100.0	1.275e-121
GCF_040790795.1_ASM4079079v1_genomic	NZ_CP161158.1	190568	191309	741	renamed_GCF_000008685.2	chromosome	190718	191459	741	99.5	3.597e-157
GCF_040790795.1_ASM4079079v1_genomic	NZ_CP161158.1	193313	192173	1140	renamed_GCF_000008685.2	chromosome	193463	192323	1140	99.7	9.252e-257
GCF_040790795.1_ASM4079079v1_genomic	NZ_CP161158.1	194725	195586	861	renamed_GCF_000008685.2	chromosome	194875	195736	861	98.9	3.489e-186
GCF_040790795.1_ASM4079079v1_genomic	NZ_CP161158.1	211150	211918	768	renamed_GCF_000008685.2	chromosome	211300	212068	768	100.0	8.822e-169
GCF_040790795.1_ASM4079079v1_genomic	NZ_CP161158.1	215114	216947	1833	renamed_GCF_000008685.2	chromosome	215426	217259	1833	99.6	0.0
GCF_040790795.1_ASM4079079v1_genomic	NZ_CP161158.1	218766	218112	654	renamed_GCF_000008685.2	chromosome	219078	218424	654	100.0	1.052e-147
GCF_040790795.1_ASM4079079v1_genomic	NZ_CP161158.1	219487	220327	840	renamed_GCF_000008685.2	chromosome	219799	220639	840	100.0	1.641e-182
GCF_040790795.1_ASM4079079v1_genomic	NZ_CP161158.1	281007	279102	1905	renamed_GCF_000008685.2	chromosome	281311	279406	1905	100.0	0.0
GCF_040790795.1_ASM4079079v1_genomic	NZ_CP161158.1	281489	281009	480	renamed_GCF_000008685.2	chromosome	281793	281313	480	99.3	5.307e-101
GCF_040790795.1_ASM4079079v1_genomic	NZ_CP161158.1	285655	283564	2091	renamed_GCF_000008685.2	chromosome	285962	283868	2091	99.4	0.0
GCF_040790795.1_ASM4079079v1_genomic	NZ_CP161158.1	287573	286784	789	renamed_GCF_000008685.2	chromosome	287877	287088	789	100.0	1.783e-164
GCF_040790795.1_ASM4079079v1_genomic	NZ_CP161158.1	288642	287877	765	renamed_GCF_000008685.2	chromosome	288946	288181	765	100.0	2.478e-165
GCF_040790795.1_ASM4079079v1_genomic	NZ_CP161158.1	289613	289271	342	renamed_GCF_000008685.2	chromosome	289917	289575	342	100.0	1.077e-70
GCF_040790795.1_ASM4079079v1_genomic	NZ_CP161158.1	291291	290754	537	renamed_GCF_000008685.2	chromosome	291595	291058	537	100.0	7.638e-115
GCF_040790795.1_ASM4079079v1_genomic	NZ_CP161158.1	302184	300474	1710	renamed_GCF_000008685.2	chromosome	302489	300779	1710	100.0	0.0
GCF_040790795.1_ASM4079079v1_genomic	NZ_CP161158.1	303435	303027	408	renamed_GCF_000008685.2	chromosome	303740	303332	408	99.2	2.649e-88
GCF_040790795.1_ASM4079079v1_genomic	NZ_CP161158.1	306313	305365	948	renamed_GCF_000008685.2	chromosome	306615	305670	948	99.6	1.604e-209
GCF_040790795.1_ASM4079079v1_genomic	NZ_CP161159.1	28976	29429	453	renamed_GCF_000008685.2	lp54	28934	29387	453	100.0	2.51e-96
GCF_040790795.1_ASM4079079v1_genomic	NZ_CP161159.1	29425	29800	375	renamed_GCF_000008685.2	lp54	29383	29758	375	100.0	1.685e-79
GCF_040790795.1_ASM4079079v1_genomic	NZ_CP161159.1	30135	30675	540	renamed_GCF_000008685.2	lp54	30093	30633	540	100.0	4.969e-120
GCF_040790795.1_ASM4079079v1_genomic	NZ_CP161159.1	30761	31832	1071	renamed_GCF_000008685.2	lp54	30709	31780	1071	99.4	1.082e-234
GCF_040790795.1_ASM4079079v1_genomic	NZ_CP161159.1	31831	32254	423	renamed_GCF_000008685.2	lp54	31779	32202	423	100.0	5.086e-92
GCF_040790795.1_ASM4079079v1_genomic	NZ_CP161159.1	32312	32801	489	renamed_GCF_000008685.2	lp54	32260	32749	489	100.0	3.125e-108
GCF_040790795.1_ASM4079079v1_genomic	NZ_CP161159.1	32793	33012	219	renamed_GCF_000008685.2	lp54	32741	32960	219	100.0	7.958e-46
GCF_040790795.1_ASM4079079v1_genomic	NZ_CP161159.1	34436	35000	564	renamed_GCF_000008685.2	lp54	34384	34948	564	99.4	3.599e-119
GCF_040790795.1_ASM4079079v1_genomic	NZ_CP161159.1	52878	53676	798	renamed_GCF_000008685.2	lp54	52705	53503	798	99.2	6.687e-177
GCF_040790795.1_ASM4079079v1_genomic	NZ_CP161158.1	71044	72454	1410	renamed_GCF_000008685.2	chromosome	71200	72610	1410	99.5	1.263e-307
GCF_040790795.1_ASM4079079v1_genomic	NZ_CP161158.1	72490	73336	846	renamed_GCF_000008685.2	chromosome	72646	73492	846	99.2	6.38e-177
GCF_040790795.1_ASM4079079v1_genomic	NZ_CP161158.1	75616	76297	681	renamed_GCF_000008685.2	chromosome	75773	76454	681	100.0	3.584e-147
GCF_040790795.1_ASM4079079v1_genomic	NZ_CP161158.1	78852	77553	1299	renamed_GCF_000008685.2	chromosome	79009	77710	1299	99.7	4.127e-284
GCF_040790795.1_ASM4079079v1_genomic	NZ_CP161158.1	112611	112191	420	renamed_GCF_000008685.2	chromosome	112769	112349	420	99.2	1.444e-88
GCF_040790795.1_ASM4079079v1_genomic	NZ_CP161158.1	116648	115346	1302	renamed_GCF_000008685.2	chromosome	116806	115504	1302	98.3	5.194e-282
GCF_040790795.1_ASM4079079v1_genomic	NZ_CP161158.1	118212	117519	693	renamed_GCF_000008685.2	chromosome	118370	117677	693	98.2	1.337e-151
GCF_040790795.1_ASM4079079v1_genomic	NZ_CP161158.1	119645	118805	840	renamed_GCF_000008685.2	chromosome	119803	118963	840	97.1	3.15e-175
GCF_040790795.1_ASM4079079v1_genomic	NZ_CP161158.1	120923	120644	279	renamed_GCF_000008685.2	chromosome	121082	120803	279	96.7	3.477e-56
GCF_040790795.1_ASM4079079v1_genomic	NZ_CP161158.1	170947	170569	378	renamed_GCF_000008685.2	chromosome	171097	170719	378	98.4	1.768e-79
GCF_040790795.1_ASM4079079v1_genomic	NZ_CP161158.1	173966	173378	588	renamed_GCF_000008685.2	chromosome	174116	173528	588	99.4	1.682e-131
GCF_040790795.1_ASM4079079v1_genomic	NZ_CP161158.1	176824	175918	906	renamed_GCF_000008685.2	chromosome	176974	176068	906	99.6	1.374e-195
GCF_040790795.1_ASM4079079v1_genomic	NZ_CP161158.1	178710	177717	993	renamed_GCF_000008685.2	chromosome	178860	177867	993	99.6	2.235e-213
GCF_040790795.1_ASM4079079v1_genomic	NZ_CP161158.1	202428	200901	1527	renamed_GCF_000008685.2	chromosome	202578	201051	1527	99.6	0.0
GCF_040790795.1_ASM4079079v1_genomic	NZ_CP161158.1	203986	204922	936	renamed_GCF_000008685.2	chromosome	204136	205072	936	100.0	4.7e-204
GCF_040790795.1_ASM4079079v1_genomic	NZ_CP161158.1	206379	207930	1551	renamed_GCF_000008685.2	chromosome	206528	208106	1551	99.8	0.0
GCF_040790795.1_ASM4079079v1_genomic	NZ_CP161158.1	244401	243630	771	renamed_GCF_000008685.2	chromosome	244713	243942	771	100.0	4.161e-169
GCF_040790795.1_ASM4079079v1_genomic	NZ_CP161158.1	256149	258672	2523	renamed_GCF_000008685.2	chromosome	256462	258985	2523	98.9	0.0
GCF_040790795.1_ASM4079079v1_genomic	NZ_CP161158.1	263674	265801	2127	renamed_GCF_000008685.2	chromosome	263987	266114	2127	99.4	0.0
GCF_040790795.1_ASM4079079v1_genomic	NZ_CP161158.1	265793	266738	945	renamed_GCF_000008685.2	chromosome	266106	267051	945	100.0	6.277e-211
GCF_040790795.1_ASM4079079v1_genomic	NZ_CP161158.1	272367	270174	2193	renamed_GCF_000008685.2	chromosome	272641	270487	2193	99.8	0.0
GCF_040790795.1_ASM4079079v1_genomic	NZ_CP161158.1	292904	292121	783	renamed_GCF_000008685.2	chromosome	293208	292425	783	99.6	6.057e-167
GCF_040790795.1_ASM4079079v1_genomic	NZ_CP161158.1	294923	294479	444	renamed_GCF_000008685.2	chromosome	295228	294784	444	98.6	1.306e-93
GCF_040790795.1_ASM4079079v1_genomic	NZ_CP161158.1	296740	296122	618	renamed_GCF_000008685.2	chromosome	297045	296427	618	99.5	5.47e-132
GCF_040790795.1_ASM4079079v1_genomic	NZ_CP161158.1	358152	358893	741	renamed_GCF_000008685.2	chromosome	358457	359198	741	99.5	4.555e-163
GCF_040790795.1_ASM4079079v1_genomic	NZ_CP161158.1	360773	359207	1566	renamed_GCF_000008685.2	chromosome	361078	359512	1566	99.6	0.0
GCF_040790795.1_ASM4079079v1_genomic	NZ_CP161158.1	363812	362012	1800	renamed_GCF_000008685.2	chromosome	364117	362317	1800	99.8	0.0
GCF_040790795.1_ASM4079079v1_genomic	NZ_CP161158.1	373847	373262	585	renamed_GCF_000008685.2	chromosome	374151	373566	585	99.4	4.742e-128
GCF_040790795.1_ASM4079079v1_genomic	NZ_CP161158.1	375356	375635	279	renamed_GCF_000008685.2	chromosome	375660	375939	279	100.0	3.143e-57
GCF_040790795.1_ASM4079079v1_genomic	NZ_CP161158.1	379026	376734	2292	renamed_GCF_000008685.2	chromosome	379258	377038	2292	98.2	0.0
GCF_040790795.1_ASM4079079v1_genomic	NZ_CP161158.1	381588	380250	1338	renamed_GCF_000008685.2	chromosome	381892	380554	1338	100.0	1.408e-311
GCF_040790795.1_ASM4079079v1_genomic	NZ_CP161158.1	383858	383090	768	renamed_GCF_000008685.2	chromosome	384162	383394	768	99.6	9.689e-168
GCF_040790795.1_ASM4079079v1_genomic	NZ_CP161158.1	396204	395178	1026	renamed_GCF_000008685.2	chromosome	396506	395480	1026	100.0	3.003e-224
GCF_040790795.1_ASM4079079v1_genomic	NZ_CP161158.1	397174	396799	375	renamed_GCF_000008685.2	chromosome	397476	397101	375	100.0	1.385e-81
GCF_040790795.1_ASM4079079v1_genomic	NZ_CP161158.1	459285	460353	1068	renamed_GCF_000008685.2	chromosome	462818	463886	1068	99.7	9.979e-244
GCF_040790795.1_ASM4079079v1_genomic	NZ_CP161158.1	460519	461599	1080	renamed_GCF_000008685.2	chromosome	464052	465132	1080	99.7	2.027e-246
GCF_040790795.1_ASM4079079v1_genomic	NZ_CP161158.1	463744	461983	1761	renamed_GCF_000008685.2	chromosome	467278	465517	1761	99.4	0.0
GCF_040790795.1_ASM4079079v1_genomic	NZ_CP161158.1	465853	463747	2106	renamed_GCF_000008685.2	chromosome	469387	467281	2106	99.7	0.0
GCF_040790795.1_ASM4079079v1_genomic	NZ_CP161158.1	466131	465855	276	renamed_GCF_000008685.2	chromosome	469665	469389	276	97.8	9.032e-54
GCF_040790795.1_ASM4079079v1_genomic	NZ_CP161158.1	466437	466143	294	renamed_GCF_000008685.2	chromosome	469971	469677	294	100.0	2.2e-63
GCF_040790795.1_ASM4079079v1_genomic	NZ_CP161158.1	478534	477820	714	renamed_GCF_000008685.2	chromosome	482057	481343	714	100.0	3.944e-160
GCF_040790795.1_ASM4079079v1_genomic	NZ_CP161158.1	479076	480759	1683	renamed_GCF_000008685.2	chromosome	482599	484282	1683	99.6	0.0
GCF_040790795.1_ASM4079079v1_genomic	NZ_CP161158.1	480763	481063	300	renamed_GCF_000008685.2	chromosome	484286	484586	300	98.9	2.966e-61
GCF_040790795.1_ASM4079079v1_genomic	NZ_CP161158.1	567737	568307	570	renamed_GCF_000008685.2	chromosome	571282	571852	570	100.0	1.471e-121
GCF_040790795.1_ASM4079079v1_genomic	NZ_CP161158.1	570195	568344	1851	renamed_GCF_000008685.2	chromosome	573740	571889	1851	100.0	0.0
GCF_040790795.1_ASM4079079v1_genomic	NZ_CP161158.1	570307	571702	1395	renamed_GCF_000008685.2	chromosome	573852	575247	1395	99.3	1.406e-312
GCF_040790795.1_ASM4079079v1_genomic	NZ_CP161158.1	572271	571728	543	renamed_GCF_000008685.2	chromosome	575816	575273	543	100.0	3.121e-117
GCF_040790795.1_ASM4079079v1_genomic	NZ_CP161158.1	572981	572435	546	renamed_GCF_000008685.2	chromosome	576499	575980	546	100.0	1.781e-115
GCF_040790795.1_ASM4079079v1_genomic	NZ_CP161158.1	573642	573036	606	renamed_GCF_000008685.2	chromosome	577187	576581	606	99.5	4.975e-131
GCF_040790795.1_ASM4079079v1_genomic	NZ_CP161158.1	573848	574391	543	renamed_GCF_000008685.2	chromosome	577394	577937	543	100.0	3.121e-117
GCF_040790795.1_ASM4079079v1_genomic	NZ_CP161158.1	586662	586137	525	renamed_GCF_000008685.2	chromosome	590208	589683	525	97.7	3.018e-106
GCF_040790795.1_ASM4079079v1_genomic	NZ_CP161158.1	586801	587389	588	renamed_GCF_000008685.2	chromosome	590347	590935	588	99.4	4.112e-130
GCF_040790795.1_ASM4079079v1_genomic	NZ_CP161158.1	587636	588806	1170	renamed_GCF_000008685.2	chromosome	591187	592357	1170	98.9	5.197e-251
GCF_040790795.1_ASM4079079v1_genomic	NZ_CP161158.1	588936	592380	3444	renamed_GCF_000008685.2	chromosome	592445	595931	3444	99.6	0.0
GCF_040790795.1_ASM4079079v1_genomic	NZ_CP161158.1	592391	592970	579	renamed_GCF_000008685.2	chromosome	595942	596521	579	99.4	1.865e-120
GCF_040790795.1_ASM4079079v1_genomic	NZ_CP161158.1	592979	595040	2061	renamed_GCF_000008685.2	chromosome	596530	598591	2061	100.0	0.0
GCF_040790795.1_ASM4079079v1_genomic	NZ_CP161158.1	595825	595036	789	renamed_GCF_000008685.2	chromosome	599376	598587	789	99.2	5.285e-178
GCF_040790795.1_ASM4079079v1_genomic	NZ_CP161158.1	595943	597293	1350	renamed_GCF_000008685.2	chromosome	599494	600844	1350	100.0	3.989e-293
GCF_040790795.1_ASM4079079v1_genomic	NZ_CP161158.1	597458	598793	1335	renamed_GCF_000008685.2	chromosome	601009	602344	1335	100.0	3.161e-293
GCF_040790795.1_ASM4079079v1_genomic	NZ_CP161158.1	598822	600178	1356	renamed_GCF_000008685.2	chromosome	602373	603729	1356	99.3	5.612e-299
GCF_040790795.1_ASM4079079v1_genomic	NZ_CP161158.1	615008	612860	2148	renamed_GCF_000008685.2	chromosome	618559	616411	2148	99.8	0.0
GCF_040790795.1_ASM4079079v1_genomic	NZ_CP161158.1	615276	617484	2208	renamed_GCF_000008685.2	chromosome	618827	621035	2208	99.8	0.0
GCF_040790795.1_ASM4079079v1_genomic	NZ_CP161158.1	618402	617493	909	renamed_GCF_000008685.2	chromosome	621953	621044	909	99.0	1.832e-201
GCF_040790795.1_ASM4079079v1_genomic	NZ_CP161158.1	639574	638947	627	renamed_GCF_000008685.2	chromosome	643126	642499	627	100.0	8.735e-137
GCF_040790795.1_ASM4079079v1_genomic	NZ_CP161158.1	641219	641588	369	renamed_GCF_000008685.2	chromosome	644771	645140	369	100.0	1.529e-79
GCF_040790795.1_ASM4079079v1_genomic	NZ_CP161158.1	644774	643106	1668	renamed_GCF_000008685.2	chromosome	648254	646658	1668	99.4	0.0
GCF_040790795.1_ASM4079079v1_genomic	NZ_CP161158.1	646835	645617	1218	renamed_GCF_000008685.2	chromosome	650387	649169	1218	99.7	6.126e-266
GCF_040790795.1_ASM4079079v1_genomic	NZ_CP161158.1	650334	651297	963	renamed_GCF_000008685.2	chromosome	653886	654849	963	100.0	5.23e-216
GCF_040790795.1_ASM4079079v1_genomic	NZ_CP161158.1	651256	653350	2094	renamed_GCF_000008685.2	chromosome	654862	656902	2094	99.1	0.0
GCF_040790795.1_ASM4079079v1_genomic	NZ_CP161158.1	106	646	540	renamed_GCF_000008685.2	chromosome	104	677	540	96.0	2.975e-117
GCF_040790795.1_ASM4079079v1_genomic	NZ_CP161158.1	6301	5245	1056	renamed_GCF_000008685.2	chromosome	6306	5250	1056	99.4	3.853e-235
GCF_040790795.1_ASM4079079v1_genomic	NZ_CP161158.1	8310	7452	858	renamed_GCF_000008685.2	chromosome	8315	7457	858	100.0	6.472e-196
GCF_040790795.1_ASM4079079v1_genomic	NZ_CP161158.1	9196	10201	1005	renamed_GCF_000008685.2	chromosome	9201	10206	1005	99.4	1.861e-217
GCF_040790795.1_ASM4079079v1_genomic	NZ_CP161158.1	10575	11415	840	renamed_GCF_000008685.2	chromosome	10580	11420	840	100.0	7.775e-191
GCF_040790795.1_ASM4079079v1_genomic	NZ_CP161158.1	12148	12748	600	renamed_GCF_000008685.2	chromosome	12153	12753	600	98.9	1.006e-130
GCF_040790795.1_ASM4079079v1_genomic	NZ_CP161158.1	15340	14719	621	renamed_GCF_000008685.2	chromosome	15345	14724	621	100.0	3.249e-138
GCF_040790795.1_ASM4079079v1_genomic	NZ_CP161158.1	15839	16799	960	renamed_GCF_000008685.2	chromosome	15994	16804	960	98.5	5.872e-171
GCF_040790795.1_ASM4079079v1_genomic	NZ_CP161158.1	42326	41285	1041	renamed_GCF_000008685.2	chromosome	42483	41442	1041	99.4	2.178e-230
GCF_040790795.1_ASM4079079v1_genomic	NZ_CP161158.1	45197	42749	2448	renamed_GCF_000008685.2	chromosome	45354	42906	2448	99.7	0.0
GCF_040790795.1_ASM4079079v1_genomic	NZ_CP161158.1	46222	45853	369	renamed_GCF_000008685.2	chromosome	46379	46010	369	100.0	3.085e-80
GCF_040790795.1_ASM4079079v1_genomic	NZ_CP161158.1	47975	48449	474	renamed_GCF_000008685.2	chromosome	47916	48606	474	98.7	5.848e-99
GCF_040790795.1_ASM4079079v1_genomic	NZ_CP161158.1	49183	49855	672	renamed_GCF_000008685.2	chromosome	49340	50012	672	100.0	9.591e-152
GCF_040790795.1_ASM4079079v1_genomic	NZ_CP161158.1	51093	50331	762	renamed_GCF_000008685.2	chromosome	51251	50489	762	99.2	1.282e-163
GCF_040790795.1_ASM4079079v1_genomic	NZ_CP161158.1	53303	52295	1008	renamed_GCF_000008685.2	chromosome	53461	52453	1008	99.7	1.478e-220
GCF_040790795.1_ASM4079079v1_genomic	NZ_CP161158.1	56122	55342	780	renamed_GCF_000008685.2	chromosome	56280	55500	780	99.6	1.628e-172
GCF_040790795.1_ASM4079079v1_genomic	NZ_CP161158.1	57027	56673	354	renamed_GCF_000008685.2	chromosome	57185	56831	354	99.1	6.554e-78
GCF_040790795.1_ASM4079079v1_genomic	NZ_CP161158.1	58878	57870	1008	renamed_GCF_000008685.2	chromosome	58982	58028	1008	99.0	1.313e-204
GCF_040790795.1_ASM4079079v1_genomic	NZ_CP161158.1	89651	89042	609	renamed_GCF_000008685.2	chromosome	89808	89199	609	100.0	1.275e-129
GCF_040790795.1_ASM4079079v1_genomic	NZ_CP161158.1	93267	92721	546	renamed_GCF_000008685.2	chromosome	93423	92877	546	97.2	3.601e-116
GCF_040790795.1_ASM4079079v1_genomic	NZ_CP161158.1	94449	94062	387	renamed_GCF_000008685.2	chromosome	94605	94218	387	100.0	1.031e-86
GCF_040790795.1_ASM4079079v1_genomic	NZ_CP161158.1	97710	96786	924	renamed_GCF_000008685.2	chromosome	97866	96942	924	99.3	8.657e-204
GCF_040790795.1_ASM4079079v1_genomic	NZ_CP161158.1	98624	97706	918	renamed_GCF_000008685.2	chromosome	98648	97862	918	99.2	2.343e-174
GCF_040790795.1_ASM4079079v1_genomic	NZ_CP161158.1	100070	100592	522	renamed_GCF_000008685.2	chromosome	100227	100749	522	100.0	2.976e-114
GCF_040790795.1_ASM4079079v1_genomic	NZ_CP161158.1	102792	101367	1425	renamed_GCF_000008685.2	chromosome	102949	101524	1425	100.0	1.009e-312
GCF_040790795.1_ASM4079079v1_genomic	NZ_CP161158.1	105274	103606	1668	renamed_GCF_000008685.2	chromosome	105299	103763	1668	99.8	0.0
GCF_040790795.1_ASM4079079v1_genomic	NZ_CP161158.1	106737	105726	1011	renamed_GCF_000008685.2	chromosome	106894	105883	1011	100.0	4.14e-218
GCF_040790795.1_ASM4079079v1_genomic	NZ_CP161158.1	108013	106816	1197	renamed_GCF_000008685.2	chromosome	108170	106973	1197	99.7	1.869e-258
GCF_040790795.1_ASM4079079v1_genomic	NZ_CP161158.1	189913	190567	654	renamed_GCF_000008685.2	chromosome	190186	190717	654	99.4	1.404e-110
GCF_040790795.1_ASM4079079v1_genomic	NZ_CP161158.1	192177	191367	810	renamed_GCF_000008685.2	chromosome	192327	191517	810	99.6	1.125e-181
GCF_040790795.1_ASM4079079v1_genomic	NZ_CP161158.1	195542	197546	2004	renamed_GCF_000008685.2	chromosome	195692	197696	2004	99.7	0.0
GCF_040790795.1_ASM4079079v1_genomic	NZ_CP161158.1	216968	218000	1032	renamed_GCF_000008685.2	chromosome	217277	218312	1032	99.1	2.355e-219
GCF_040790795.1_ASM4079079v1_genomic	NZ_CP161158.1	219322	218743	579	renamed_GCF_000008685.2	chromosome	219634	219055	579	100.0	8.388e-121
GCF_040790795.1_ASM4079079v1_genomic	NZ_CP161158.1	220416	221325	909	renamed_GCF_000008685.2	chromosome	220728	221637	909	99.3	4.638e-191
GCF_040790795.1_ASM4079079v1_genomic	NZ_CP161158.1	222866	223649	783	renamed_GCF_000008685.2	chromosome	223178	223961	783	99.2	8.433e-172
GCF_040790795.1_ASM4079079v1_genomic	NZ_CP161158.1	245067	244464	603	renamed_GCF_000008685.2	chromosome	245382	244776	603	99.5	7.936e-134
GCF_040790795.1_ASM4079079v1_genomic	NZ_CP161158.1	246283	247789	1506	renamed_GCF_000008685.2	chromosome	246596	248102	1506	100.0	0.0
GCF_040790795.1_ASM4079079v1_genomic	NZ_CP161158.1	250357	249862	495	renamed_GCF_000008685.2	chromosome	250670	250175	495	100.0	5.051e-104
GCF_040790795.1_ASM4079079v1_genomic	NZ_CP161158.1	252120	252726	606	renamed_GCF_000008685.2	chromosome	252433	253039	606	100.0	4.115e-133
GCF_040790795.1_ASM4079079v1_genomic	NZ_CP161158.1	254631	255336	705	renamed_GCF_000008685.2	chromosome	254944	255649	705	100.0	7.263e-152
GCF_040790795.1_ASM4079079v1_genomic	NZ_CP161158.1	273549	274932	1383	renamed_GCF_000008685.2	chromosome	273856	275236	1383	99.5	1.314e-302
GCF_040790795.1_ASM4079079v1_genomic	NZ_CP161158.1	276253	276760	507	renamed_GCF_000008685.2	chromosome	276671	277064	507	100.0	6.298e-87
GCF_040790795.1_ASM4079079v1_genomic	NZ_CP161158.1	279076	278773	303	renamed_GCF_000008685.2	chromosome	279380	279077	303	96.0	6.277e-62
GCF_040790795.1_ASM4079079v1_genomic	NZ_CP161158.1	282383	281495	888	renamed_GCF_000008685.2	chromosome	282687	281799	888	99.6	8.945e-189
GCF_040790795.1_ASM4079079v1_genomic	NZ_CP161158.1	283561	282394	1167	renamed_GCF_000008685.2	chromosome	283865	282698	1167	100.0	1.172e-258
GCF_040790795.1_ASM4079079v1_genomic	NZ_CP161158.1	286785	285666	1119	renamed_GCF_000008685.2	chromosome	287089	285970	1119	100.0	9.957e-244
GCF_040790795.1_ASM4079079v1_genomic	NZ_CP161158.1	287869	287605	264	renamed_GCF_000008685.2	chromosome	288173	287909	264	100.0	2.025e-51
GCF_040790795.1_ASM4079079v1_genomic	NZ_CP161158.1	289279	288652	627	renamed_GCF_000008685.2	chromosome	289583	288956	627	99.5	3.117e-131
GCF_040790795.1_ASM4079079v1_genomic	NZ_CP161158.1	290717	289658	1059	renamed_GCF_000008685.2	chromosome	291021	289962	1059	100.0	3.164e-229
GCF_040790795.1_ASM4079079v1_genomic	NZ_CP161158.1	300459	299424	1035	renamed_GCF_000008685.2	chromosome	300764	299729	1035	100.0	3.255e-216
GCF_040790795.1_ASM4079079v1_genomic	NZ_CP161158.1	302534	302198	336	renamed_GCF_000008685.2	chromosome	302839	302503	336	98.1	1.315e-67
GCF_040790795.1_ASM4079079v1_genomic	NZ_CP161158.1	303004	302545	459	renamed_GCF_000008685.2	chromosome	303309	302850	459	100.0	4.601e-99
GCF_040790795.1_ASM4079079v1_genomic	NZ_CP161158.1	304815	303468	1347	renamed_GCF_000008685.2	chromosome	305120	303773	1347	100.0	1.016e-290
GCF_040790795.1_ASM4079079v1_genomic	NZ_CP161158.1	305356	304807	549	renamed_GCF_000008685.2	chromosome	305661	305112	549	100.0	9.24e-115
GCF_040790795.1_ASM4079079v1_genomic	NZ_CP161158.1	307012	306319	693	renamed_GCF_000008685.2	chromosome	307317	306624	693	100.0	2.971e-151
GCF_040790795.1_ASM4079079v1_genomic	NZ_CP161158.1	308212	307012	1200	renamed_GCF_000008685.2	chromosome	308517	307317	1200	100.0	3.302e-261
GCF_040790795.1_ASM4079079v1_genomic	NZ_CP161158.1	368151	368577	426	renamed_GCF_000008685.2	chromosome	368455	368881	426	98.5	9.562e-86
GCF_040790795.1_ASM4079079v1_genomic	NZ_CP161158.1	368580	369723	1143	renamed_GCF_000008685.2	chromosome	368884	370027	1143	99.4	7.822e-242
GCF_040790795.1_ASM4079079v1_genomic	NZ_CP161158.1	369722	370709	987	renamed_GCF_000008685.2	chromosome	370026	371013	987	99.6	8.057e-224
GCF_040790795.1_ASM4079079v1_genomic	NZ_CP161158.1	370729	372742	2013	renamed_GCF_000008685.2	chromosome	371033	373046	2013	99.7	0.0
GCF_040790795.1_ASM4079079v1_genomic	NZ_CP161158.1	372835	373216	381	renamed_GCF_000008685.2	chromosome	373139	373520	381	100.0	1.683e-80
GCF_040790795.1_ASM4079079v1_genomic	NZ_CP161158.1	385144	385858	714	renamed_GCF_000008685.2	chromosome	385448	386162	714	100.0	3.427e-153
GCF_040790795.1_ASM4079079v1_genomic	NZ_CP161158.1	385854	387033	1179	renamed_GCF_000008685.2	chromosome	386158	387337	1179	99.7	9.776e-263
GCF_040790795.1_ASM4079079v1_genomic	NZ_CP161158.1	387029	387503	474	renamed_GCF_000008685.2	chromosome	387333	387807	474	100.0	1.339e-106
GCF_040790795.1_ASM4079079v1_genomic	NZ_CP161158.1	388176	387513	663	renamed_GCF_000008685.2	chromosome	388480	387817	663	99.5	1.104e-148
GCF_040790795.1_ASM4079079v1_genomic	NZ_CP161158.1	388622	388202	420	renamed_GCF_000008685.2	chromosome	388926	388506	420	100.0	9.787e-93
GCF_040790795.1_ASM4079079v1_genomic	NZ_CP161158.1	412708	411163	1545	renamed_GCF_000008685.2	chromosome	413006	411455	1545	99.2	0.0
GCF_040790795.1_ASM4079079v1_genomic	NZ_CP161158.1	412820	414023	1203	renamed_GCF_000008685.2	chromosome	413112	414315	1203	99.2	7.009e-262
GCF_040790795.1_ASM4079079v1_genomic	NZ_CP161158.1	415501	414034	1467	renamed_GCF_000008685.2	chromosome	415793	414326	1467	99.5	0.0
GCF_040790795.1_ASM4079079v1_genomic	NZ_CP161158.1	416231	415553	678	renamed_GCF_000008685.2	chromosome	416478	415845	678	99.5	1.008e-143
GCF_040790795.1_ASM4079079v1_genomic	NZ_CP161158.1	416396	416813	417	renamed_GCF_000008685.2	chromosome	416688	417105	417	99.2	1.376e-88
GCF_040790795.1_ASM4079079v1_genomic	NZ_CP161158.1	416809	417421	612	renamed_GCF_000008685.2	chromosome	417101	417713	612	100.0	4.975e-132
GCF_040790795.1_ASM4079079v1_genomic	NZ_CP161158.1	417431	418043	612	renamed_GCF_000008685.2	chromosome	417723	418335	612	98.5	3.744e-135
GCF_040790795.1_ASM4079079v1_genomic	NZ_CP161158.1	419214	418095	1119	renamed_GCF_000008685.2	chromosome	419506	418387	1119	99.4	1.781e-254
GCF_040790795.1_ASM4079079v1_genomic	NZ_CP161158.1	421088	419210	1878	renamed_GCF_000008685.2	chromosome	421380	419502	1878	99.5	0.0
GCF_040790795.1_ASM4079079v1_genomic	NZ_CP161158.1	421261	421891	630	renamed_GCF_000008685.2	chromosome	421553	422183	630	98.5	1.533e-139
GCF_040790795.1_ASM4079079v1_genomic	NZ_CP161158.1	450939	448506	2433	renamed_GCF_000008685.2	chromosome	454472	452039	2433	100.0	0.0
GCF_040790795.1_ASM4079079v1_genomic	NZ_CP161158.1	452855	450950	1905	renamed_GCF_000008685.2	chromosome	456388	454483	1905	99.8	0.0
GCF_040790795.1_ASM4079079v1_genomic	NZ_CP161158.1	453042	454503	1461	renamed_GCF_000008685.2	chromosome	456575	458036	1461	99.5	0.0
GCF_040790795.1_ASM4079079v1_genomic	NZ_CP161158.1	454743	455901	1158	renamed_GCF_000008685.2	chromosome	458276	459434	1158	99.7	1.225e-256
GCF_040790795.1_ASM4079079v1_genomic	NZ_CP161158.1	455991	456291	300	renamed_GCF_000008685.2	chromosome	459524	459824	300	95.9	4.432e-57
GCF_040790795.1_ASM4079079v1_genomic	NZ_CP161158.1	467686	466426	1260	renamed_GCF_000008685.2	chromosome	471220	469960	1260	100.0	2.539e-274
GCF_040790795.1_ASM4079079v1_genomic	NZ_CP161158.1	468222	467688	534	renamed_GCF_000008685.2	chromosome	471756	471222	534	100.0	8.816e-113
GCF_040790795.1_ASM4079079v1_genomic	NZ_CP161158.1	468941	468236	705	renamed_GCF_000008685.2	chromosome	472358	471770	705	99.4	1.099e-121
GCF_040790795.1_ASM4079079v1_genomic	NZ_CP161158.1	469031	469874	843	renamed_GCF_000008685.2	chromosome	472565	473408	843	100.0	5.328e-187
GCF_040790795.1_ASM4079079v1_genomic	NZ_CP161158.1	471022	469870	1152	renamed_GCF_000008685.2	chromosome	474556	473404	1152	100.0	7.714e-261
GCF_040790795.1_ASM4079079v1_genomic	NZ_CP161158.1	491509	492694	1185	renamed_GCF_000008685.2	chromosome	495032	496217	1185	100.0	4.832e-263
GCF_040790795.1_ASM4079079v1_genomic	NZ_CP161158.1	492744	493056	312	renamed_GCF_000008685.2	chromosome	496267	496579	312	100.0	2.953e-63
GCF_040790795.1_ASM4079079v1_genomic	NZ_CP161158.1	493091	493712	621	renamed_GCF_000008685.2	chromosome	496614	497235	621	100.0	8.732e-136
GCF_040790795.1_ASM4079079v1_genomic	NZ_CP161158.1	493721	494351	630	renamed_GCF_000008685.2	chromosome	497244	497874	630	100.0	4.528e-136
GCF_040790795.1_ASM4079079v1_genomic	NZ_CP161158.1	494371	494668	297	renamed_GCF_000008685.2	chromosome	497894	498191	297	100.0	5.69e-62
GCF_040790795.1_ASM4079079v1_genomic	NZ_CP161158.1	499208	499418	210	renamed_GCF_000008685.2	chromosome	502755	502941	210	100.0	1.151e-40
GCF_040790795.1_ASM4079079v1_genomic	NZ_CP161158.1	499427	499826	399	renamed_GCF_000008685.2	chromosome	502950	503349	399	100.0	3.071e-85
GCF_040790795.1_ASM4079079v1_genomic	NZ_CP161158.1	499842	500385	543	renamed_GCF_000008685.2	chromosome	503365	503908	543	100.0	7.636e-116
GCF_040790795.1_ASM4079079v1_genomic	NZ_CP161158.1	500402	500762	360	renamed_GCF_000008685.2	chromosome	503925	504285	360	99.1	4.361e-75
GCF_040790795.1_ASM4079079v1_genomic	NZ_CP161158.1	500774	501272	498	renamed_GCF_000008685.2	chromosome	504297	504795	498	99.3	1.965e-106
GCF_040790795.1_ASM4079079v1_genomic	NZ_CP161158.1	525667	524572	1095	renamed_GCF_000008685.2	chromosome	529198	528103	1095	99.7	8.741e-250
GCF_040790795.1_ASM4079079v1_genomic	NZ_CP161158.1	527574	525666	1908	renamed_GCF_000008685.2	chromosome	531105	529197	1908	100.0	0.0
GCF_040790795.1_ASM4079079v1_genomic	NZ_CP161158.1	528161	527597	564	renamed_GCF_000008685.2	chromosome	531692	531128	564	100.0	2.704e-122
GCF_040790795.1_ASM4079079v1_genomic	NZ_CP161158.1	530770	531625	855	renamed_GCF_000008685.2	chromosome	534300	535155	855	99.6	9.843e-191
GCF_040790795.1_ASM4079079v1_genomic	NZ_CP161158.1	532070	531647	423	renamed_GCF_000008685.2	chromosome	535600	535177	423	100.0	5.606e-91
GCF_040790795.1_ASM4079079v1_genomic	NZ_CP161158.1	532173	533997	1824	renamed_GCF_000008685.2	chromosome	535703	537527	1824	99.5	0.0
GCF_040790795.1_ASM4079079v1_genomic	NZ_CP161158.1	533989	534778	789	renamed_GCF_000008685.2	chromosome	537543	538308	789	98.8	3.287e-166
GCF_040790795.1_ASM4079079v1_genomic	NZ_CP161158.1	535745	534797	948	renamed_GCF_000008685.2	chromosome	539275	538327	948	99.3	2.459e-213
GCF_040790795.1_ASM4079079v1_genomic	NZ_CP161158.1	558398	558017	381	renamed_GCF_000008685.2	chromosome	561943	561562	381	99.2	5.027e-77
GCF_040790795.1_ASM4079079v1_genomic	NZ_CP161158.1	558639	560622	1983	renamed_GCF_000008685.2	chromosome	562184	564167	1983	99.6	0.0
GCF_040790795.1_ASM4079079v1_genomic	NZ_CP161158.1	562425	564279	1854	renamed_GCF_000008685.2	chromosome	565954	567823	1854	99.6	0.0
GCF_040790795.1_ASM4079079v1_genomic	NZ_CP161158.1	564265	564733	468	renamed_GCF_000008685.2	chromosome	567809	568277	468	100.0	1.969e-101
GCF_040790795.1_ASM4079079v1_genomic	NZ_CP161158.1	574403	574715	312	renamed_GCF_000008685.2	chromosome	577949	578261	312	100.0	5.387e-65
GCF_040790795.1_ASM4079079v1_genomic	NZ_CP161158.1	574730	576875	2145	renamed_GCF_000008685.2	chromosome	578276	580421	2145	99.7	0.0
GCF_040790795.1_ASM4079079v1_genomic	NZ_CP161158.1	576939	578097	1158	renamed_GCF_000008685.2	chromosome	580485	581643	1158	100.0	7.971e-253
GCF_040790795.1_ASM4079079v1_genomic	NZ_CP161158.1	578098	579871	1773	renamed_GCF_000008685.2	chromosome	581644	583417	1773	99.3	0.0
GCF_040790795.1_ASM4079079v1_genomic	NZ_CP161158.1	579911	580286	375	renamed_GCF_000008685.2	chromosome	583457	583832	375	99.1	1.859e-78
GCF_040790795.1_ASM4079079v1_genomic	NZ_CP161158.1	607642	606391	1251	renamed_GCF_000008685.2	chromosome	611193	609942	1251	98.3	2.071e-266
GCF_040790795.1_ASM4079079v1_genomic	NZ_CP161158.1	607757	608471	714	renamed_GCF_000008685.2	chromosome	611308	612022	714	99.5	9.633e-159
GCF_040790795.1_ASM4079079v1_genomic	NZ_CP161158.1	608496	610434	1938	renamed_GCF_000008685.2	chromosome	612047	613985	1938	99.8	0.0
GCF_040790795.1_ASM4079079v1_genomic	NZ_CP161158.1	612220	610462	1758	renamed_GCF_000008685.2	chromosome	615771	614013	1758	98.9	0.0
GCF_040790795.1_ASM4079079v1_genomic	NZ_CP161158.1	612839	612212	627	renamed_GCF_000008685.2	chromosome	616390	615763	627	99.0	1.402e-131
GCF_040790795.1_ASM4079079v1_genomic	NZ_CP161158.1	655345	656071	726	renamed_GCF_000008685.2	chromosome	658897	659623	726	100.0	3.429e-155
GCF_040790795.1_ASM4079079v1_genomic	NZ_CP161158.1	657963	656091	1872	renamed_GCF_000008685.2	chromosome	661515	659643	1872	99.1	0.0
GCF_040790795.1_ASM4079079v1_genomic	NZ_CP161158.1	658053	658977	924	renamed_GCF_000008685.2	chromosome	661605	662529	924	99.6	1.144e-200
GCF_040790795.1_ASM4079079v1_genomic	NZ_CP161158.1	659365	659050	315	renamed_GCF_000008685.2	chromosome	662917	662602	315	99.0	2.806e-64
GCF_040790795.1_ASM4079079v1_genomic	NZ_CP161158.1	661459	659626	1833	renamed_GCF_000008685.2	chromosome	665011	663178	1833	100.0	0.0
GCF_040790795.1_ASM4079079v1_genomic	NZ_CP161158.1	678967	678127	840	renamed_GCF_000008685.2	chromosome	682524	681684	840	99.6	3.646e-182
GCF_040790795.1_ASM4079079v1_genomic	NZ_CP161158.1	679121	679820	699	renamed_GCF_000008685.2	chromosome	682678	683377	699	100.0	1.337e-152
GCF_040790795.1_ASM4079079v1_genomic	NZ_CP161158.1	679865	681410	1545	renamed_GCF_000008685.2	chromosome	683422	684967	1545	99.8	0.0
GCF_040790795.1_ASM4079079v1_genomic	NZ_CP161158.1	682424	681440	984	renamed_GCF_000008685.2	chromosome	685980	684996	984	99.3	1.874e-222
GCF_040790795.1_ASM4079079v1_genomic	NZ_CP161158.1	682951	682420	531	renamed_GCF_000008685.2	chromosome	686507	685976	531	100.0	1.053e-118
GCF_040790795.1_ASM4079079v1_genomic	NZ_CP161158.1	684933	686571	1638	renamed_GCF_000008685.2	chromosome	688489	690127	1638	100.0	0.0
GCF_040790795.1_ASM4079079v1_genomic	NZ_CP161158.1	686636	686933	297	renamed_GCF_000008685.2	chromosome	690192	690489	297	100.0	1.037e-63
GCF_040790795.1_ASM4079079v1_genomic	NZ_CP161158.1	686946	687243	297	renamed_GCF_000008685.2	chromosome	690481	690799	297	98.9	6.955e-60
GCF_040790795.1_ASM4079079v1_genomic	NZ_CP161158.1	687328	689089	1761	renamed_GCF_000008685.2	chromosome	690884	692645	1761	99.4	0.0
GCF_040790795.1_ASM4079079v1_genomic	NZ_CP161158.1	698259	698709	450	renamed_GCF_000008685.2	chromosome	701824	702274	450	99.3	2.172e-97
GCF_040790795.1_ASM4079079v1_genomic	NZ_CP161158.1	699401	698717	684	renamed_GCF_000008685.2	chromosome	702951	702282	684	99.5	1.009e-144
GCF_040790795.1_ASM4079079v1_genomic	NZ_CP161158.1	699443	700403	960	renamed_GCF_000008685.2	chromosome	703008	703968	960	100.0	6.008e-214
GCF_040790795.1_ASM4079079v1_genomic	NZ_CP161158.1	700365	701394	1029	renamed_GCF_000008685.2	chromosome	703960	704959	1029	98.7	4.152e-221
GCF_040790795.1_ASM4079079v1_genomic	NZ_CP161158.1	701383	701935	552	renamed_GCF_000008685.2	chromosome	704948	705500	552	96.1	1.619e-117
GCF_040790795.1_ASM4079079v1_genomic	NZ_CP161158.1	702012	703038	1026	renamed_GCF_000008685.2	chromosome	705579	706605	1026	100.0	2.737e-225
GCF_040790795.1_ASM4079079v1_genomic	NZ_CP161158.1	703105	705700	2595	renamed_GCF_000008685.2	chromosome	706672	709267	2595	99.4	0.0
GCF_040790795.1_ASM4079079v1_genomic	NZ_CP161158.1	705706	707107	1401	renamed_GCF_000008685.2	chromosome	709273	710674	1401	98.2	2.931e-305
GCF_040790795.1_ASM4079079v1_genomic	NZ_CP161158.1	707118	707604	486	renamed_GCF_000008685.2	chromosome	710685	711171	486	100.0	5.304e-102
GCF_040790795.1_ASM4079079v1_genomic	NZ_CP161158.1	707643	708084	441	renamed_GCF_000008685.2	chromosome	711210	711651	441	100.0	1.245e-93
GCF_040790795.1_ASM4079079v1_genomic	NZ_CP161158.1	720653	721877	1224	renamed_GCF_000008685.2	chromosome	724223	725447	1224	99.5	3.533e-273
GCF_040790795.1_ASM4079079v1_genomic	NZ_CP161158.1	721860	722925	1065	renamed_GCF_000008685.2	chromosome	725430	726495	1065	98.8	9.851e-235
GCF_040790795.1_ASM4079079v1_genomic	NZ_CP161158.1	722914	724183	1269	renamed_GCF_000008685.2	chromosome	726457	727753	1269	97.1	1.579e-272
GCF_040790795.1_ASM4079079v1_genomic	NZ_CP161158.1	724166	725105	939	renamed_GCF_000008685.2	chromosome	727736	728675	939	100.0	1.678e-207
GCF_040790795.1_ASM4079079v1_genomic	NZ_CP161158.1	725095	726049	954	renamed_GCF_000008685.2	chromosome	728665	729619	954	98.7	7.929e-210
GCF_040790795.1_ASM4079079v1_genomic	NZ_CP161158.1	726042	726936	894	renamed_GCF_000008685.2	chromosome	729612	730506	894	98.9	3.048e-193
GCF_040790795.1_ASM4079079v1_genomic	NZ_CP161158.1	727529	727061	468	renamed_GCF_000008685.2	chromosome	731099	730631	468	98.0	1.073e-99
GCF_040790795.1_ASM4079079v1_genomic	NZ_CP161158.1	727613	728150	537	renamed_GCF_000008685.2	chromosome	731183	731720	537	100.0	1.936e-121
GCF_040790795.1_ASM4079079v1_genomic	NZ_CP161158.1	728223	730233	2010	renamed_GCF_000008685.2	chromosome	731793	733803	2010	99.8	0.0
GCF_040790795.1_ASM4079079v1_genomic	NZ_CP161158.1	730509	731718	1209	renamed_GCF_000008685.2	chromosome	734080	735289	1209	100.0	8.188e-270
GCF_040790795.1_ASM4079079v1_genomic	NZ_CP161158.1	737116	737854	738	renamed_GCF_000008685.2	chromosome	740687	741425	738	100.0	4.772e-162
GCF_040790795.1_ASM4079079v1_genomic	NZ_CP161158.1	739057	737824	1233	renamed_GCF_000008685.2	chromosome	742628	741395	1233	99.2	4.064e-273
GCF_040790795.1_ASM4079079v1_genomic	NZ_CP161158.1	739172	740945	1773	renamed_GCF_000008685.2	chromosome	742743	744516	1773	99.3	0.0
GCF_040790795.1_ASM4079079v1_genomic	NZ_CP161158.1	740950	741274	324	renamed_GCF_000008685.2	chromosome	744521	744845	324	100.0	1.32e-65
GCF_040790795.1_ASM4079079v1_genomic	NZ_CP161158.1	741730	742762	1032	renamed_GCF_000008685.2	chromosome	745301	746333	1032	98.8	6.089e-226
GCF_040790795.1_ASM4079079v1_genomic	NZ_CP161158.1	744552	746448	1896	renamed_GCF_000008685.2	chromosome	748122	750018	1896	100.0	0.0
GCF_040790795.1_ASM4079079v1_genomic	NZ_CP161158.1	746460	747219	759	renamed_GCF_000008685.2	chromosome	750030	750789	759	100.0	2.255e-165
GCF_040790795.1_ASM4079079v1_genomic	NZ_CP161158.1	747620	748589	969	renamed_GCF_000008685.2	chromosome	751190	752159	969	100.0	4.772e-218
GCF_040790795.1_ASM4079079v1_genomic	NZ_CP161158.1	748599	749649	1050	renamed_GCF_000008685.2	chromosome	752169	753219	1050	100.0	6.109e-229
GCF_040790795.1_ASM4079079v1_genomic	NZ_CP161158.1	760800	761772	972	renamed_GCF_000008685.2	chromosome	764370	765342	972	99.3	7.249e-214
GCF_040790795.1_ASM4079079v1_genomic	NZ_CP161158.1	761802	763146	1344	renamed_GCF_000008685.2	chromosome	765372	766716	1344	100.0	2.685e-305
GCF_040790795.1_ASM4079079v1_genomic	NZ_CP161158.1	764494	763162	1332	renamed_GCF_000008685.2	chromosome	768064	766732	1332	98.6	1.788e-290
GCF_040790795.1_ASM4079079v1_genomic	NZ_CP161158.1	765900	764508	1392	renamed_GCF_000008685.2	chromosome	769470	768078	1392	100.0	1.696e-292
GCF_040790795.1_ASM4079079v1_genomic	NZ_CP161158.1	767568	765975	1593	renamed_GCF_000008685.2	chromosome	771139	769546	1593	99.0	0.0
GCF_040790795.1_ASM4079079v1_genomic	NZ_CP161158.1	767992	767590	402	renamed_GCF_000008685.2	chromosome	771563	771161	402	100.0	3.917e-83
GCF_040790795.1_ASM4079079v1_genomic	NZ_CP161158.1	770797	767998	2799	renamed_GCF_000008685.2	chromosome	774368	771569	2799	99.6	0.0
GCF_040790795.1_ASM4079079v1_genomic	NZ_CP161158.1	771105	771891	786	renamed_GCF_000008685.2	chromosome	774676	775462	786	100.0	1.17e-168
GCF_040790795.1_ASM4079079v1_genomic	NZ_CP161158.1	773052	772038	1014	renamed_GCF_000008685.2	chromosome	776679	775665	1014	99.7	8.011e-220
GCF_040790795.1_ASM4079079v1_genomic	NZ_CP161158.1	773157	773946	789	renamed_GCF_000008685.2	chromosome	776784	777573	789	98.4	5.027e-170
GCF_040790795.1_ASM4079079v1_genomic	NZ_CP161158.1	788158	787177	981	renamed_GCF_000008685.2	chromosome	791787	790806	981	99.6	2.843e-217
GCF_040790795.1_ASM4079079v1_genomic	NZ_CP161158.1	788623	788164	459	renamed_GCF_000008685.2	chromosome	792252	791793	459	98.6	5.582e-97
GCF_040790795.1_ASM4079079v1_genomic	NZ_CP161158.1	788721	789996	1275	renamed_GCF_000008685.2	chromosome	792350	793625	1275	98.1	4.931e-278
GCF_040790795.1_ASM4079079v1_genomic	NZ_CP161158.1	791226	790212	1014	renamed_GCF_000008685.2	chromosome	794855	793841	1014	98.8	2.27e-225
GCF_040790795.1_ASM4079079v1_genomic	NZ_CP161158.1	794419	793489	930	renamed_GCF_000008685.2	chromosome	798048	797118	930	100.0	3.063e-199
GCF_040790795.1_ASM4079079v1_genomic	NZ_CP161158.1	795387	794427	960	renamed_GCF_000008685.2	chromosome	799016	798056	960	99.6	2.967e-213
GCF_040790795.1_ASM4079079v1_genomic	NZ_CP161158.1	796646	795578	1068	renamed_GCF_000008685.2	chromosome	800275	799207	1068	99.4	9.097e-245
GCF_040790795.1_ASM4079079v1_genomic	NZ_CP161158.1	796846	797443	597	renamed_GCF_000008685.2	chromosome	800475	801072	597	99.4	1.402e-126
GCF_040790795.1_ASM4079079v1_genomic	NZ_CP161158.1	807882	806841	1041	renamed_GCF_000008685.2	chromosome	811510	810469	1041	99.7	3.047e-235
GCF_040790795.1_ASM4079079v1_genomic	NZ_CP161158.1	808760	807878	882	renamed_GCF_000008685.2	chromosome	812388	811506	882	99.3	2.773e-192
GCF_040790795.1_ASM4079079v1_genomic	NZ_CP161158.1	809611	808810	801	renamed_GCF_000008685.2	chromosome	813239	812438	801	100.0	9.279e-174
GCF_040790795.1_ASM4079079v1_genomic	NZ_CP161158.1	810108	809763	345	renamed_GCF_000008685.2	chromosome	813706	813385	345	92.0	6.146e-61
GCF_040790795.1_ASM4079079v1_genomic	NZ_CP161158.1	811099	810091	1008	renamed_GCF_000008685.2	chromosome	814697	813689	1008	99.4	2.823e-213
GCF_040790795.1_ASM4079079v1_genomic	NZ_CP161158.1	811704	811269	435	renamed_GCF_000008685.2	chromosome	815302	814867	435	100.0	4.611e-95
GCF_040790795.1_ASM4079079v1_genomic	NZ_CP161158.1	812701	811903	798	renamed_GCF_000008685.2	chromosome	816299	815501	798	100.0	1.968e-173
GCF_040790795.1_ASM4079079v1_genomic	NZ_CP161158.1	813604	812713	891	renamed_GCF_000008685.2	chromosome	817160	816311	891	99.2	1.129e-186
GCF_040790795.1_ASM4079079v1_genomic	NZ_CP161158.1	813797	814358	561	renamed_GCF_000008685.2	chromosome	817395	817956	561	100.0	3.237e-128
GCF_040790795.1_ASM4079079v1_genomic	NZ_CP161158.1	814419	814950	531	renamed_GCF_000008685.2	chromosome	818017	818548	531	100.0	1.403e-115
GCF_040790795.1_ASM4079079v1_genomic	NZ_CP161158.1	820783	822106	1323	renamed_GCF_000008685.2	chromosome	824381	825704	1323	100.0	8.966e-297
GCF_040790795.1_ASM4079079v1_genomic	NZ_CP161158.1	822102	824022	1920	renamed_GCF_000008685.2	chromosome	825700	827620	1920	100.0	0.0
GCF_040790795.1_ASM4079079v1_genomic	NZ_CP161158.1	824032	825514	1482	renamed_GCF_000008685.2	chromosome	827630	829112	1482	98.9	0.0
GCF_040790795.1_ASM4079079v1_genomic	NZ_CP161158.1	825619	826723	1104	renamed_GCF_000008685.2	chromosome	829217	830321	1104	99.1	5.448e-248
GCF_040790795.1_ASM4079079v1_genomic	NZ_CP161158.1	827343	826719	624	renamed_GCF_000008685.2	chromosome	830941	830317	624	98.5	1.394e-139
GCF_040790795.1_ASM4079079v1_genomic	NZ_CP161158.1	827965	827356	609	renamed_GCF_000008685.2	chromosome	831563	830954	609	100.0	7.938e-135
GCF_040790795.1_ASM4079079v1_genomic	NZ_CP161158.1	832462	834928	2466	renamed_GCF_000008685.2	chromosome	836060	838526	2466	99.6	0.0
GCF_040790795.1_ASM4079079v1_genomic	NZ_CP161158.1	834948	835482	534	renamed_GCF_000008685.2	chromosome	838546	839080	534	100.0	7.282e-115
GCF_040790795.1_ASM4079079v1_genomic	NZ_CP161158.1	835645	838234	2589	renamed_GCF_000008685.2	chromosome	839243	841832	2589	99.5	0.0
GCF_040790795.1_ASM4079079v1_genomic	NZ_CP161158.1	850146	851214	1068	renamed_GCF_000008685.2	chromosome	853774	854842	1068	100.0	1.362e-231
GCF_040790795.1_ASM4079079v1_genomic	NZ_CP161158.1	851240	852368	1128	renamed_GCF_000008685.2	chromosome	854868	855996	1128	99.4	1.292e-259
GCF_040790795.1_ASM4079079v1_genomic	NZ_CP161158.1	852360	853881	1521	renamed_GCF_000008685.2	chromosome	855988	857509	1521	99.8	0.0
GCF_040790795.1_ASM4079079v1_genomic	NZ_CP161158.1	853877	855287	1410	renamed_GCF_000008685.2	chromosome	857505	858915	1410	99.3	7.483e-305
GCF_040790795.1_ASM4079079v1_genomic	NZ_CP161158.1	856483	855310	1173	renamed_GCF_000008685.2	chromosome	860111	858938	1173	99.2	1.547e-256
GCF_040790795.1_ASM4079079v1_genomic	NZ_CP161158.1	856812	858147	1335	renamed_GCF_000008685.2	chromosome	860439	861774	1335	99.3	1.013e-288
GCF_040790795.1_ASM4079079v1_genomic	NZ_CP161158.1	859072	860020	948	renamed_GCF_000008685.2	chromosome	862698	863646	948	100.0	4.292e-207
GCF_040790795.1_ASM4079079v1_genomic	NZ_CP161158.1	860009	861416	1407	renamed_GCF_000008685.2	chromosome	863635	865042	1407	99.5	3.133e-314
GCF_040790795.1_ASM4079079v1_genomic	NZ_CP161158.1	861435	862293	858	renamed_GCF_000008685.2	chromosome	865052	865919	858	99.6	3.329e-186
GCF_040790795.1_ASM4079079v1_genomic	NZ_CP161158.1	872802	875655	2853	renamed_GCF_000008685.2	chromosome	876491	879281	2853	99.3	0.0
GCF_040790795.1_ASM4079079v1_genomic	NZ_CP161158.1	875688	876624	936	renamed_GCF_000008685.2	chromosome	879314	880250	936	99.6	1.601e-207
GCF_040790795.1_ASM4079079v1_genomic	NZ_CP161158.1	877465	876640	825	renamed_GCF_000008685.2	chromosome	881091	880266	825	99.6	6.405e-182
GCF_040790795.1_ASM4079079v1_genomic	NZ_CP161158.1	880587	877458	3129	renamed_GCF_000008685.2	chromosome	884213	881084	3129	99.7	0.0
GCF_040790795.1_ASM4079079v1_genomic	NZ_CP161158.1	882821	880601	2220	renamed_GCF_000008685.2	chromosome	886447	884227	2220	98.5	0.0
GCF_040790795.1_ASM4079079v1_genomic	NZ_CP161158.1	884556	882843	1713	renamed_GCF_000008685.2	chromosome	888179	886469	1713	99.1	0.0
GCF_040790795.1_ASM4079079v1_genomic	NZ_CP161158.1	886698	889551	2853	renamed_GCF_000008685.2	chromosome	890321	893174	2853	99.5	0.0
GCF_040790795.1_ASM4079079v1_genomic	NZ_CP161158.1	889505	892946	3441	renamed_GCF_000008685.2	chromosome	893128	896569	3441	98.4	0.0
GCF_040790795.1_ASM4079079v1_genomic	NZ_CP161158.1	893501	892955	546	renamed_GCF_000008685.2	chromosome	897127	896578	546	97.7	8.009e-116
GCF_040790795.1_ASM4079079v1_genomic	NZ_CP161158.1	914508	914223	285	renamed_GCF_000008685.2	lp21	16548	16227	285	98.9	2.097e-62
GCF_040790795.1_ASM4079079v1_genomic	NZ_CP161158.1	914881	915874	993	renamed_GCF_000008685.2	lp5	3339	4332	993	100.0	1.858e-215
GCF_040790795.1_ASM4079079v1_genomic	NZ_CP161158.1	915929	916361	432	renamed_GCF_000008685.2	lp5	4387	4819	432	99.3	2.641e-92
GCF_040790795.1_ASM4079079v1_genomic	NZ_CP161167.1	45	324	279	renamed_GCF_000008685.2	cp26	45	324	279	98.9	5.175e-60
GCF_040790795.1_ASM4079079v1_genomic	NZ_CP161167.1	751	307	444	renamed_GCF_000008685.2	cp26	751	307	444	99.3	7.305e-100
GCF_040790795.1_ASM4079079v1_genomic	NZ_CP161167.1	2186	836	1350	renamed_GCF_000008685.2	cp26	2186	836	1350	98.8	9.453e-301
GCF_040790795.1_ASM4079079v1_genomic	NZ_CP161167.1	3796	2473	1323	renamed_GCF_000008685.2	cp26	3798	2475	1323	99.5	7.001e-291
GCF_040790795.1_ASM4079079v1_genomic	NZ_CP161167.1	4081	4429	348	renamed_GCF_000008685.2	cp26	4083	4431	348	99.1	5.329e-71
GCF_040790795.1_ASM4079079v1_genomic	NZ_CP161167.1	4437	4755	318	renamed_GCF_000008685.2	cp26	4481	4757	318	97.8	1.616e-54
GCF_040790795.1_ASM4079079v1_genomic	NZ_CP161167.1	4766	5864	1098	renamed_GCF_000008685.2	cp26	4768	5866	1098	100.0	2.035e-249
GCF_040790795.1_ASM4079079v1_genomic	NZ_CP161167.1	16901	17537	636	renamed_GCF_000008685.2	cp26	16902	17535	636	78.1	2.717e-100
GCF_040790795.1_ASM4079079v1_genomic	NZ_CP161167.1	19337	17981	1356	renamed_GCF_000008685.2	cp26	19321	17965	1356	99.5	4.378e-293
GCF_040790795.1_ASM4079079v1_genomic	NZ_CP161167.1	20802	19446	1356	renamed_GCF_000008685.2	cp26	20786	19430	1356	98.6	2.16e-292
GCF_040790795.1_ASM4079079v1_genomic	NZ_CP161167.1	21380	20873	507	renamed_GCF_000008685.2	cp26	21364	20857	507	100.0	3.123e-111
GCF_040790795.1_ASM4079079v1_genomic	NZ_CP161167.1	21840	21354	486	renamed_GCF_000008685.2	cp26	21833	21338	486	100.0	3.279e-107
GCF_040790795.1_ASM4079079v1_genomic	NZ_CP161167.1	21913	22519	606	renamed_GCF_000008685.2	cp26	21897	22593	606	99.4	2.148e-123
GCF_040790795.1_ASM4079079v1_genomic	NZ_CP161167.1	23168	22616	552	renamed_GCF_000008685.2	cp26	23154	22602	552	100.0	6.015e-120
GCF_040790795.1_ASM4079079v1_genomic	NZ_CP161167.1	23268	24513	1245	renamed_GCF_000008685.2	cp26	23254	24499	1245	98.5	3.391e-277
GCF_040790795.1_ASM4079079v1_genomic	NZ_CP161167.1	24838	26467	1629	renamed_GCF_000008685.2	cp26	24824	26453	1629	100.0	0.0
GCF_040790795.1_ASM4079079v1_genomic	NZ_CP161162.1	5403	5787	384	renamed_GCF_000008685.2	cp32-9	5412	5796	384	100.0	2.931e-83
GCF_040790795.1_ASM4079079v1_genomic	NZ_CP161162.1	5774	6164	390	renamed_GCF_000008685.2	cp32-4	5777	6167	390	100.0	3.229e-83
GCF_040790795.1_ASM4079079v1_genomic	NZ_CP161162.1	6160	6730	570	renamed_GCF_000008685.2	cp32-6	6160	6730	570	98.4	5.468e-124
GCF_040790795.1_ASM4079079v1_genomic	NZ_CP161162.1	6710	7823	1113	renamed_GCF_000008685.2	lp56	10170	11283	1113	96.4	1.311e-239
GCF_040790795.1_ASM4079079v1_genomic	NZ_CP161162.1	7838	8267	429	renamed_GCF_000008685.2	lp56	11296	11725	429	98.5	1.374e-90
GCF_040790795.1_ASM4079079v1_genomic	NZ_CP161162.1	8282	8738	456	renamed_GCF_000008685.2	cp32-4	8281	8737	456	96.6	1.075e-97
GCF_040790795.1_ASM4079079v1_genomic	NZ_CP161162.1	8734	8971	237	renamed_GCF_000008685.2	cp32-7	8725	8962	237	97.4	1.95e-47
GCF_040790795.1_ASM4079079v1_genomic	NZ_CP161162.1	8978	10289	1311	renamed_GCF_000008685.2	cp32-7	8969	10304	1311	81.0	4.301e-233
GCF_040790795.1_ASM4079079v1_genomic	NZ_CP161162.1	10301	10943	642	renamed_GCF_000008685.2	cp32-7	10316	10958	642	94.8	1.615e-132
GCF_040790795.1_ASM4079079v1_genomic	NZ_CP161162.1	16586	16904	318	renamed_GCF_000008685.2	cp32-3	16585	16903	318	100.0	2.414e-66
GCF_040790795.1_ASM4079079v1_genomic	NZ_CP161162.1	17089	17773	684	renamed_GCF_000008685.2	lp56	20042	20738	684	86.1	2.703e-125
GCF_040790795.1_ASM4079079v1_genomic	NZ_CP161162.1	17878	18328	450	renamed_GCF_000008685.2	cp32-8	17204	17651	450	79.7	4.475e-73
GCF_040790795.1_ASM4079079v1_genomic	NZ_CP161162.1	19375	18361	1014	renamed_GCF_000008685.2	cp32-1	18728	17714	1014	99.7	7.051e-230
GCF_040790795.1_ASM4079079v1_genomic	NZ_CP161162.1	19764	20865	1101	renamed_GCF_000008685.2	cp32-1	19113	20214	1101	95.0	4.897e-240
GCF_040790795.1_ASM4079079v1_genomic	NZ_CP161162.1	20874	21441	567	renamed_GCF_000008685.2	cp32-4	20066	20633	567	100.0	2.944e-130
GCF_040790795.1_ASM4079079v1_genomic	NZ_CP161162.1	21416	22157	741	renamed_GCF_000008685.2	cp32-3	21256	21997	741	100.0	5.003e-162
GCF_040790795.1_ASM4079079v1_genomic	NZ_CP161162.1	22197	22740	543	renamed_GCF_000008685.2	cp32-1	21560	22118	543	64.0	6.304e-76
GCF_040790795.1_ASM4079079v1_genomic	NZ_CP161162.1	22752	23289	537	renamed_GCF_000008685.2	cp32-3	22592	23183	537	90.3	2.263e-111
GCF_040790795.1_ASM4079079v1_genomic	NZ_CP161162.1	26023	25246	777	renamed_GCF_000008685.2	cp32-3	26276	25499	777	98.8	7.674e-172
GCF_040790795.1_ASM4079079v1_genomic	NZ_CP161162.1	27289	27817	528	renamed_GCF_000008685.2	cp32-4	27675	28203	528	89.7	7.744e-105
GCF_040790795.1_ASM4079079v1_genomic	NZ_CP161162.1	27998	28565	567	renamed_GCF_000008685.2	cp32-7	28884	29451	567	100.0	5.734e-123
GCF_040790795.1_ASM4079079v1_genomic	NZ_CP161162.1	28561	29914	1353	renamed_GCF_000008685.2	cp32-6	28485	29838	1353	99.7	1.39e-305
GCF_040790795.1_ASM4079079v1_genomic	NZ_CP161161.1	8735	8972	237	renamed_GCF_000008685.2	cp32-6	8733	8970	237	97.4	8.748e-48
GCF_040790795.1_ASM4079079v1_genomic	NZ_CP161161.1	10699	11650	951	renamed_GCF_000008685.2	cp32-4	10895	11846	951	76.6	9.078e-156
GCF_040790795.1_ASM4079079v1_genomic	NZ_CP161161.1	11663	12218	555	renamed_GCF_000008685.2	cp32-6	11929	12484	555	87.5	6.44e-103
GCF_040790795.1_ASM4079079v1_genomic	NZ_CP161161.1	12247	12580	333	renamed_GCF_000008685.2	cp32-9	12592	12925	333	100.0	1.876e-71
GCF_040790795.1_ASM4079079v1_genomic	NZ_CP161161.1	14075	14888	813	renamed_GCF_000008685.2	cp32-8	14323	15139	813	59.9	7.62e-100
GCF_040790795.1_ASM4079079v1_genomic	NZ_CP161161.1	14964	15168	204	renamed_GCF_000008685.2	lp56	18712	18916	204	100.0	2.578e-39
GCF_040790795.1_ASM4079079v1_genomic	NZ_CP161171.1	1844	2402	558	renamed_GCF_000008685.2	cp32-1	2010	2568	558	96.7	1.471e-119
GCF_040790795.1_ASM4079079v1_genomic	NZ_CP161171.1	2408	3173	765	renamed_GCF_000008685.2	cp32-7	2573	3338	765	98.4	1.703e-169
GCF_040790795.1_ASM4079079v1_genomic	NZ_CP161171.1	3796	4756	960	renamed_GCF_000008685.2	cp32-1	3962	4922	960	99.3	3.255e-212
GCF_040790795.1_ASM4079079v1_genomic	NZ_CP161171.1	4775	5231	456	renamed_GCF_000008685.2	cp32-1	4941	5397	456	96.6	1.436e-94
GCF_040790795.1_ASM4079079v1_genomic	NZ_CP161171.1	5230	5614	384	renamed_GCF_000008685.2	cp32-4	5406	5790	384	100.0	2.931e-83
GCF_040790795.1_ASM4079079v1_genomic	NZ_CP161171.1	12998	13520	522	renamed_GCF_000008685.2	cp32-7	21521	22076	522	100.0	1.473e-113
GCF_040790795.1_ASM4079079v1_genomic	NZ_CP161171.1	13531	14104	573	renamed_GCF_000008685.2	cp32-7	22087	22660	573	100.0	7.629e-121
GCF_040790795.1_ASM4079079v1_genomic	NZ_CP161171.1	14491	15817	1326	renamed_GCF_000008685.2	cp32-7	23134	24460	1326	99.0	3.52e-299
GCF_040790795.1_ASM4079079v1_genomic	NZ_CP161171.1	17077	16300	777	renamed_GCF_000008685.2	lp56	29506	28729	777	97.6	2.057e-169
GCF_040790795.1_ASM4079079v1_genomic	NZ_CP161169.1	22763	22259	504	renamed_GCF_000008685.2	lp56	3622	4108	504	93.0	3.962e-83
GCF_040790795.1_ASM4079079v1_genomic	NZ_CP161169.1	23658	22986	672	renamed_GCF_000008685.2	lp28-2	1046	1928	672	97.7	3.417e-146
GCF_040790795.1_ASM4079079v1_genomic	NZ_CP161169.1	24753	23859	894	renamed_GCF_000008685.2	lp28-2	115	1009	894	98.9	7.433e-192
GCF_040790795.1_ASM4079079v1_genomic	NZ_CP161168.1	2317	1132	1185	renamed_GCF_000008685.2	chromosome	908406	909591	1185	100.0	8.142e-266
GCF_040790795.1_ASM4079079v1_genomic	NZ_CP161168.1	9730	9178	552	renamed_GCF_000008685.2	lp28-1	12992	12440	552	97.8	3.273e-118
GCF_040790795.1_ASM4079079v1_genomic	NZ_CP161168.1	10531	9766	765	renamed_GCF_000008685.2	lp28-1	13793	13028	765	99.6	1.871e-168
GCF_040790795.1_ASM4079079v1_genomic	NZ_CP161164.1	1064	1388	324	renamed_GCF_000008685.2	lp28-3	1044	1368	324	99.0	8.87e-70
GCF_040790795.1_ASM4079079v1_genomic	NZ_CP161164.1	3002	2279	723	renamed_GCF_000008685.2	lp28-3	2970	2259	723	94.5	2.04e-143
GCF_040790795.1_ASM4079079v1_genomic	NZ_CP161164.1	7759	3922	3837	renamed_GCF_000008685.2	lp28-3	7728	3891	3837	100.0	0.0
GCF_040790795.1_ASM4079079v1_genomic	NZ_CP161164.1	8234	8030	204	renamed_GCF_000008685.2	lp36	17379	17583	204	83.5	3.933e-35
GCF_040790795.1_ASM4079079v1_genomic	NZ_CP161164.1	10547	9878	669	renamed_GCF_000008685.2	lp28-3	10516	9847	669	100.0	5.739e-140
GCF_040790795.1_ASM4079079v1_genomic	NZ_CP161164.1	16550	17495	945	renamed_GCF_000008685.2	lp28-3	16518	17415	945	94.5	4.657e-197
GCF_040790795.1_ASM4079079v1_genomic	NZ_CP161163.1	4024	4840	816	renamed_GCF_000008685.2	lp28-4	2535	3351	816	100.0	8.08e-178
GCF_040790795.1_ASM4079079v1_genomic	NZ_CP161163.1	6617	6836	219	renamed_GCF_000008685.2	lp28-4	5127	5346	219	100.0	1.443e-47
GCF_040790795.1_ASM4079079v1_genomic	NZ_CP161163.1	8693	10496	1803	renamed_GCF_000008685.2	lp28-4	7182	8538	1803	75.1	3.722e-272
GCF_040790795.1_ASM4079079v1_genomic	NZ_CP161163.1	12773	13880	1107	renamed_GCF_000008685.2	lp28-4	10814	11927	1107	98.9	2.343e-249
GCF_040790795.1_ASM4079079v1_genomic	NZ_CP161163.1	13876	14431	555	renamed_GCF_000008685.2	lp28-4	11923	12478	555	100.0	3.559e-126
GCF_040790795.1_ASM4079079v1_genomic	NZ_CP161163.1	14406	15159	753	renamed_GCF_000008685.2	lp28-4	12453	13206	753	100.0	4.561e-165
GCF_040790795.1_ASM4079079v1_genomic	NZ_CP161163.1	15217	15790	573	renamed_GCF_000008685.2	lp28-4	13264	13837	573	100.0	2.579e-124
GCF_040790795.1_ASM4079079v1_genomic	NZ_CP161163.1	17307	18486	1179	renamed_GCF_000008685.2	lp28-4	15351	16530	1179	99.2	5.451e-252
GCF_040790795.1_ASM4079079v1_genomic	NZ_CP161163.1	21133	20467	666	renamed_GCF_000008685.2	lp28-4	19183	18517	666	99.5	1.537e-145
GCF_040790795.1_ASM4079079v1_genomic	NZ_CP161163.1	23512	22759	753	renamed_GCF_000008685.2	lp28-4	21562	20770	753	98.3	1.223e-162
GCF_040790795.1_ASM4079079v1_genomic	NZ_CP161163.1	24881	24044	837	renamed_GCF_000008685.2	lp28-4	22931	22094	837	98.9	7.731e-182
GCF_040790795.1_ASM4079079v1_genomic	NZ_CP161165.1	27149	26795	354	renamed_GCF_000008685.2	lp5	743	1097	354	99.1	7.983e-76
GCF_040790795.1_ASM4079079v1_genomic	NZ_CP161165.1	27627	27246	381	renamed_GCF_000008685.2	lp28-4	173	608	381	68.0	3.224e-49
GCF_040790795.1_ASM4079079v1_genomic	NZ_CP161166.1	14262	13236	1026	renamed_GCF_000008685.2	lp28-2	16482	15456	1026	99.4	8.508e-230
GCF_040790795.1_ASM4079079v1_genomic	NZ_CP161166.1	15464	14273	1191	renamed_GCF_000008685.2	lp28-2	17684	16493	1191	99.7	6.781e-269
GCF_040790795.1_ASM4079079v1_genomic	NZ_CP161166.1	15799	15460	339	renamed_GCF_000008685.2	lp28-2	18019	17680	339	100.0	5.085e-70
GCF_040790795.1_ASM4079079v1_genomic	NZ_CP161166.1	16607	15809	798	renamed_GCF_000008685.2	lp28-2	18827	18029	798	93.2	2.604e-170
GCF_040790795.1_ASM4079079v1_genomic	NZ_CP161166.1	17399	16616	783	renamed_GCF_000008685.2	lp28-2	19619	18836	783	92.3	1.226e-167
GCF_040790795.1_ASM4079079v1_genomic	NZ_CP161166.1	20081	17399	2682	renamed_GCF_000008685.2	lp28-2	22259	19619	2682	97.5	0.0
GCF_040790795.1_ASM4079079v1_genomic	NZ_CP161166.1	20479	20092	387	renamed_GCF_000008685.2	lp28-2	22659	22272	387	72.6	9.831e-63
GCF_040790795.1_ASM4079079v1_genomic	NZ_CP161166.1	20853	20481	372	renamed_GCF_000008685.2	lp28-2	23033	22658	372	80.4	3.483e-63
GCF_040790795.1_ASM4079079v1_genomic	NZ_CP161166.1	21545	20852	693	renamed_GCF_000008685.2	lp28-2	23725	23032	693	83.4	3.937e-131
GCF_040790795.1_ASM4079079v1_genomic	NZ_CP161166.1	21951	21537	414	renamed_GCF_000008685.2	lp28-2	24108	23721	414	55.6	1.931e-43
GCF_040790795.1_ASM4079079v1_genomic	NZ_CP161170.1	6313	5617	696	renamed_GCF_000008685.2	lp36	8859	8163	696	97.8	8.359e-149
GCF_040790795.1_ASM4079079v1_genomic	NZ_CP161170.1	6826	7231	405	renamed_GCF_000008685.2	lp36	9372	9999	405	99.1	1.226e-79
GCF_040790795.1_ASM4079079v1_genomic	NZ_CP161170.1	7755	9402	1647	renamed_GCF_000008685.2	lp36	10300	11947	1647	99.8	0.0
GCF_040790795.1_ASM4079079v1_genomic	NZ_CP161170.1	10056	10692	636	renamed_GCF_000008685.2	lp36	12601	13237	636	99.5	7.582e-140
GCF_040790795.1_ASM4079079v1_genomic	NZ_CP161170.1	11781	11031	750	renamed_GCF_000008685.2	lp36	14326	13576	750	100.0	1.062e-163
GCF_040790795.1_ASM4079079v1_genomic	NZ_CP161170.1	12296	11756	540	renamed_GCF_000008685.2	lp36	14841	14301	540	100.0	2.234e-120
GCF_040790795.1_ASM4079079v1_genomic	NZ_CP161170.1	13215	12288	927	renamed_GCF_000008685.2	lp36	15760	14833	927	99.6	1.39e-207
GCF_040790795.1_ASM4079079v1_genomic	NZ_CP161170.1	13728	14340	612	renamed_GCF_000008685.2	lp36	16274	16886	612	100.0	9.153e-134
GCF_040790795.1_ASM4079079v1_genomic	NZ_CP161160.1	7959	7152	807	renamed_GCF_000008685.2	lp56	2743	3496	807	56.1	5.821e-84
GCF_040790795.1_ASM4079079v1_genomic	NZ_CP161160.1	16026	14988	1038	renamed_GCF_000008685.2	lp38	22042	23008	1038	88.7	1.356e-200
GCF_040790795.1_ASM4079079v1_genomic	NZ_CP161160.1	16775	16049	726	renamed_GCF_000008685.2	lp38	21222	21948	726	92.5	2.708e-149
GCF_040790795.1_ASM4079079v1_genomic	NZ_CP161160.1	17997	16767	1230	renamed_GCF_000008685.2	lp38	20000	21230	1230	94.8	1.685e-256
GCF_040790795.1_ASM4079079v1_genomic	NZ_CP161160.1	18685	17989	696	renamed_GCF_000008685.2	lp38	19312	20008	696	94.3	1.108e-145
GCF_040790795.1_ASM4079079v1_genomic	NZ_CP161160.1	19778	18743	1035	renamed_GCF_000008685.2	lp38	18213	19254	1035	87.8	3.062e-208
GCF_040790795.1_ASM4079079v1_genomic	NZ_CP161160.1	20597	19820	777	renamed_GCF_000008685.2	lp38	17387	18170	777	83.3	2.326e-142
GCF_040790795.1_ASM4079079v1_genomic	NZ_CP161160.1	21459	20649	810	renamed_GCF_000008685.2	lp38	16519	17329	810	86.2	2.571e-155
GCF_040790795.1_ASM4079079v1_genomic	NZ_CP161159.1	4258	3004	1254	renamed_GCF_000008685.2	lp54	4256	3002	1254	100.0	3.245e-279
GCF_040790795.1_ASM4079079v1_genomic	NZ_CP161159.1	5141	4667	474	renamed_GCF_000008685.2	lp54	5140	4666	474	96.8	1.577e-96
GCF_040790795.1_ASM4079079v1_genomic	NZ_CP161159.1	5314	5650	336	renamed_GCF_000008685.2	lp54	5313	5649	336	100.0	1.784e-72
GCF_040790795.1_ASM4079079v1_genomic	NZ_CP161159.1	5646	6519	873	renamed_GCF_000008685.2	lp54	5645	6518	873	99.3	2.643e-191
GCF_040790795.1_ASM4079079v1_genomic	NZ_CP161159.1	6521	7148	627	renamed_GCF_000008685.2	lp54	6520	7147	627	99.0	1.16e-133
GCF_040790795.1_ASM4079079v1_genomic	NZ_CP161159.1	7209	8244	1035	renamed_GCF_000008685.2	lp54	7208	8243	1035	100.0	8.138e-232
GCF_040790795.1_ASM4079079v1_genomic	NZ_CP161159.1	8266	8446	180	renamed_GCF_000008685.2	lp54	8265	8445	180	100.0	1.452e-33
GCF_040790795.1_ASM4079079v1_genomic	NZ_CP161159.1	8442	8868	426	renamed_GCF_000008685.2	lp54	8441	8867	426	100.0	3.21e-89
GCF_040790795.1_ASM4079079v1_genomic	NZ_CP161159.1	9457	10279	822	renamed_GCF_000008685.2	lp54	9456	10278	822	99.6	1.415e-172
GCF_040790795.1_ASM4079079v1_genomic	NZ_CP161159.1	21128	21668	540	renamed_GCF_000008685.2	lp54	21086	21626	540	97.7	2.373e-111
GCF_040790795.1_ASM4079079v1_genomic	NZ_CP161159.1	23315	21725	1590	renamed_GCF_000008685.2	lp54	23273	21683	1590	99.6	0.0
GCF_040790795.1_ASM4079079v1_genomic	NZ_CP161159.1	24539	25145	606	renamed_GCF_000008685.2	lp54	24497	25103	606	99.0	1.616e-126
GCF_040790795.1_ASM4079079v1_genomic	NZ_CP161159.1	28055	28973	918	renamed_GCF_000008685.2	lp54	28013	28931	918	99.6	1.041e-200
GCF_040790795.1_ASM4079079v1_genomic	NZ_CP161159.1	35039	35885	846	renamed_GCF_000008685.2	lp54	34987	35833	846	99.2	3.028e-185
GCF_040790795.1_ASM4079079v1_genomic	NZ_CP161159.1	36319	36586	267	renamed_GCF_000008685.2	lp54	36255	36534	267	96.5	1.736e-53
GCF_040790795.1_ASM4079079v1_genomic	NZ_CP161159.1	39457	38212	1245	renamed_GCF_000008685.2	lp54	39405	38160	1245	98.5	3.184e-269
GCF_040790795.1_ASM4079079v1_genomic	NZ_CP161159.1	41099	40265	834	renamed_GCF_000008685.2	lp54	41045	40211	834	99.6	1.639e-181
GCF_040790795.1_ASM4079079v1_genomic	NZ_CP161159.1	42320	42527	207	renamed_GCF_000008685.2	lp54	42266	42473	207	100.0	9.856e-42
GCF_040790795.1_ASM4079079v1_genomic	NZ_CP161158.1	79347	80616	1269	renamed_GCF_000008685.2	chromosome	79504	80773	1269	100.0	1.4e-282
GCF_040790795.1_ASM4079079v1_genomic	NZ_CP161158.1	114445	112750	1695	renamed_GCF_000008685.2	chromosome	114603	112908	1695	100.0	0.0
GCF_040790795.1_ASM4079079v1_genomic	NZ_CP161158.1	114648	115350	702	renamed_GCF_000008685.2	chromosome	114806	115508	702	100.0	2.35e-155
GCF_040790795.1_ASM4079079v1_genomic	NZ_CP161158.1	118771	118216	555	renamed_GCF_000008685.2	chromosome	118929	118374	555	99.4	3.776e-117
GCF_040790795.1_ASM4079079v1_genomic	NZ_CP161158.1	120431	119648	783	renamed_GCF_000008685.2	chromosome	120589	119806	783	99.6	5.024e-169
GCF_040790795.1_ASM4079079v1_genomic	NZ_CP161158.1	121664	120941	723	renamed_GCF_000008685.2	chromosome	121823	121100	723	98.7	4.546e-160
GCF_040790795.1_ASM4079079v1_genomic	NZ_CP161158.1	123987	122331	1656	renamed_GCF_000008685.2	chromosome	124146	122490	1656	99.2	0.0
GCF_040790795.1_ASM4079079v1_genomic	NZ_CP161158.1	125388	124638	750	renamed_GCF_000008685.2	chromosome	125547	124797	750	100.0	1.281e-161
GCF_040790795.1_ASM4079079v1_genomic	NZ_CP161158.1	127254	126156	1098	renamed_GCF_000008685.2	chromosome	127413	126315	1098	100.0	1.369e-236
GCF_040790795.1_ASM4079079v1_genomic	NZ_CP161158.1	179393	178766	627	renamed_GCF_000008685.2	chromosome	179543	178916	627	98.0	7.618e-130
GCF_040790795.1_ASM4079079v1_genomic	NZ_CP161158.1	200900	199814	1086	renamed_GCF_000008685.2	chromosome	201050	199964	1086	99.4	6.528e-243
GCF_040790795.1_ASM4079079v1_genomic	NZ_CP161158.1	202699	203938	1239	renamed_GCF_000008685.2	chromosome	202849	204088	1239	100.0	5.514e-262
GCF_040790795.1_ASM4079079v1_genomic	NZ_CP161158.1	204922	205894	972	renamed_GCF_000008685.2	chromosome	205174	206044	972	99.6	3.289e-188
GCF_040790795.1_ASM4079079v1_genomic	NZ_CP161158.1	208470	207933	537	renamed_GCF_000008685.2	chromosome	208581	208083	537	98.7	3.647e-106
GCF_040790795.1_ASM4079079v1_genomic	NZ_CP161158.1	224473	223651	822	renamed_GCF_000008685.2	chromosome	224785	223963	822	100.0	3.638e-179
GCF_040790795.1_ASM4079079v1_genomic	NZ_CP161158.1	227515	226297	1218	renamed_GCF_000008685.2	chromosome	227827	226609	1218	99.7	3.023e-265
GCF_040790795.1_ASM4079079v1_genomic	NZ_CP161158.1	231179	229901	1278	renamed_GCF_000008685.2	chromosome	231491	230213	1278	99.7	4.58e-288
GCF_040790795.1_ASM4079079v1_genomic	NZ_CP161158.1	293125	292900	225	renamed_GCF_000008685.2	chromosome	293429	293204	225	100.0	8.8e-46
GCF_040790795.1_ASM4079079v1_genomic	NZ_CP161158.1	294475	293146	1329	renamed_GCF_000008685.2	chromosome	294780	293451	1329	99.5	2.627e-294
GCF_040790795.1_ASM4079079v1_genomic	NZ_CP161158.1	296115	294936	1179	renamed_GCF_000008685.2	chromosome	296420	295241	1179	98.9	2.863e-259
GCF_040790795.1_ASM4079079v1_genomic	NZ_CP161158.1	297164	296732	432	renamed_GCF_000008685.2	chromosome	297469	297037	432	99.3	2.176e-94
GCF_040790795.1_ASM4079079v1_genomic	NZ_CP161158.1	298471	297160	1311	renamed_GCF_000008685.2	chromosome	298776	297465	1311	99.5	1.7e-287
GCF_040790795.1_ASM4079079v1_genomic	NZ_CP161158.1	299410	298489	921	renamed_GCF_000008685.2	chromosome	299715	298794	921	99.6	2.293e-192
GCF_040790795.1_ASM4079079v1_genomic	NZ_CP161158.1	319332	318801	531	renamed_GCF_000008685.2	chromosome	319636	319105	531	100.0	1.699e-113
GCF_040790795.1_ASM4079079v1_genomic	NZ_CP161158.1	319954	319375	579	renamed_GCF_000008685.2	chromosome	320249	319679	579	98.9	3.43e-122
GCF_040790795.1_ASM4079079v1_genomic	NZ_CP161158.1	321047	321734	687	renamed_GCF_000008685.2	chromosome	321351	322038	687	100.0	1.336e-150
GCF_040790795.1_ASM4079079v1_genomic	NZ_CP161158.1	323475	322542	933	renamed_GCF_000008685.2	chromosome	323779	322846	933	99.6	9.082e-205
GCF_040790795.1_ASM4079079v1_genomic	NZ_CP161158.1	356701	358135	1434	renamed_GCF_000008685.2	chromosome	357006	358440	1434	99.7	4.764e-314
GCF_040790795.1_ASM4079079v1_genomic	NZ_CP161158.1	359190	358911	279	renamed_GCF_000008685.2	chromosome	359495	359216	279	98.9	6.331e-58
GCF_040790795.1_ASM4079079v1_genomic	NZ_CP161158.1	360894	362016	1122	renamed_GCF_000008685.2	chromosome	361187	362321	1122	99.4	1.215e-250
GCF_040790795.1_ASM4079079v1_genomic	NZ_CP161158.1	373972	375349	1377	renamed_GCF_000008685.2	chromosome	374276	375653	1377	99.7	6.3e-310
GCF_040790795.1_ASM4079079v1_genomic	NZ_CP161158.1	376715	375656	1059	renamed_GCF_000008685.2	chromosome	377019	375960	1059	98.0	1.713e-227
GCF_040790795.1_ASM4079079v1_genomic	NZ_CP161158.1	380254	379036	1218	renamed_GCF_000008685.2	chromosome	380558	379340	1218	99.2	2.093e-269
GCF_040790795.1_ASM4079079v1_genomic	NZ_CP161158.1	383078	381605	1473	renamed_GCF_000008685.2	chromosome	383382	381909	1473	100.0	0.0
GCF_040790795.1_ASM4079079v1_genomic	NZ_CP161158.1	383982	385122	1140	renamed_GCF_000008685.2	chromosome	384286	385426	1140	99.4	1.764e-249
GCF_040790795.1_ASM4079079v1_genomic	NZ_CP161158.1	396775	396301	474	renamed_GCF_000008685.2	chromosome	397077	396603	474	100.0	4.822e-101
GCF_040790795.1_ASM4079079v1_genomic	NZ_CP161158.1	401375	397241	4134	renamed_GCF_000008685.2	chromosome	401677	397543	4134	99.8	0.0
GCF_040790795.1_ASM4079079v1_genomic	NZ_CP161158.1	482026	482554	528	renamed_GCF_000008685.2	chromosome	485549	486077	528	100.0	1.004e-118
GCF_040790795.1_ASM4079079v1_genomic	NZ_CP161158.1	483193	484015	822	renamed_GCF_000008685.2	chromosome	486746	487538	822	99.6	9.243e-169
GCF_040790795.1_ASM4079079v1_genomic	NZ_CP161158.1	484702	485449	747	renamed_GCF_000008685.2	chromosome	488225	488972	747	100.0	3.778e-166
GCF_040790795.1_ASM4079079v1_genomic	NZ_CP161158.1	494689	495523	834	renamed_GCF_000008685.2	chromosome	498212	499046	834	100.0	1.895e-188
GCF_040790795.1_ASM4079079v1_genomic	NZ_CP161158.1	496183	497065	882	renamed_GCF_000008685.2	chromosome	499706	500588	882	100.0	1.248e-192
GCF_040790795.1_ASM4079079v1_genomic	NZ_CP161158.1	497069	497486	417	renamed_GCF_000008685.2	chromosome	500592	501009	417	100.0	2.778e-89
GCF_040790795.1_ASM4079079v1_genomic	NZ_CP161158.1	497691	497946	255	renamed_GCF_000008685.2	chromosome	501214	501469	255	100.0	1.745e-51
GCF_040790795.1_ASM4079079v1_genomic	NZ_CP161158.1	498667	499216	549	renamed_GCF_000008685.2	chromosome	502190	502739	549	99.4	3.776e-116
GCF_040790795.1_ASM4079079v1_genomic	NZ_CP161158.1	504290	505325	1035	renamed_GCF_000008685.2	chromosome	507813	508848	1035	100.0	4.156e-222
GCF_040790795.1_ASM4079079v1_genomic	NZ_CP161158.1	505346	505718	372	renamed_GCF_000008685.2	chromosome	508869	509241	372	100.0	8.775e-78
GCF_040790795.1_ASM4079079v1_genomic	NZ_CP161158.1	628933	630913	1980	renamed_GCF_000008685.2	chromosome	632484	634464	1980	99.2	0.0
GCF_040790795.1_ASM4079079v1_genomic	NZ_CP161158.1	633040	634405	1365	renamed_GCF_000008685.2	chromosome	636592	637957	1365	99.3	1.721e-296
GCF_040790795.1_ASM4079079v1_genomic	NZ_CP161158.1	635027	636320	1293	renamed_GCF_000008685.2	chromosome	638579	639872	1293	99.5	1.544e-285
GCF_040790795.1_ASM4079079v1_genomic	NZ_CP161158.1	638736	638889	153	renamed_GCF_000008685.2	chromosome	642288	642441	153	98.0	2.814e-30
GCF_040790795.1_ASM4079079v1_genomic	NZ_CP161158.1	641098	639742	1356	renamed_GCF_000008685.2	chromosome	644650	643294	1356	99.5	1.919e-302
GCF_040790795.1_ASM4079079v1_genomic	NZ_CP161158.1	642049	641584	465	renamed_GCF_000008685.2	chromosome	645601	645136	465	100.0	4.176e-101
GCF_040790795.1_ASM4079079v1_genomic	NZ_CP161158.1	642166	643129	963	renamed_GCF_000008685.2	chromosome	645718	646681	963	99.6	1.275e-214
GCF_040790795.1_ASM4079079v1_genomic	NZ_CP161158.1	645000	645555	555	renamed_GCF_000008685.2	chromosome	648552	649107	555	99.4	3.12e-119
GCF_040790795.1_ASM4079079v1_genomic	NZ_CP161158.1	650238	646860	3378	renamed_GCF_000008685.2	chromosome	653790	650412	3378	99.8	0.0
GCF_040790795.1_ASM4079079v1_genomic	NZ_CP161158.1	18299	17786	513	renamed_GCF_000008685.2	chromosome	18304	17791	513	99.4	1.872e-109
GCF_040790795.1_ASM4079079v1_genomic	NZ_CP161158.1	21938	20894	1044	renamed_GCF_000008685.2	chromosome	22101	21057	1044	100.0	6.693e-227
GCF_040790795.1_ASM4079079v1_genomic	NZ_CP161158.1	22655	23795	1140	renamed_GCF_000008685.2	chromosome	22818	23958	1140	97.0	1.113e-254
GCF_040790795.1_ASM4079079v1_genomic	NZ_CP161158.1	25589	26228	639	renamed_GCF_000008685.2	chromosome	25752	26391	639	99.5	1.211e-143
GCF_040790795.1_ASM4079079v1_genomic	NZ_CP161158.1	27702	27270	432	renamed_GCF_000008685.2	chromosome	27865	27433	432	100.0	2.641e-92
GCF_040790795.1_ASM4079079v1_genomic	NZ_CP161158.1	29309	28328	981	renamed_GCF_000008685.2	chromosome	29472	28491	981	100.0	8.047e-223
GCF_040790795.1_ASM4079079v1_genomic	NZ_CP161158.1	30866	31325	459	renamed_GCF_000008685.2	chromosome	31026	31479	459	99.3	5.582e-97
GCF_040790795.1_ASM4079079v1_genomic	NZ_CP161158.1	33883	32002	1881	renamed_GCF_000008685.2	chromosome	34037	32156	1881	100.0	0.0
GCF_040790795.1_ASM4079079v1_genomic	NZ_CP161158.1	36455	35702	753	renamed_GCF_000008685.2	chromosome	36609	35856	753	98.0	1.62e-159
GCF_040790795.1_ASM4079079v1_genomic	NZ_CP161158.1	39481	37978	1503	renamed_GCF_000008685.2	chromosome	39638	38135	1503	99.8	0.0
GCF_040790795.1_ASM4079079v1_genomic	NZ_CP161158.1	61098	60408	690	renamed_GCF_000008685.2	chromosome	61257	60567	690	98.6	3.759e-148
GCF_040790795.1_ASM4079079v1_genomic	NZ_CP161158.1	62987	63869	882	renamed_GCF_000008685.2	chromosome	63146	64028	882	99.6	6.762e-191
GCF_040790795.1_ASM4079079v1_genomic	NZ_CP161158.1	65131	65593	462	renamed_GCF_000008685.2	chromosome	65290	65752	462	100.0	3.193e-95
GCF_040790795.1_ASM4079079v1_genomic	NZ_CP161158.1	69409	69970	561	renamed_GCF_000008685.2	chromosome	69565	70126	561	100.0	3.775e-118
GCF_040790795.1_ASM4079079v1_genomic	NZ_CP161158.1	81247	82783	1536	renamed_GCF_000008685.2	chromosome	81404	82940	1536	100.0	0.0
GCF_040790795.1_ASM4079079v1_genomic	NZ_CP161158.1	85563	83883	1680	renamed_GCF_000008685.2	chromosome	85720	84040	1680	100.0	0.0
GCF_040790795.1_ASM4079079v1_genomic	NZ_CP161158.1	87203	86768	435	renamed_GCF_000008685.2	chromosome	87360	86925	435	100.0	2.772e-92
GCF_040790795.1_ASM4079079v1_genomic	NZ_CP161158.1	90958	89653	1305	renamed_GCF_000008685.2	chromosome	91115	89810	1305	100.0	2.863e-289
GCF_040790795.1_ASM4079079v1_genomic	NZ_CP161158.1	93876	93276	600	renamed_GCF_000008685.2	chromosome	94032	93432	600	100.0	1.47e-126
GCF_040790795.1_ASM4079079v1_genomic	NZ_CP161158.1	145311	144438	873	renamed_GCF_000008685.2	chromosome	145458	144585	873	98.9	1.511e-197
GCF_040790795.1_ASM4079079v1_genomic	NZ_CP161158.1	158477	159194	717	renamed_GCF_000008685.2	chromosome	158627	159344	717	97.0	3.592e-153
GCF_040790795.1_ASM4079079v1_genomic	NZ_CP161158.1	159939	161058	1119	renamed_GCF_000008685.2	chromosome	160089	161208	1119	99.7	1.16e-250
GCF_040790795.1_ASM4079079v1_genomic	NZ_CP161158.1	162727	162895	168	renamed_GCF_000008685.2	chromosome	162877	163045	168	100.0	5.294e-34
GCF_040790795.1_ASM4079079v1_genomic	NZ_CP161158.1	165737	164750	987	renamed_GCF_000008685.2	chromosome	165887	164900	987	99.6	2.948e-209
GCF_040790795.1_ASM4079079v1_genomic	NZ_CP161158.1	167609	165764	1845	renamed_GCF_000008685.2	chromosome	167759	165914	1845	99.1	0.0
GCF_040790795.1_ASM4079079v1_genomic	NZ_CP161158.1	169388	170558	1170	renamed_GCF_000008685.2	chromosome	169562	170708	1170	99.7	6.062e-258
GCF_040790795.1_ASM4079079v1_genomic	NZ_CP161158.1	182652	181257	1395	renamed_GCF_000008685.2	chromosome	182802	181407	1395	100.0	4.219e-300
GCF_040790795.1_ASM4079079v1_genomic	NZ_CP161158.1	186403	186796	393	renamed_GCF_000008685.2	chromosome	186553	186946	393	100.0	5.626e-86
GCF_040790795.1_ASM4079079v1_genomic	NZ_CP161158.1	221321	222866	1545	renamed_GCF_000008685.2	chromosome	221741	223178	1545	98.3	8.416e-309
GCF_040790795.1_ASM4079079v1_genomic	NZ_CP161158.1	245476	246241	765	renamed_GCF_000008685.2	chromosome	245789	246554	765	100.0	7.663e-170
GCF_040790795.1_ASM4079079v1_genomic	NZ_CP161158.1	248213	249776	1563	renamed_GCF_000008685.2	chromosome	248505	250089	1563	99.8	0.0
GCF_040790795.1_ASM4079079v1_genomic	NZ_CP161158.1	250898	250343	555	renamed_GCF_000008685.2	chromosome	251211	250656	555	99.4	1.543e-118
GCF_040790795.1_ASM4079079v1_genomic	NZ_CP161158.1	251924	250898	1026	renamed_GCF_000008685.2	chromosome	252237	251211	1026	99.4	1.351e-224
GCF_040790795.1_ASM4079079v1_genomic	NZ_CP161158.1	252845	254618	1773	renamed_GCF_000008685.2	chromosome	253158	254931	1773	99.3	0.0
GCF_040790795.1_ASM4079079v1_genomic	NZ_CP161158.1	273343	272320	1023	renamed_GCF_000008685.2	chromosome	273647	272633	1023	98.5	8.403e-221
GCF_040790795.1_ASM4079079v1_genomic	NZ_CP161158.1	276192	274938	1254	renamed_GCF_000008685.2	chromosome	276496	275242	1254	99.5	5.471e-282
GCF_040790795.1_ASM4079079v1_genomic	NZ_CP161158.1	278255	276785	1470	renamed_GCF_000008685.2	chromosome	278559	277089	1470	99.7	4.387e-321
GCF_040790795.1_ASM4079079v1_genomic	NZ_CP161158.1	278754	278232	522	renamed_GCF_000008685.2	chromosome	279058	278536	522	100.0	3.966e-111
GCF_040790795.1_ASM4079079v1_genomic	NZ_CP161158.1	309475	308233	1242	renamed_GCF_000008685.2	chromosome	309780	308538	1242	100.0	1.368e-269
GCF_040790795.1_ASM4079079v1_genomic	NZ_CP161158.1	311348	310253	1095	renamed_GCF_000008685.2	chromosome	311617	310558	1095	99.4	1.229e-228
GCF_040790795.1_ASM4079079v1_genomic	NZ_CP161158.1	312410	311354	1056	renamed_GCF_000008685.2	chromosome	312715	311659	1056	100.0	1.239e-230
GCF_040790795.1_ASM4079079v1_genomic	NZ_CP161158.1	313819	312427	1392	renamed_GCF_000008685.2	chromosome	314123	312728	1392	100.0	1.047e-306
GCF_040790795.1_ASM4079079v1_genomic	NZ_CP161158.1	314123	313841	282	renamed_GCF_000008685.2	chromosome	314427	314145	282	100.0	2.699e-59
GCF_040790795.1_ASM4079079v1_genomic	NZ_CP161159.1	16663	16099	564	renamed_GCF_000008685.2	lp54	16576	16000	564	91.8	3.333e-103
GCF_040790795.1_ASM4079079v1_genomic	NZ_CP161159.1	18811	20164	1353	renamed_GCF_000008685.2	lp54	18724	20077	1353	99.7	3.386e-304
GCF_040790795.1_ASM4079079v1_genomic	NZ_CP161159.1	23818	24457	639	renamed_GCF_000008685.2	lp54	23776	24415	639	98.1	1.541e-132
GCF_040790795.1_ASM4079079v1_genomic	NZ_CP161159.1	25494	26736	1242	renamed_GCF_000008685.2	lp54	25467	26694	1242	99.7	3.651e-267
GCF_040790795.1_ASM4079079v1_genomic	NZ_CP161159.1	27431	28040	609	renamed_GCF_000008685.2	lp54	27389	27998	609	100.0	2.346e-131
GCF_040790795.1_ASM4079079v1_genomic	NZ_CP161159.1	36005	36281	276	renamed_GCF_000008685.2	lp54	35953	36229	276	100.0	3.31e-56
GCF_040790795.1_ASM4079079v1_genomic	NZ_CP161159.1	40166	39926	240	renamed_GCF_000008685.2	lp54	40112	39872	240	100.0	3.722e-49
GCF_040790795.1_ASM4079079v1_genomic	NZ_CP161159.1	42073	41449	624	renamed_GCF_000008685.2	lp54	42019	41395	624	100.0	3.1e-139
GCF_040790795.1_ASM4079079v1_genomic	NZ_CP161159.1	43586	42677	909	renamed_GCF_000008685.2	lp54	43532	42623	909	99.6	5.38e-198
GCF_040790795.1_ASM4079079v1_genomic	NZ_CP161159.1	48350	47594	756	renamed_GCF_000008685.2	lp54	47228	46472	756	98.0	2.849e-162
GCF_040790795.1_ASM4079079v1_genomic	NZ_CP161159.1	51349	50458	891	renamed_GCF_000008685.2	lp54	51176	50285	891	98.9	4.455e-197
GCF_040790795.1_ASM4079079v1_genomic	NZ_CP161158.1	122332	121720	612	renamed_GCF_000008685.2	chromosome	122491	121879	612	97.0	9.656e-125
GCF_040790795.1_ASM4079079v1_genomic	NZ_CP161158.1	124655	123989	666	renamed_GCF_000008685.2	chromosome	124814	124148	666	100.0	8.347e-144
GCF_040790795.1_ASM4079079v1_genomic	NZ_CP161158.1	126142	125374	768	renamed_GCF_000008685.2	chromosome	126301	125533	768	99.2	8.033e-170
GCF_040790795.1_ASM4079079v1_genomic	NZ_CP161158.1	129973	127267	2706	renamed_GCF_000008685.2	chromosome	130132	127426	2706	99.8	0.0
GCF_040790795.1_ASM4079079v1_genomic	NZ_CP161158.1	131138	132266	1128	renamed_GCF_000008685.2	chromosome	131297	132425	1128	99.4	1.93e-246
GCF_040790795.1_ASM4079079v1_genomic	NZ_CP161158.1	148512	147501	1011	renamed_GCF_000008685.2	chromosome	148659	147648	1011	99.7	2.697e-214
GCF_040790795.1_ASM4079079v1_genomic	NZ_CP161158.1	152054	152861	807	renamed_GCF_000008685.2	chromosome	152205	153012	807	100.0	9.769e-183
GCF_040790795.1_ASM4079079v1_genomic	NZ_CP161158.1	156249	153549	2700	renamed_GCF_000008685.2	chromosome	156400	153700	2700	100.0	0.0
GCF_040790795.1_ASM4079079v1_genomic	NZ_CP161158.1	157476	157911	435	renamed_GCF_000008685.2	chromosome	157626	158061	435	99.3	1.372e-91
GCF_040790795.1_ASM4079079v1_genomic	NZ_CP161158.1	226298	224513	1785	renamed_GCF_000008685.2	chromosome	226610	224825	1785	99.4	0.0
GCF_040790795.1_ASM4079079v1_genomic	NZ_CP161158.1	228209	227501	708	renamed_GCF_000008685.2	chromosome	228521	227813	708	100.0	8.763e-159
GCF_040790795.1_ASM4079079v1_genomic	NZ_CP161158.1	228904	229912	1008	renamed_GCF_000008685.2	chromosome	229216	230224	1008	99.4	2.993e-221
GCF_040790795.1_ASM4079079v1_genomic	NZ_CP161158.1	231308	232010	702	renamed_GCF_000008685.2	chromosome	231620	232322	702	100.0	1.161e-154
GCF_040790795.1_ASM4079079v1_genomic	NZ_CP161158.1	235222	234976	246	renamed_GCF_000008685.2	chromosome	235534	235288	246	98.7	3.025e-52
GCF_040790795.1_ASM4079079v1_genomic	NZ_CP161158.1	237317	236909	408	renamed_GCF_000008685.2	chromosome	237629	237221	408	100.0	2.649e-88
GCF_040790795.1_ASM4079079v1_genomic	NZ_CP161158.1	237914	237656	258	renamed_GCF_000008685.2	chromosome	238226	237968	258	100.0	9.113e-51
GCF_040790795.1_ASM4079079v1_genomic	NZ_CP161158.1	239938	238831	1107	renamed_GCF_000008685.2	chromosome	240250	239143	1107	99.7	3.718e-244
GCF_040790795.1_ASM4079079v1_genomic	NZ_CP161158.1	242125	243691	1566	renamed_GCF_000008685.2	chromosome	242437	244003	1566	98.4	0.0
GCF_040790795.1_ASM4079079v1_genomic	NZ_CP161158.1	318812	317972	840	renamed_GCF_000008685.2	chromosome	319116	318276	840	99.6	1.977e-180
GCF_040790795.1_ASM4079079v1_genomic	NZ_CP161158.1	320004	321048	1044	renamed_GCF_000008685.2	chromosome	320308	321352	1044	99.4	3.304e-226
GCF_040790795.1_ASM4079079v1_genomic	NZ_CP161158.1	322542	321735	807	renamed_GCF_000008685.2	chromosome	322846	322039	807	99.6	2.064e-174
GCF_040790795.1_ASM4079079v1_genomic	NZ_CP161158.1	325984	324931	1053	renamed_GCF_000008685.2	chromosome	326288	325235	1053	99.4	2.184e-232
GCF_040790795.1_ASM4079079v1_genomic	NZ_CP161158.1	328959	329319	360	renamed_GCF_000008685.2	chromosome	329261	329621	360	100.0	1.609e-77
GCF_040790795.1_ASM4079079v1_genomic	NZ_CP161158.1	334222	333325	897	renamed_GCF_000008685.2	chromosome	334515	333618	897	100.0	1.666e-200
GCF_040790795.1_ASM4079079v1_genomic	NZ_CP161158.1	340035	340956	921	renamed_GCF_000008685.2	chromosome	340340	341261	921	98.6	3.516e-196
GCF_040790795.1_ASM4079079v1_genomic	NZ_CP161158.1	354331	353134	1197	renamed_GCF_000008685.2	chromosome	354636	353439	1197	100.0	5.312e-264
GCF_040790795.1_ASM4079079v1_genomic	NZ_CP161158.1	355185	356604	1419	renamed_GCF_000008685.2	chromosome	355490	356909	1419	99.5	1.551e-315
GCF_040790795.1_ASM4079079v1_genomic	NZ_CP161158.1	405315	404940	375	renamed_GCF_000008685.2	chromosome	405617	405242	375	99.1	2.753e-74
GCF_040790795.1_ASM4079079v1_genomic	NZ_CP161158.1	406559	405878	681	renamed_GCF_000008685.2	chromosome	406861	406180	681	100.0	2.702e-150
GCF_040790795.1_ASM4079079v1_genomic	NZ_CP161158.1	407596	407041	555	renamed_GCF_000008685.2	chromosome	407898	407343	555	99.4	1.275e-120
GCF_040790795.1_ASM4079079v1_genomic	NZ_CP161158.1	427696	428332	636	renamed_GCF_000008685.2	chromosome	427986	428622	636	99.5	1.686e-139
GCF_040790795.1_ASM4079079v1_genomic	NZ_CP161158.1	430326	429402	924	renamed_GCF_000008685.2	chromosome	430616	429692	924	98.0	2.542e-200
GCF_040790795.1_ASM4079079v1_genomic	NZ_CP161158.1	439018	438178	840	renamed_GCF_000008685.2	chromosome	442552	441712	840	98.9	7.382e-183
GCF_040790795.1_ASM4079079v1_genomic	NZ_CP161158.1	439714	439153	561	renamed_GCF_000008685.2	chromosome	443248	442687	561	99.4	1.054e-123
GCF_040790795.1_ASM4079079v1_genomic	NZ_CP161158.1	444152	443435	717	renamed_GCF_000008685.2	chromosome	447736	446968	717	99.1	3.946e-152
GCF_040790795.1_ASM4079079v1_genomic	NZ_CP161158.1	456518	456878	360	renamed_GCF_000008685.2	chromosome	460051	460411	360	99.1	5.311e-73
GCF_040790795.1_ASM4079079v1_genomic	NZ_CP161158.1	482550	483246	696	renamed_GCF_000008685.2	chromosome	486073	486769	696	100.0	2.835e-152
GCF_040790795.1_ASM4079079v1_genomic	NZ_CP161158.1	484011	484701	690	renamed_GCF_000008685.2	chromosome	487534	488224	690	99.5	4.749e-154
GCF_040790795.1_ASM4079079v1_genomic	NZ_CP161158.1	485459	485972	513	renamed_GCF_000008685.2	chromosome	488982	489495	513	100.0	1.545e-111
GCF_040790795.1_ASM4079079v1_genomic	NZ_CP161158.1	495532	495811	279	renamed_GCF_000008685.2	chromosome	499055	499334	279	100.0	1.411e-57
GCF_040790795.1_ASM4079079v1_genomic	NZ_CP161158.1	495817	496180	363	renamed_GCF_000008685.2	chromosome	499340	499703	363	100.0	3.407e-78
GCF_040790795.1_ASM4079079v1_genomic	NZ_CP161158.1	497488	497689	201	renamed_GCF_000008685.2	chromosome	501014	501212	201	98.4	1.098e-39
GCF_040790795.1_ASM4079079v1_genomic	NZ_CP161158.1	497973	498342	369	renamed_GCF_000008685.2	chromosome	501496	501865	369	99.1	4.571e-76
GCF_040790795.1_ASM4079079v1_genomic	NZ_CP161158.1	498356	498662	306	renamed_GCF_000008685.2	chromosome	501879	502185	306	100.0	2.959e-62
GCF_040790795.1_ASM4079079v1_genomic	NZ_CP161158.1	503882	504275	393	renamed_GCF_000008685.2	chromosome	507405	507798	393	100.0	3.073e-84
GCF_040790795.1_ASM4079079v1_genomic	NZ_CP161158.1	505790	507323	1533	renamed_GCF_000008685.2	chromosome	509313	510846	1533	100.0	0.0
GCF_040790795.1_ASM4079079v1_genomic	NZ_CP161158.1	507312	508101	789	renamed_GCF_000008685.2	chromosome	510835	511624	789	100.0	3.149e-175
GCF_040790795.1_ASM4079079v1_genomic	NZ_CP161158.1	509702	511004	1302	renamed_GCF_000008685.2	chromosome	513225	514527	1302	99.3	1.946e-284
GCF_040790795.1_ASM4079079v1_genomic	NZ_CP161158.1	511000	512260	1260	renamed_GCF_000008685.2	chromosome	514523	515783	1260	98.3	1.758e-278
GCF_040790795.1_ASM4079079v1_genomic	NZ_CP161158.1	544960	544315	645	renamed_GCF_000008685.2	chromosome	548490	547845	645	100.0	1.056e-137
GCF_040790795.1_ASM4079079v1_genomic	NZ_CP161158.1	546088	545389	699	renamed_GCF_000008685.2	chromosome	549618	548919	699	100.0	1.058e-146
GCF_040790795.1_ASM4079079v1_genomic	NZ_CP161158.1	548193	546111	2082	renamed_GCF_000008685.2	chromosome	551723	549641	2082	100.0	0.0
GCF_040790795.1_ASM4079079v1_genomic	NZ_CP161158.1	549614	550265	651	renamed_GCF_000008685.2	chromosome	553138	553789	651	99.5	3.256e-143
GCF_040790795.1_ASM4079079v1_genomic	NZ_CP161158.1	551691	553056	1365	renamed_GCF_000008685.2	chromosome	555215	556580	1365	99.1	1.676e-305
GCF_040790795.1_ASM4079079v1_genomic	NZ_CP161158.1	565732	565993	261	renamed_GCF_000008685.2	chromosome	569277	569538	261	100.0	9.575e-51
GCF_040790795.1_ASM4079079v1_genomic	NZ_CP161158.1	566013	567735	1722	renamed_GCF_000008685.2	chromosome	569558	571280	1722	99.8	0.0
GCF_040790795.1_ASM4079079v1_genomic	NZ_CP161158.1	618453	619896	1443	renamed_GCF_000008685.2	chromosome	622004	623447	1443	99.1	0.0
GCF_040790795.1_ASM4079079v1_genomic	NZ_CP161158.1	619899	621456	1557	renamed_GCF_000008685.2	chromosome	623450	625007	1557	98.6	0.0
GCF_040790795.1_ASM4079079v1_genomic	NZ_CP161158.1	621455	622709	1254	renamed_GCF_000008685.2	chromosome	625006	626260	1254	100.0	1.925e-276
GCF_040790795.1_ASM4079079v1_genomic	NZ_CP161158.1	622734	623487	753	renamed_GCF_000008685.2	chromosome	626285	627038	753	100.0	9.23e-166
GCF_040790795.1_ASM4079079v1_genomic	NZ_CP161158.1	625397	623540	1857	renamed_GCF_000008685.2	chromosome	628948	627091	1857	100.0	0.0
GCF_040790795.1_ASM4079079v1_genomic	NZ_CP161158.1	627217	628435	1218	renamed_GCF_000008685.2	chromosome	630795	631986	1218	99.4	4.366e-261
GCF_040790795.1_ASM4079079v1_genomic	NZ_CP161158.1	628439	628931	492	renamed_GCF_000008685.2	chromosome	631990	632482	492	100.0	1.786e-106
GCF_040790795.1_ASM4079079v1_genomic	NZ_CP161158.1	631029	632460	1431	renamed_GCF_000008685.2	chromosome	634580	636011	1431	95.3	9.45e-306
GCF_040790795.1_ASM4079079v1_genomic	NZ_CP161158.1	634410	635004	594	renamed_GCF_000008685.2	chromosome	637971	638556	594	99.4	7.271e-125
GCF_040790795.1_ASM4079079v1_genomic	NZ_CP161158.1	636288	638697	2409	renamed_GCF_000008685.2	chromosome	639858	642249	2409	99.4	0.0