QUERY_ID	QUERY_NAME	QUERY_START	QUERY_END	QUERY_LENGTH	REF_ID	REF_NAME	REF_START	REF_END	REF_LENGTH	IDENTITY	EVALUE
GCF_040790805.1_ASM4079080v1_genomic	NZ_CP161191.1	15345	14724	621	renamed_GCF_000008685.2	chromosome	15345	14724	621	100.0	3.249e-138
GCF_040790805.1_ASM4079080v1_genomic	NZ_CP161191.1	18304	17791	513	renamed_GCF_000008685.2	chromosome	18304	17791	513	100.0	1.701e-110
GCF_040790805.1_ASM4079080v1_genomic	NZ_CP161191.1	22739	22145	594	renamed_GCF_000008685.2	chromosome	22739	22145	594	100.0	3.27e-125
GCF_040790805.1_ASM4079080v1_genomic	NZ_CP161191.1	25602	24696	906	renamed_GCF_000008685.2	chromosome	25623	24696	906	99.6	3.053e-195
GCF_040790805.1_ASM4079080v1_genomic	NZ_CP161191.1	26398	27448	1050	renamed_GCF_000008685.2	chromosome	26398	27448	1050	100.0	7.794e-235
GCF_040790805.1_ASM4079080v1_genomic	NZ_CP161191.1	27865	27433	432	renamed_GCF_000008685.2	chromosome	27865	27433	432	100.0	2.641e-92
GCF_040790805.1_ASM4079080v1_genomic	NZ_CP161191.1	29542	31015	1473	renamed_GCF_000008685.2	chromosome	29542	31015	1473	99.7	0.0
GCF_040790805.1_ASM4079080v1_genomic	NZ_CP161191.1	32089	31549	540	renamed_GCF_000008685.2	chromosome	32089	31549	540	100.0	3.274e-116
GCF_040790805.1_ASM4079080v1_genomic	NZ_CP161191.1	35836	34036	1800	renamed_GCF_000008685.2	chromosome	35836	34036	1800	100.0	0.0
GCF_040790805.1_ASM4079080v1_genomic	NZ_CP161191.1	69562	70123	561	renamed_GCF_000008685.2	chromosome	69565	70126	561	100.0	3.775e-118
GCF_040790805.1_ASM4079080v1_genomic	NZ_CP161191.1	71197	72607	1410	renamed_GCF_000008685.2	chromosome	71200	72610	1410	100.0	2.56e-308
GCF_040790805.1_ASM4079080v1_genomic	NZ_CP161191.1	75769	76450	681	renamed_GCF_000008685.2	chromosome	75773	76454	681	100.0	3.584e-147
GCF_040790805.1_ASM4079080v1_genomic	NZ_CP161191.1	79037	77738	1299	renamed_GCF_000008685.2	chromosome	79009	77710	1299	100.0	8.363e-285
GCF_040790805.1_ASM4079080v1_genomic	NZ_CP161191.1	79532	80801	1269	renamed_GCF_000008685.2	chromosome	79504	80773	1269	100.0	1.4e-282
GCF_040790805.1_ASM4079080v1_genomic	NZ_CP161191.1	94633	94246	387	renamed_GCF_000008685.2	chromosome	94605	94218	387	100.0	1.031e-86
GCF_040790805.1_ASM4079080v1_genomic	NZ_CP161191.1	97894	96970	924	renamed_GCF_000008685.2	chromosome	97866	96942	924	100.0	7.888e-205
GCF_040790805.1_ASM4079080v1_genomic	NZ_CP161191.1	100255	100777	522	renamed_GCF_000008685.2	chromosome	100227	100749	522	100.0	2.976e-114
GCF_040790805.1_ASM4079080v1_genomic	NZ_CP161191.1	133869	132498	1371	renamed_GCF_000008685.2	chromosome	133842	132471	1371	100.0	2.422e-302
GCF_040790805.1_ASM4079080v1_genomic	NZ_CP161191.1	148688	147677	1011	renamed_GCF_000008685.2	chromosome	148659	147648	1011	100.0	5.463e-215
GCF_040790805.1_ASM4079080v1_genomic	NZ_CP161191.1	152234	153041	807	renamed_GCF_000008685.2	chromosome	152205	153012	807	100.0	9.769e-183
GCF_040790805.1_ASM4079080v1_genomic	NZ_CP161191.1	156429	153729	2700	renamed_GCF_000008685.2	chromosome	156400	153700	2700	100.0	0.0
GCF_040790805.1_ASM4079080v1_genomic	NZ_CP161191.1	157655	158090	435	renamed_GCF_000008685.2	chromosome	157626	158061	435	100.0	6.167e-92
GCF_040790805.1_ASM4079080v1_genomic	NZ_CP161191.1	158656	159373	717	renamed_GCF_000008685.2	chromosome	158627	159344	717	100.0	1.01e-158
GCF_040790805.1_ASM4079080v1_genomic	NZ_CP161191.1	182914	183409	495	renamed_GCF_000008685.2	chromosome	182885	183380	495	100.0	9.271e-106
GCF_040790805.1_ASM4079080v1_genomic	NZ_CP161191.1	186977	187223	246	renamed_GCF_000008685.2	chromosome	186948	187194	246	100.0	9.168e-49
GCF_040790805.1_ASM4079080v1_genomic	NZ_CP161191.1	188266	187852	414	renamed_GCF_000008685.2	chromosome	188237	187823	414	100.0	2.918e-88
GCF_040790805.1_ASM4079080v1_genomic	NZ_CP161191.1	214645	216478	1833	renamed_GCF_000008685.2	chromosome	215426	217259	1833	100.0	0.0
GCF_040790805.1_ASM4079080v1_genomic	NZ_CP161191.1	218297	217643	654	renamed_GCF_000008685.2	chromosome	219078	218424	654	100.0	1.052e-147
GCF_040790805.1_ASM4079080v1_genomic	NZ_CP161191.1	219018	219858	840	renamed_GCF_000008685.2	chromosome	219799	220639	840	100.0	1.641e-182
GCF_040790805.1_ASM4079080v1_genomic	NZ_CP161191.1	220852	222397	1545	renamed_GCF_000008685.2	chromosome	221741	223178	1545	99.7	1.424e-311
GCF_040790805.1_ASM4079080v1_genomic	NZ_CP161191.1	224004	223182	822	renamed_GCF_000008685.2	chromosome	224785	223963	822	100.0	3.638e-179
GCF_040790805.1_ASM4079080v1_genomic	NZ_CP161191.1	236848	236440	408	renamed_GCF_000008685.2	chromosome	237629	237221	408	100.0	2.649e-88
GCF_040790805.1_ASM4079080v1_genomic	NZ_CP161191.1	237175	236848	327	renamed_GCF_000008685.2	chromosome	237956	237629	327	100.0	8.435e-71
GCF_040790805.1_ASM4079080v1_genomic	NZ_CP161191.1	238347	237519	828	renamed_GCF_000008685.2	chromosome	239128	238300	828	100.0	9.354e-187
GCF_040790805.1_ASM4079080v1_genomic	NZ_CP161191.1	412345	413548	1203	renamed_GCF_000008685.2	chromosome	413112	414315	1203	100.0	6.394e-263
GCF_040790805.1_ASM4079080v1_genomic	NZ_CP161198.1	7747	3910	3837	renamed_GCF_000008685.2	lp28-3	7728	3891	3837	100.0	0.0
GCF_040790805.1_ASM4079080v1_genomic	NZ_CP161198.1	10535	9866	669	renamed_GCF_000008685.2	lp28-3	10516	9847	669	100.0	5.739e-140
GCF_040790805.1_ASM4079080v1_genomic	NZ_CP161198.1	16537	17434	897	renamed_GCF_000008685.2	lp28-3	16518	17415	897	100.0	1.518e-201
GCF_040790805.1_ASM4079080v1_genomic	NZ_CP161198.1	17426	17993	567	renamed_GCF_000008685.2	lp28-3	17407	17974	567	100.0	1.938e-126
GCF_040790805.1_ASM4079080v1_genomic	NZ_CP161193.1	6077	5324	753	renamed_GCF_000008685.2	lp36	6040	5287	753	100.0	7.287e-160
GCF_040790805.1_ASM4079080v1_genomic	NZ_CP161193.1	6411	6687	276	renamed_GCF_000008685.2	lp36	6365	6650	276	100.0	1.214e-58
GCF_040790805.1_ASM4079080v1_genomic	NZ_CP161193.1	8896	8200	696	renamed_GCF_000008685.2	lp36	8859	8163	696	100.0	1.275e-152
GCF_040790805.1_ASM4079080v1_genomic	NZ_CP161193.1	9409	10036	627	renamed_GCF_000008685.2	lp36	9372	9999	627	100.0	1.942e-136
GCF_040790805.1_ASM4079080v1_genomic	NZ_CP161193.1	10337	11984	1647	renamed_GCF_000008685.2	lp36	10300	11947	1647	100.0	0.0
GCF_040790805.1_ASM4079080v1_genomic	NZ_CP161193.1	12638	13274	636	renamed_GCF_000008685.2	lp36	12601	13237	636	100.0	3.41e-140
GCF_040790805.1_ASM4079080v1_genomic	NZ_CP161192.1	5647	6520	873	renamed_GCF_000008685.2	lp54	5645	6518	873	100.0	2.408e-192
GCF_040790805.1_ASM4079080v1_genomic	NZ_CP161192.1	6522	7149	627	renamed_GCF_000008685.2	lp54	6520	7147	627	100.0	4.747e-135
GCF_040790805.1_ASM4079080v1_genomic	NZ_CP161192.1	7210	8245	1035	renamed_GCF_000008685.2	lp54	7208	8243	1035	100.0	8.138e-232
GCF_040790805.1_ASM4079080v1_genomic	NZ_CP161192.1	8267	8447	180	renamed_GCF_000008685.2	lp54	8265	8445	180	100.0	1.452e-33
GCF_040790805.1_ASM4079080v1_genomic	NZ_CP161192.1	8443	8869	426	renamed_GCF_000008685.2	lp54	8441	8867	426	100.0	3.21e-89
GCF_040790805.1_ASM4079080v1_genomic	NZ_CP161192.1	9458	10280	822	renamed_GCF_000008685.2	lp54	9456	10278	822	100.0	5.801e-174
GCF_040790805.1_ASM4079080v1_genomic	NZ_CP161192.1	10289	11180	891	renamed_GCF_000008685.2	lp54	10287	11178	891	99.6	4.629e-188
GCF_040790805.1_ASM4079080v1_genomic	NZ_CP161192.1	21088	21628	540	renamed_GCF_000008685.2	lp54	21086	21626	540	100.0	8.011e-115
GCF_040790805.1_ASM4079080v1_genomic	NZ_CP161192.1	30095	30635	540	renamed_GCF_000008685.2	lp54	30093	30633	540	100.0	4.969e-120
GCF_040790805.1_ASM4079080v1_genomic	NZ_CP161192.1	30711	31782	1071	renamed_GCF_000008685.2	lp54	30709	31780	1071	100.0	2.191e-235
GCF_040790805.1_ASM4079080v1_genomic	NZ_CP161192.1	31781	32204	423	renamed_GCF_000008685.2	lp54	31779	32202	423	100.0	5.086e-92
GCF_040790805.1_ASM4079080v1_genomic	NZ_CP161192.1	32262	32751	489	renamed_GCF_000008685.2	lp54	32260	32749	489	100.0	3.125e-108
GCF_040790805.1_ASM4079080v1_genomic	NZ_CP161192.1	32743	32962	219	renamed_GCF_000008685.2	lp54	32741	32960	219	100.0	7.958e-46
GCF_040790805.1_ASM4079080v1_genomic	NZ_CP161192.1	34386	34950	564	renamed_GCF_000008685.2	lp54	34384	34948	564	100.0	7.276e-120
GCF_040790805.1_ASM4079080v1_genomic	NZ_CP161192.1	34989	35835	846	renamed_GCF_000008685.2	lp54	34987	35833	846	100.0	5.585e-187
GCF_040790805.1_ASM4079080v1_genomic	NZ_CP161192.1	35955	36231	276	renamed_GCF_000008685.2	lp54	35953	36229	276	100.0	3.31e-56
GCF_040790805.1_ASM4079080v1_genomic	NZ_CP161191.1	50471	50108	363	renamed_GCF_000008685.2	chromosome	50474	50111	363	100.0	4.578e-75
GCF_040790805.1_ASM4079080v1_genomic	NZ_CP161191.1	81432	82968	1536	renamed_GCF_000008685.2	chromosome	81404	82940	1536	100.0	0.0
GCF_040790805.1_ASM4079080v1_genomic	NZ_CP161191.1	83948	82997	951	renamed_GCF_000008685.2	chromosome	83920	82969	951	99.6	3.736e-209
GCF_040790805.1_ASM4079080v1_genomic	NZ_CP161191.1	85748	84068	1680	renamed_GCF_000008685.2	chromosome	85720	84040	1680	100.0	0.0
GCF_040790805.1_ASM4079080v1_genomic	NZ_CP161191.1	86882	85907	975	renamed_GCF_000008685.2	chromosome	86854	85879	975	100.0	4.354e-220
GCF_040790805.1_ASM4079080v1_genomic	NZ_CP161191.1	87388	86953	435	renamed_GCF_000008685.2	chromosome	87360	86925	435	100.0	2.772e-92
GCF_040790805.1_ASM4079080v1_genomic	NZ_CP161191.1	89836	89227	609	renamed_GCF_000008685.2	chromosome	89808	89199	609	100.0	1.275e-129
GCF_040790805.1_ASM4079080v1_genomic	NZ_CP161191.1	91143	89838	1305	renamed_GCF_000008685.2	chromosome	91115	89810	1305	100.0	2.863e-289
GCF_040790805.1_ASM4079080v1_genomic	NZ_CP161191.1	103799	103043	756	renamed_GCF_000008685.2	chromosome	103771	103015	756	100.0	4.353e-166
GCF_040790805.1_ASM4079080v1_genomic	NZ_CP161191.1	114833	115535	702	renamed_GCF_000008685.2	chromosome	114806	115508	702	100.0	2.35e-155
GCF_040790805.1_ASM4079080v1_genomic	NZ_CP161191.1	116833	115531	1302	renamed_GCF_000008685.2	chromosome	116806	115504	1302	100.0	1.776e-285
GCF_040790805.1_ASM4079080v1_genomic	NZ_CP161191.1	118397	117704	693	renamed_GCF_000008685.2	chromosome	118370	117677	693	100.0	4.532e-155
GCF_040790805.1_ASM4079080v1_genomic	NZ_CP161191.1	118956	118401	555	renamed_GCF_000008685.2	chromosome	118929	118374	555	100.0	1.543e-118
GCF_040790805.1_ASM4079080v1_genomic	NZ_CP161191.1	119830	118990	840	renamed_GCF_000008685.2	chromosome	119803	118963	840	100.0	4.393e-180
GCF_040790805.1_ASM4079080v1_genomic	NZ_CP161191.1	120616	119833	783	renamed_GCF_000008685.2	chromosome	120589	119806	783	100.0	5.024e-169
GCF_040790805.1_ASM4079080v1_genomic	NZ_CP161191.1	121109	120830	279	renamed_GCF_000008685.2	chromosome	121082	120803	279	100.0	1.411e-57
GCF_040790805.1_ASM4079080v1_genomic	NZ_CP161191.1	121850	121127	723	renamed_GCF_000008685.2	chromosome	121823	121100	723	100.0	1.695e-162
GCF_040790805.1_ASM4079080v1_genomic	NZ_CP161191.1	134001	135891	1890	renamed_GCF_000008685.2	chromosome	133974	135864	1890	100.0	0.0
GCF_040790805.1_ASM4079080v1_genomic	NZ_CP161191.1	162830	161228	1602	renamed_GCF_000008685.2	chromosome	162801	161199	1602	100.0	0.0
GCF_040790805.1_ASM4079080v1_genomic	NZ_CP161191.1	164849	163100	1749	renamed_GCF_000008685.2	chromosome	164820	163071	1749	100.0	0.0
GCF_040790805.1_ASM4079080v1_genomic	NZ_CP161191.1	165916	164929	987	renamed_GCF_000008685.2	chromosome	165887	164900	987	100.0	2.687e-210
GCF_040790805.1_ASM4079080v1_genomic	NZ_CP161191.1	169428	167907	1521	renamed_GCF_000008685.2	chromosome	169399	167878	1521	100.0	0.0
GCF_040790805.1_ASM4079080v1_genomic	NZ_CP161191.1	171126	170748	378	renamed_GCF_000008685.2	chromosome	171097	170719	378	100.0	1.603e-80
GCF_040790805.1_ASM4079080v1_genomic	NZ_CP161191.1	171279	171513	234	renamed_GCF_000008685.2	chromosome	171262	171484	234	98.6	1.134e-44
GCF_040790805.1_ASM4079080v1_genomic	NZ_CP161191.1	174145	173557	588	renamed_GCF_000008685.2	chromosome	174116	173528	588	100.0	1.529e-132
GCF_040790805.1_ASM4079080v1_genomic	NZ_CP161191.1	177882	177006	876	renamed_GCF_000008685.2	chromosome	177853	176977	876	100.0	9.427e-195
GCF_040790805.1_ASM4079080v1_genomic	NZ_CP161191.1	179572	178945	627	renamed_GCF_000008685.2	chromosome	179543	178916	627	100.0	1.275e-132
GCF_040790805.1_ASM4079080v1_genomic	NZ_CP161191.1	225829	224044	1785	renamed_GCF_000008685.2	chromosome	226610	224825	1785	100.0	0.0
GCF_040790805.1_ASM4079080v1_genomic	NZ_CP161191.1	227740	227032	708	renamed_GCF_000008685.2	chromosome	228521	227813	708	100.0	8.763e-159
GCF_040790805.1_ASM4079080v1_genomic	NZ_CP161191.1	230710	229432	1278	renamed_GCF_000008685.2	chromosome	231491	230213	1278	100.0	4.58e-288
GCF_040790805.1_ASM4079080v1_genomic	NZ_CP161191.1	231556	234472	2916	renamed_GCF_000008685.2	chromosome	232337	235253	2916	100.0	0.0
GCF_040790805.1_ASM4079080v1_genomic	NZ_CP161191.1	245008	245773	765	renamed_GCF_000008685.2	chromosome	245789	246554	765	100.0	7.663e-170
GCF_040790805.1_ASM4079080v1_genomic	NZ_CP161191.1	247745	249308	1563	renamed_GCF_000008685.2	chromosome	248505	250089	1563	100.0	0.0
GCF_040790805.1_ASM4079080v1_genomic	NZ_CP161191.1	250430	249875	555	renamed_GCF_000008685.2	chromosome	251211	250656	555	100.0	3.12e-119
GCF_040790805.1_ASM4079080v1_genomic	NZ_CP161191.1	251652	252258	606	renamed_GCF_000008685.2	chromosome	252433	253039	606	100.0	4.115e-133
GCF_040790805.1_ASM4079080v1_genomic	NZ_CP161191.1	290240	289181	1059	renamed_GCF_000008685.2	chromosome	291021	289962	1059	100.0	3.164e-229
GCF_040790805.1_ASM4079080v1_genomic	NZ_CP161191.1	290814	290277	537	renamed_GCF_000008685.2	chromosome	291595	291058	537	100.0	7.638e-115
GCF_040790805.1_ASM4079080v1_genomic	NZ_CP161191.1	301708	299998	1710	renamed_GCF_000008685.2	chromosome	302489	300779	1710	100.0	0.0
GCF_040790805.1_ASM4079080v1_genomic	NZ_CP161191.1	302528	302069	459	renamed_GCF_000008685.2	chromosome	303309	302850	459	100.0	4.601e-99
GCF_040790805.1_ASM4079080v1_genomic	NZ_CP161191.1	304339	302992	1347	renamed_GCF_000008685.2	chromosome	305120	303773	1347	100.0	1.016e-290
GCF_040790805.1_ASM4079080v1_genomic	NZ_CP161191.1	305837	304889	948	renamed_GCF_000008685.2	chromosome	306615	305670	948	100.0	3.249e-210
GCF_040790805.1_ASM4079080v1_genomic	NZ_CP161191.1	307736	306536	1200	renamed_GCF_000008685.2	chromosome	308517	307317	1200	100.0	3.302e-261
GCF_040790805.1_ASM4079080v1_genomic	NZ_CP161191.1	309742	308998	744	renamed_GCF_000008685.2	chromosome	310523	309779	744	100.0	5.245e-162
GCF_040790805.1_ASM4079080v1_genomic	NZ_CP161191.1	311934	310878	1056	renamed_GCF_000008685.2	chromosome	312715	311659	1056	100.0	1.239e-230
GCF_040790805.1_ASM4079080v1_genomic	NZ_CP161191.1	313647	313365	282	renamed_GCF_000008685.2	chromosome	314427	314145	282	100.0	2.699e-59
GCF_040790805.1_ASM4079080v1_genomic	NZ_CP161191.1	348830	347372	1458	renamed_GCF_000008685.2	chromosome	349610	348152	1458	100.0	0.0
GCF_040790805.1_ASM4079080v1_genomic	NZ_CP161191.1	352673	350573	2100	renamed_GCF_000008685.2	chromosome	353437	351340	2100	100.0	0.0
GCF_040790805.1_ASM4079080v1_genomic	NZ_CP161191.1	354531	353880	651	renamed_GCF_000008685.2	chromosome	355298	354647	651	100.0	1.769e-141
GCF_040790805.1_ASM4079080v1_genomic	NZ_CP161191.1	356239	357673	1434	renamed_GCF_000008685.2	chromosome	357006	358440	1434	100.0	9.657e-315
GCF_040790805.1_ASM4079080v1_genomic	NZ_CP161191.1	358728	358449	279	renamed_GCF_000008685.2	chromosome	359495	359216	279	100.0	2.841e-58
GCF_040790805.1_ASM4079080v1_genomic	NZ_CP161191.1	360432	361554	1122	renamed_GCF_000008685.2	chromosome	361187	362321	1122	100.0	1.01e-252
GCF_040790805.1_ASM4079080v1_genomic	NZ_CP161191.1	364313	363362	951	renamed_GCF_000008685.2	chromosome	364972	364129	951	99.6	1.174e-187
GCF_040790805.1_ASM4079080v1_genomic	NZ_CP161191.1	367688	368114	426	renamed_GCF_000008685.2	chromosome	368455	368881	426	100.0	3.899e-87
GCF_040790805.1_ASM4079080v1_genomic	NZ_CP161191.1	406094	405413	681	renamed_GCF_000008685.2	chromosome	406861	406180	681	100.0	2.702e-150
GCF_040790805.1_ASM4079080v1_genomic	NZ_CP161191.1	407131	406576	555	renamed_GCF_000008685.2	chromosome	407898	407343	555	100.0	5.734e-121
GCF_040790805.1_ASM4079080v1_genomic	NZ_CP161191.1	407613	407433	180	renamed_GCF_000008685.2	chromosome	408380	408200	180	100.0	2.118e-37
GCF_040790805.1_ASM4079080v1_genomic	NZ_CP161191.1	420613	418735	1878	renamed_GCF_000008685.2	chromosome	421380	419502	1878	100.0	0.0
GCF_040790805.1_ASM4079080v1_genomic	NZ_CP161191.1	422290	423070	780	renamed_GCF_000008685.2	chromosome	423054	423834	780	100.0	3.296e-173
GCF_040790805.1_ASM4079080v1_genomic	NZ_CP161191.1	423928	424786	858	renamed_GCF_000008685.2	chromosome	424693	425551	858	100.0	1.579e-194
GCF_040790805.1_ASM4079080v1_genomic	NZ_CP161191.1	425970	427185	1215	renamed_GCF_000008685.2	chromosome	426735	427950	1215	100.0	1.711e-262
GCF_040790805.1_ASM4079080v1_genomic	NZ_CP161191.1	444694	445300	606	renamed_GCF_000008685.2	chromosome	448707	449310	606	100.0	1.106e-130
GCF_040790805.1_ASM4079080v1_genomic	NZ_CP161191.1	483201	483897	696	renamed_GCF_000008685.2	chromosome	486073	486769	696	100.0	2.835e-152
GCF_040790805.1_ASM4079080v1_genomic	NZ_CP161191.1	484662	485352	690	renamed_GCF_000008685.2	chromosome	487534	488224	690	100.0	9.609e-155
GCF_040790805.1_ASM4079080v1_genomic	NZ_CP161191.1	486110	486623	513	renamed_GCF_000008685.2	chromosome	488982	489495	513	100.0	1.545e-111
GCF_040790805.1_ASM4079080v1_genomic	NZ_CP161191.1	486619	486847	228	renamed_GCF_000008685.2	chromosome	489539	489719	228	100.0	1.455e-33
GCF_040790805.1_ASM4079080v1_genomic	NZ_CP161191.1	487771	489055	1284	renamed_GCF_000008685.2	chromosome	490643	491927	1284	100.0	9.564e-281
GCF_040790805.1_ASM4079080v1_genomic	NZ_CP161191.1	491670	491277	393	renamed_GCF_000008685.2	chromosome	494539	494149	393	100.0	4.545e-80
GCF_040790805.1_ASM4079080v1_genomic	NZ_CP161191.1	493395	493707	312	renamed_GCF_000008685.2	chromosome	496267	496579	312	100.0	2.953e-63
GCF_040790805.1_ASM4079080v1_genomic	NZ_CP161191.1	494372	495002	630	renamed_GCF_000008685.2	chromosome	497244	497874	630	100.0	4.528e-136
GCF_040790805.1_ASM4079080v1_genomic	NZ_CP161191.1	495340	496174	834	renamed_GCF_000008685.2	chromosome	498212	499046	834	100.0	1.895e-188
GCF_040790805.1_ASM4079080v1_genomic	NZ_CP161191.1	496468	496831	363	renamed_GCF_000008685.2	chromosome	499340	499703	363	100.0	3.407e-78
GCF_040790805.1_ASM4079080v1_genomic	NZ_CP161191.1	540172	540940	768	renamed_GCF_000008685.2	chromosome	543048	543816	768	100.0	8.433e-178
GCF_040790805.1_ASM4079080v1_genomic	NZ_CP161191.1	541709	544511	2802	renamed_GCF_000008685.2	chromosome	544585	547387	2802	99.8	0.0
GCF_040790805.1_ASM4079080v1_genomic	NZ_CP161191.1	546009	545610	399	renamed_GCF_000008685.2	chromosome	548885	548486	399	100.0	1.521e-84
GCF_040790805.1_ASM4079080v1_genomic	NZ_CP161191.1	548847	546765	2082	renamed_GCF_000008685.2	chromosome	551723	549641	2082	100.0	0.0
GCF_040790805.1_ASM4079080v1_genomic	NZ_CP161191.1	550261	550912	651	renamed_GCF_000008685.2	chromosome	553138	553789	651	100.0	1.464e-143
GCF_040790805.1_ASM4079080v1_genomic	NZ_CP161191.1	552338	553703	1365	renamed_GCF_000008685.2	chromosome	555215	556580	1365	100.0	6.28e-308
GCF_040790805.1_ASM4079080v1_genomic	NZ_CP161191.1	566400	566661	261	renamed_GCF_000008685.2	chromosome	569277	569538	261	100.0	9.575e-51
GCF_040790805.1_ASM4079080v1_genomic	NZ_CP161191.1	568405	568975	570	renamed_GCF_000008685.2	chromosome	571282	571852	570	100.0	1.471e-121
GCF_040790805.1_ASM4079080v1_genomic	NZ_CP161191.1	805610	805121	489	renamed_GCF_000008685.2	chromosome	808464	807975	489	100.0	6.125e-101
GCF_040790805.1_ASM4079080v1_genomic	NZ_CP161191.1	807641	806846	795	renamed_GCF_000008685.2	chromosome	810495	809700	795	100.0	1.877e-173
GCF_040790805.1_ASM4079080v1_genomic	NZ_CP161191.1	809534	808652	882	renamed_GCF_000008685.2	chromosome	812388	811506	882	100.0	2.526e-193
GCF_040790805.1_ASM4079080v1_genomic	NZ_CP161191.1	810861	810531	330	renamed_GCF_000008685.2	chromosome	813706	813385	330	97.2	1.608e-64
GCF_040790805.1_ASM4079080v1_genomic	NZ_CP161191.1	812457	812022	435	renamed_GCF_000008685.2	chromosome	815302	814867	435	100.0	4.611e-95
GCF_040790805.1_ASM4079080v1_genomic	NZ_CP161191.1	814357	813466	891	renamed_GCF_000008685.2	chromosome	817160	816311	891	99.6	1.029e-187
GCF_040790805.1_ASM4079080v1_genomic	NZ_CP161191.1	815172	815703	531	renamed_GCF_000008685.2	chromosome	818017	818548	531	100.0	1.403e-115
GCF_040790805.1_ASM4079080v1_genomic	NZ_CP161191.1	816076	816397	321	renamed_GCF_000008685.2	chromosome	819035	819242	321	98.5	2.552e-42
GCF_040790805.1_ASM4079080v1_genomic	NZ_CP161191.1	816696	817683	987	renamed_GCF_000008685.2	chromosome	819541	820528	987	100.0	5.255e-220
GCF_040790805.1_ASM4079080v1_genomic	NZ_CP161191.1	828718	828109	609	renamed_GCF_000008685.2	chromosome	831563	830954	609	100.0	7.938e-135
GCF_040790805.1_ASM4079080v1_genomic	NZ_CP161191.1	860791	862198	1407	renamed_GCF_000008685.2	chromosome	863635	865042	1407	100.0	1.287e-315
GCF_040790805.1_ASM4079080v1_genomic	NZ_CP161191.1	862217	863075	858	renamed_GCF_000008685.2	chromosome	865052	865919	858	100.0	6.741e-187
GCF_040790805.1_ASM4079080v1_genomic	NZ_CP161191.1	863836	864757	921	renamed_GCF_000008685.2	chromosome	866680	867601	921	100.0	3.086e-206
GCF_040790805.1_ASM4079080v1_genomic	NZ_CP161191.1	865350	865896	546	renamed_GCF_000008685.2	chromosome	868194	868740	546	100.0	1.846e-123
GCF_040790805.1_ASM4079080v1_genomic	NZ_CP161191.1	887477	890330	2853	renamed_GCF_000008685.2	chromosome	890321	893174	2853	100.0	0.0
GCF_040790805.1_ASM4079080v1_genomic	NZ_CP161191.1	894283	893734	549	renamed_GCF_000008685.2	chromosome	897127	896578	549	100.0	1.159e-120
GCF_040790805.1_ASM4079080v1_genomic	NZ_CP161191.1	896476	894859	1617	renamed_GCF_000008685.2	chromosome	899320	897703	1617	100.0	0.0
GCF_040790805.1_ASM4079080v1_genomic	NZ_CP161191.1	897954	898938	984	renamed_GCF_000008685.2	chromosome	900798	901782	984	100.0	5.014e-220
GCF_040790805.1_ASM4079080v1_genomic	NZ_CP161191.1	902056	901084	972	renamed_GCF_000008685.2	chromosome	904900	903928	972	100.0	2.334e-209
GCF_040790805.1_ASM4079080v1_genomic	NZ_CP161201.1	10530	11121	591	renamed_GCF_000008685.2	cp32-3	26707	27298	591	100.0	2.345e-128
GCF_040790805.1_ASM4079080v1_genomic	NZ_CP161195.1	2	1289	1287	renamed_GCF_000008685.2	cp32-4	65	1289	1287	99.7	2.746e-269
GCF_040790805.1_ASM4079080v1_genomic	NZ_CP161195.1	2579	3347	768	renamed_GCF_000008685.2	cp32-4	2579	3347	768	100.0	3.291e-171
GCF_040790805.1_ASM4079080v1_genomic	NZ_CP161195.1	3971	4931	960	renamed_GCF_000008685.2	cp32-4	3972	4932	960	100.0	6.008e-214
GCF_040790805.1_ASM4079080v1_genomic	NZ_CP161195.1	5405	5789	384	renamed_GCF_000008685.2	cp32-9	5412	5796	384	100.0	2.931e-83
GCF_040790805.1_ASM4079080v1_genomic	NZ_CP161195.1	6162	6729	567	renamed_GCF_000008685.2	cp32-4	6163	6730	567	100.0	1.054e-124
GCF_040790805.1_ASM4079080v1_genomic	NZ_CP161195.1	6709	7822	1113	renamed_GCF_000008685.2	cp32-4	6710	7823	1113	100.0	1.393e-247
GCF_040790805.1_ASM4079080v1_genomic	NZ_CP161195.1	21413	21959	546	renamed_GCF_000008685.2	cp32-4	21414	21960	546	100.0	3.273e-117
GCF_040790805.1_ASM4079080v1_genomic	NZ_CP161194.1	6153	6720	567	renamed_GCF_000008685.2	cp32-1	6153	6720	567	100.0	9.584e-126
GCF_040790805.1_ASM4079080v1_genomic	NZ_CP161194.1	8271	8727	456	renamed_GCF_000008685.2	cp32-6	8281	8737	456	100.0	1.971e-99
GCF_040790805.1_ASM4079080v1_genomic	NZ_CP161194.1	8967	10242	1275	renamed_GCF_000008685.2	cp32-8	8967	10242	1275	100.0	1.201e-276
GCF_040790805.1_ASM4079080v1_genomic	NZ_CP161194.1	10951	11902	951	renamed_GCF_000008685.2	cp32-8	10951	11902	951	100.0	4.333e-216
GCF_040790805.1_ASM4079080v1_genomic	NZ_CP161194.1	12494	12827	333	renamed_GCF_000008685.2	cp32-8	12494	12827	333	100.0	8.424e-72
GCF_040790805.1_ASM4079080v1_genomic	NZ_CP161194.1	21599	22124	525	renamed_GCF_000008685.2	cp32-6	21519	22098	525	65.2	7.009e-72
GCF_040790805.1_ASM4079080v1_genomic	NZ_CP161194.1	25744	24967	777	renamed_GCF_000008685.2	cp32-8	25951	25174	777	93.7	3.284e-164
GCF_040790805.1_ASM4079080v1_genomic	NZ_CP161200.1	359	833	474	renamed_GCF_000008685.2	lp17	329	803	474	100.0	1.788e-103
GCF_040790805.1_ASM4079080v1_genomic	NZ_CP161200.1	3627	3849	222	renamed_GCF_000008685.2	lp17	3651	3819	222	100.0	6.565e-33
GCF_040790805.1_ASM4079080v1_genomic	NZ_CP161200.1	6482	5903	579	renamed_GCF_000008685.2	lp17	6452	5873	579	100.0	2.345e-126
GCF_040790805.1_ASM4079080v1_genomic	NZ_CP161200.1	7814	8141	327	renamed_GCF_000008685.2	lp17	7784	8111	327	100.0	1.029e-68
GCF_040790805.1_ASM4079080v1_genomic	NZ_CP161200.1	9917	9620	297	renamed_GCF_000008685.2	lp17	9980	9590	297	100.0	9.385e-65
GCF_040790805.1_ASM4079080v1_genomic	NZ_CP161196.1	16218	15117	1101	renamed_GCF_000008685.2	lp28-1	15451	14350	1101	100.0	2.133e-249
GCF_040790805.1_ASM4079080v1_genomic	NZ_CP161196.1	18573	18318	255	renamed_GCF_000008685.2	lp28-1	17805	17550	255	100.0	1.423e-53
GCF_040790805.1_ASM4079080v1_genomic	NZ_CP161197.1	22413	19728	2685	renamed_GCF_000008685.2	lp28-2	22259	19619	2685	99.8	0.0
GCF_040790805.1_ASM4079080v1_genomic	NZ_CP161197.1	23834	23141	693	renamed_GCF_000008685.2	lp28-2	23725	23032	693	100.0	4.125e-156
GCF_040790805.1_ASM4079080v1_genomic	NZ_CP161197.1	24217	23830	387	renamed_GCF_000008685.2	lp28-2	24108	23721	387	100.0	1.013e-78
GCF_040790805.1_ASM4079080v1_genomic	NZ_CP161197.1	26088	26499	411	renamed_GCF_000008685.2	lp28-2	25979	26390	411	100.0	2.076e-91
GCF_040790805.1_ASM4079080v1_genomic	NZ_CP161197.1	27221	28049	828	renamed_GCF_000008685.2	lp28-2	27112	27940	828	100.0	3.316e-181
GCF_040790805.1_ASM4079080v1_genomic	NZ_CP161197.1	29727	28962	765	renamed_GCF_000008685.2	lp28-2	29618	28853	765	100.0	1.703e-169
GCF_040790805.1_ASM4079080v1_genomic	NZ_CP161198.1	17965	18721	756	renamed_GCF_000008685.2	lp28-3	17946	18702	756	100.0	8.81e-167
GCF_040790805.1_ASM4079080v1_genomic	NZ_CP161198.1	22696	22972	276	renamed_GCF_000008685.2	lp28-3	22677	22953	276	100.0	6.026e-58
GCF_040790805.1_ASM4079080v1_genomic	NZ_CP161198.1	27464	26996	468	renamed_GCF_000008685.2	lp28-3	27445	26977	468	99.3	1.339e-105
GCF_040790805.1_ASM4079080v1_genomic	NZ_CP161192.1	17261	16697	564	renamed_GCF_000008685.2	lp54	17259	16695	564	100.0	1.065e-115
GCF_040790805.1_ASM4079080v1_genomic	NZ_CP161192.1	18129	18723	594	renamed_GCF_000008685.2	lp54	18127	18721	594	100.0	1.47e-125
GCF_040790805.1_ASM4079080v1_genomic	NZ_CP161192.1	18726	20079	1353	renamed_GCF_000008685.2	lp54	18724	20077	1353	100.0	1.524e-304
GCF_040790805.1_ASM4079080v1_genomic	NZ_CP161192.1	20719	20914	195	renamed_GCF_000008685.2	lp54	20717	20912	195	100.0	2.214e-39
GCF_040790805.1_ASM4079080v1_genomic	NZ_CP161192.1	36269	36536	267	renamed_GCF_000008685.2	lp54	36255	36534	267	98.8	1.568e-54
GCF_040790805.1_ASM4079080v1_genomic	NZ_CP161192.1	39407	38162	1245	renamed_GCF_000008685.2	lp54	39405	38160	1245	99.7	1.088e-272
GCF_040790805.1_ASM4079080v1_genomic	NZ_CP161192.1	40113	39873	240	renamed_GCF_000008685.2	lp54	40112	39872	240	100.0	3.722e-49
GCF_040790805.1_ASM4079080v1_genomic	NZ_CP161192.1	41046	40212	834	renamed_GCF_000008685.2	lp54	41045	40211	834	100.0	3.319e-182
GCF_040790805.1_ASM4079080v1_genomic	NZ_CP161192.1	51699	52473	774	renamed_GCF_000008685.2	lp54	51705	52479	774	100.0	9.219e-161
GCF_040790805.1_ASM4079080v1_genomic	NZ_CP161192.1	52699	53497	798	renamed_GCF_000008685.2	lp54	52705	53503	798	100.0	3.008e-177
GCF_040790805.1_ASM4079080v1_genomic	NZ_CP161191.1	1795	766	1029	renamed_GCF_000008685.2	chromosome	1796	767	1029	100.0	4.829e-228
GCF_040790805.1_ASM4079080v1_genomic	NZ_CP161191.1	8426	9197	771	renamed_GCF_000008685.2	chromosome	8426	9197	771	100.0	1.781e-161
GCF_040790805.1_ASM4079080v1_genomic	NZ_CP161191.1	10580	11420	840	renamed_GCF_000008685.2	chromosome	10580	11420	840	100.0	7.775e-191
GCF_040790805.1_ASM4079080v1_genomic	NZ_CP161191.1	12745	14728	1983	renamed_GCF_000008685.2	chromosome	12745	14728	1983	100.0	0.0
GCF_040790805.1_ASM4079080v1_genomic	NZ_CP161191.1	15722	15344	378	renamed_GCF_000008685.2	chromosome	15716	15344	378	100.0	1.768e-79
GCF_040790805.1_ASM4079080v1_genomic	NZ_CP161191.1	15994	16804	810	renamed_GCF_000008685.2	chromosome	15994	16804	810	100.0	1.068e-173
GCF_040790805.1_ASM4079080v1_genomic	NZ_CP161191.1	42480	41439	1041	renamed_GCF_000008685.2	chromosome	42483	41442	1041	100.0	8.938e-232
GCF_040790805.1_ASM4079080v1_genomic	NZ_CP161191.1	45351	42903	2448	renamed_GCF_000008685.2	chromosome	45354	42906	2448	100.0	0.0
GCF_040790805.1_ASM4079080v1_genomic	NZ_CP161191.1	46376	46007	369	renamed_GCF_000008685.2	chromosome	46379	46010	369	100.0	3.085e-80
GCF_040790805.1_ASM4079080v1_genomic	NZ_CP161191.1	47901	48603	702	renamed_GCF_000008685.2	chromosome	47916	48606	702	100.0	4.54e-148
GCF_040790805.1_ASM4079080v1_genomic	NZ_CP161191.1	49256	48599	657	renamed_GCF_000008685.2	chromosome	49259	48602	657	100.0	2.137e-140
GCF_040790805.1_ASM4079080v1_genomic	NZ_CP161191.1	60036	59097	939	renamed_GCF_000008685.2	chromosome	60039	59100	939	100.0	4.091e-206
GCF_040790805.1_ASM4079080v1_genomic	NZ_CP161191.1	63143	64025	882	renamed_GCF_000008685.2	chromosome	63146	64028	882	100.0	1.369e-191
GCF_040790805.1_ASM4079080v1_genomic	NZ_CP161191.1	65287	65749	462	renamed_GCF_000008685.2	chromosome	65290	65752	462	100.0	3.193e-95
GCF_040790805.1_ASM4079080v1_genomic	NZ_CP161191.1	67244	69566	2322	renamed_GCF_000008685.2	chromosome	67247	69569	2322	100.0	0.0
GCF_040790805.1_ASM4079080v1_genomic	NZ_CP161191.1	101367	100773	594	renamed_GCF_000008685.2	chromosome	101339	100745	594	100.0	6.255e-135
GCF_040790805.1_ASM4079080v1_genomic	NZ_CP161191.1	151002	152208	1206	renamed_GCF_000008685.2	chromosome	150973	152179	1206	100.0	4.93e-275
GCF_040790805.1_ASM4079080v1_genomic	NZ_CP161191.1	153715	153103	612	renamed_GCF_000008685.2	chromosome	153686	153074	612	100.0	4.712e-141
GCF_040790805.1_ASM4079080v1_genomic	NZ_CP161191.1	156490	157627	1137	renamed_GCF_000008685.2	chromosome	156461	157598	1137	100.0	1.164e-253
GCF_040790805.1_ASM4079080v1_genomic	NZ_CP161191.1	158086	158503	417	renamed_GCF_000008685.2	chromosome	158075	158474	417	100.0	2.72e-81
GCF_040790805.1_ASM4079080v1_genomic	NZ_CP161191.1	182831	181436	1395	renamed_GCF_000008685.2	chromosome	182802	181407	1395	100.0	4.219e-300
GCF_040790805.1_ASM4079080v1_genomic	NZ_CP161191.1	186582	186975	393	renamed_GCF_000008685.2	chromosome	186553	186946	393	100.0	5.626e-86
GCF_040790805.1_ASM4079080v1_genomic	NZ_CP161191.1	187860	187206	654	renamed_GCF_000008685.2	chromosome	187831	187177	654	100.0	1.397e-144
GCF_040790805.1_ASM4079080v1_genomic	NZ_CP161191.1	188523	188262	261	renamed_GCF_000008685.2	chromosome	188494	188233	261	100.0	7.054e-54
GCF_040790805.1_ASM4079080v1_genomic	NZ_CP161191.1	263206	265333	2127	renamed_GCF_000008685.2	chromosome	263987	266114	2127	100.0	0.0
GCF_040790805.1_ASM4079080v1_genomic	NZ_CP161191.1	266284	266494	210	renamed_GCF_000008685.2	chromosome	267065	267275	210	100.0	4.647e-42
GCF_040790805.1_ASM4079080v1_genomic	NZ_CP161191.1	269692	268891	801	renamed_GCF_000008685.2	chromosome	270473	269672	801	100.0	6.66e-169
GCF_040790805.1_ASM4079080v1_genomic	NZ_CP161191.1	272866	271852	1014	renamed_GCF_000008685.2	chromosome	273647	272633	1014	100.0	5.532e-224
GCF_040790805.1_ASM4079080v1_genomic	NZ_CP161191.1	293999	292670	1329	renamed_GCF_000008685.2	chromosome	294780	293451	1329	100.0	2.397e-295
GCF_040790805.1_ASM4079080v1_genomic	NZ_CP161191.1	294447	294003	444	renamed_GCF_000008685.2	chromosome	295228	294784	444	100.0	1.185e-94
GCF_040790805.1_ASM4079080v1_genomic	NZ_CP161191.1	295639	294460	1179	renamed_GCF_000008685.2	chromosome	296420	295241	1179	100.0	1.072e-261
GCF_040790805.1_ASM4079080v1_genomic	NZ_CP161191.1	296264	295646	618	renamed_GCF_000008685.2	chromosome	297045	296427	618	100.0	5.47e-132
GCF_040790805.1_ASM4079080v1_genomic	NZ_CP161191.1	296688	296256	432	renamed_GCF_000008685.2	chromosome	297469	297037	432	100.0	1.974e-95
GCF_040790805.1_ASM4079080v1_genomic	NZ_CP161191.1	416956	417568	612	renamed_GCF_000008685.2	chromosome	417723	418335	612	100.0	3.097e-137
GCF_040790805.1_ASM4079080v1_genomic	NZ_CP161191.1	427880	428909	1029	renamed_GCF_000008685.2	chromosome	428645	429674	1029	100.0	3.872e-239
GCF_040790805.1_ASM4079080v1_genomic	NZ_CP161191.1	429851	428927	924	renamed_GCF_000008685.2	chromosome	430616	429692	924	100.0	4.275e-203
GCF_040790805.1_ASM4079080v1_genomic	NZ_CP161191.1	434338	429853	4485	renamed_GCF_000008685.2	chromosome	435103	430618	4485	100.0	0.0
GCF_040790805.1_ASM4079080v1_genomic	NZ_CP161191.1	438542	437702	840	renamed_GCF_000008685.2	chromosome	442552	441712	840	100.0	1.361e-184
GCF_040790805.1_ASM4079080v1_genomic	NZ_CP161191.1	439238	438677	561	renamed_GCF_000008685.2	chromosome	443248	442687	561	100.0	1.054e-123
GCF_040790805.1_ASM4079080v1_genomic	NZ_CP161191.1	442865	442316	549	renamed_GCF_000008685.2	chromosome	446875	446326	549	100.0	4.738e-122
GCF_040790805.1_ASM4079080v1_genomic	NZ_CP161191.1	443750	442958	792	renamed_GCF_000008685.2	chromosome	447736	446968	792	99.6	3.782e-165
GCF_040790805.1_ASM4079080v1_genomic	NZ_CP161191.1	443844	444162	318	renamed_GCF_000008685.2	chromosome	447854	448172	318	100.0	8.883e-69
GCF_040790805.1_ASM4079080v1_genomic	NZ_CP161191.1	478048	477334	714	renamed_GCF_000008685.2	chromosome	482057	481343	714	100.0	3.944e-160
GCF_040790805.1_ASM4079080v1_genomic	NZ_CP161191.1	499883	500069	186	renamed_GCF_000008685.2	chromosome	502755	502941	186	100.0	7.664e-41
GCF_040790805.1_ASM4079080v1_genomic	NZ_CP161191.1	500078	500477	399	renamed_GCF_000008685.2	chromosome	502950	503349	399	100.0	3.071e-85
GCF_040790805.1_ASM4079080v1_genomic	NZ_CP161191.1	500493	501036	543	renamed_GCF_000008685.2	chromosome	503365	503908	543	100.0	7.636e-116
GCF_040790805.1_ASM4079080v1_genomic	NZ_CP161191.1	501053	501413	360	renamed_GCF_000008685.2	chromosome	503925	504285	360	100.0	4.361e-75
GCF_040790805.1_ASM4079080v1_genomic	NZ_CP161191.1	501425	501923	498	renamed_GCF_000008685.2	chromosome	504297	504795	498	100.0	1.785e-107
GCF_040790805.1_ASM4079080v1_genomic	NZ_CP161191.1	501926	502232	306	renamed_GCF_000008685.2	chromosome	504798	505104	306	100.0	1.468e-61
GCF_040790805.1_ASM4079080v1_genomic	NZ_CP161191.1	502231	502669	438	renamed_GCF_000008685.2	chromosome	505103	505541	438	100.0	1.186e-93
GCF_040790805.1_ASM4079080v1_genomic	NZ_CP161191.1	502681	503986	1305	renamed_GCF_000008685.2	chromosome	505553	506858	1305	100.0	4.133e-285
GCF_040790805.1_ASM4079080v1_genomic	NZ_CP161191.1	503998	504112	114	renamed_GCF_000008685.2	chromosome	506864	506984	114	100.0	7.638e-22
GCF_040790805.1_ASM4079080v1_genomic	NZ_CP161191.1	504129	504507	378	renamed_GCF_000008685.2	chromosome	507001	507379	378	100.0	8.763e-79
GCF_040790805.1_ASM4079080v1_genomic	NZ_CP161191.1	513616	520117	6501	renamed_GCF_000008685.2	chromosome	516492	522993	6501	100.0	0.0
GCF_040790805.1_ASM4079080v1_genomic	NZ_CP161191.1	521677	523378	1701	renamed_GCF_000008685.2	chromosome	524553	526254	1701	100.0	0.0
GCF_040790805.1_ASM4079080v1_genomic	NZ_CP161191.1	526321	525226	1095	renamed_GCF_000008685.2	chromosome	529198	528103	1095	100.0	3.934e-250
GCF_040790805.1_ASM4079080v1_genomic	NZ_CP161191.1	528228	526320	1908	renamed_GCF_000008685.2	chromosome	531105	529197	1908	100.0	0.0
GCF_040790805.1_ASM4079080v1_genomic	NZ_CP161191.1	528815	528251	564	renamed_GCF_000008685.2	chromosome	531692	531128	564	100.0	2.704e-122
GCF_040790805.1_ASM4079080v1_genomic	NZ_CP161191.1	599496	600852	1356	renamed_GCF_000008685.2	chromosome	602373	603729	1356	100.0	2.305e-300
GCF_040790805.1_ASM4079080v1_genomic	NZ_CP161191.1	615682	613534	2148	renamed_GCF_000008685.2	chromosome	618559	616411	2148	100.0	0.0
GCF_040790805.1_ASM4079080v1_genomic	NZ_CP161191.1	615950	618158	2208	renamed_GCF_000008685.2	chromosome	618827	621035	2208	100.0	0.0
GCF_040790805.1_ASM4079080v1_genomic	NZ_CP161191.1	619076	618167	909	renamed_GCF_000008685.2	chromosome	621953	621044	909	100.0	1.521e-203
GCF_040790805.1_ASM4079080v1_genomic	NZ_CP161191.1	619127	620570	1443	renamed_GCF_000008685.2	chromosome	622004	623447	1443	100.0	0.0
GCF_040790805.1_ASM4079080v1_genomic	NZ_CP161191.1	620573	622130	1557	renamed_GCF_000008685.2	chromosome	623450	625007	1557	100.0	0.0
GCF_040790805.1_ASM4079080v1_genomic	NZ_CP161191.1	622129	623383	1254	renamed_GCF_000008685.2	chromosome	625006	626260	1254	100.0	1.925e-276
GCF_040790805.1_ASM4079080v1_genomic	NZ_CP161191.1	623408	624161	753	renamed_GCF_000008685.2	chromosome	626285	627038	753	100.0	9.23e-166
GCF_040790805.1_ASM4079080v1_genomic	NZ_CP161191.1	626071	624214	1857	renamed_GCF_000008685.2	chromosome	628948	627091	1857	100.0	0.0
GCF_040790805.1_ASM4079080v1_genomic	NZ_CP161191.1	627821	626318	1503	renamed_GCF_000008685.2	chromosome	630698	629195	1503	100.0	0.0
GCF_040790805.1_ASM4079080v1_genomic	NZ_CP161191.1	627891	629109	1218	renamed_GCF_000008685.2	chromosome	630795	631986	1218	99.7	8.847e-262
GCF_040790805.1_ASM4079080v1_genomic	NZ_CP161191.1	629113	629605	492	renamed_GCF_000008685.2	chromosome	631990	632482	492	100.0	1.786e-106
GCF_040790805.1_ASM4079080v1_genomic	NZ_CP161191.1	629607	631587	1980	renamed_GCF_000008685.2	chromosome	632484	634464	1980	100.0	0.0
GCF_040790805.1_ASM4079080v1_genomic	NZ_CP161191.1	631703	633134	1431	renamed_GCF_000008685.2	chromosome	634580	636011	1431	100.0	1.295e-319
GCF_040790805.1_ASM4079080v1_genomic	NZ_CP161191.1	633714	635079	1365	renamed_GCF_000008685.2	chromosome	636592	637957	1365	100.0	3.184e-298
GCF_040790805.1_ASM4079080v1_genomic	NZ_CP161191.1	635084	635678	594	renamed_GCF_000008685.2	chromosome	637971	638556	594	100.0	1.47e-125
GCF_040790805.1_ASM4079080v1_genomic	NZ_CP161191.1	635701	636994	1293	renamed_GCF_000008685.2	chromosome	638579	639872	1293	100.0	3.129e-286
GCF_040790805.1_ASM4079080v1_genomic	NZ_CP161191.1	636962	639371	2409	renamed_GCF_000008685.2	chromosome	639858	642249	2409	100.0	0.0
GCF_040790805.1_ASM4079080v1_genomic	NZ_CP161191.1	639410	639563	153	renamed_GCF_000008685.2	chromosome	642288	642441	153	100.0	5.64e-31
GCF_040790805.1_ASM4079080v1_genomic	NZ_CP161191.1	640248	639621	627	renamed_GCF_000008685.2	chromosome	643126	642499	627	100.0	8.735e-137
GCF_040790805.1_ASM4079080v1_genomic	NZ_CP161191.1	641772	640416	1356	renamed_GCF_000008685.2	chromosome	644650	643294	1356	100.0	1.597e-304
GCF_040790805.1_ASM4079080v1_genomic	NZ_CP161191.1	641893	642262	369	renamed_GCF_000008685.2	chromosome	644771	645140	369	100.0	1.529e-79
GCF_040790805.1_ASM4079080v1_genomic	NZ_CP161191.1	642723	642258	465	renamed_GCF_000008685.2	chromosome	645601	645136	465	100.0	4.176e-101
GCF_040790805.1_ASM4079080v1_genomic	NZ_CP161191.1	642840	643803	963	renamed_GCF_000008685.2	chromosome	645718	646681	963	100.0	1.162e-215
GCF_040790805.1_ASM4079080v1_genomic	NZ_CP161191.1	645448	643780	1668	renamed_GCF_000008685.2	chromosome	648254	646658	1668	100.0	0.0
GCF_040790805.1_ASM4079080v1_genomic	NZ_CP161191.1	645674	646229	555	renamed_GCF_000008685.2	chromosome	648552	649107	555	100.0	3.12e-119
GCF_040790805.1_ASM4079080v1_genomic	NZ_CP161191.1	647509	646291	1218	renamed_GCF_000008685.2	chromosome	650387	649169	1218	100.0	2.758e-266
GCF_040790805.1_ASM4079080v1_genomic	NZ_CP161191.1	650912	647534	3378	renamed_GCF_000008685.2	chromosome	653790	650412	3378	100.0	0.0
GCF_040790805.1_ASM4079080v1_genomic	NZ_CP161191.1	651008	651971	963	renamed_GCF_000008685.2	chromosome	653886	654849	963	100.0	5.23e-216
GCF_040790805.1_ASM4079080v1_genomic	NZ_CP161191.1	651930	654024	2094	renamed_GCF_000008685.2	chromosome	654862	656902	2094	99.8	0.0
GCF_040790805.1_ASM4079080v1_genomic	NZ_CP161191.1	656019	656745	726	renamed_GCF_000008685.2	chromosome	658897	659623	726	100.0	3.429e-155
GCF_040790805.1_ASM4079080v1_genomic	NZ_CP161191.1	658637	656765	1872	renamed_GCF_000008685.2	chromosome	661515	659643	1872	100.0	0.0
GCF_040790805.1_ASM4079080v1_genomic	NZ_CP161191.1	658727	659651	924	renamed_GCF_000008685.2	chromosome	661605	662529	924	100.0	4.691e-202
GCF_040790805.1_ASM4079080v1_genomic	NZ_CP161191.1	660039	659724	315	renamed_GCF_000008685.2	chromosome	662917	662602	315	100.0	5.657e-65
GCF_040790805.1_ASM4079080v1_genomic	NZ_CP161191.1	662133	660300	1833	renamed_GCF_000008685.2	chromosome	665011	663178	1833	100.0	0.0
GCF_040790805.1_ASM4079080v1_genomic	NZ_CP161191.1	665639	662129	3510	renamed_GCF_000008685.2	chromosome	668517	665007	3510	100.0	0.0
GCF_040790805.1_ASM4079080v1_genomic	NZ_CP161191.1	670333	668887	1446	renamed_GCF_000008685.2	chromosome	673167	671766	1446	100.0	1.676e-310
GCF_040790805.1_ASM4079080v1_genomic	NZ_CP161191.1	670462	671899	1437	renamed_GCF_000008685.2	chromosome	673341	674778	1437	100.0	0.0
GCF_040790805.1_ASM4079080v1_genomic	NZ_CP161191.1	672155	673499	1344	renamed_GCF_000008685.2	chromosome	675034	676378	1344	100.0	3.635e-293
GCF_040790805.1_ASM4079080v1_genomic	NZ_CP161191.1	673592	674981	1389	renamed_GCF_000008685.2	chromosome	676471	677860	1389	100.0	1.442e-302
GCF_040790805.1_ASM4079080v1_genomic	NZ_CP161191.1	676059	675012	1047	renamed_GCF_000008685.2	chromosome	678938	677891	1047	100.0	5.633e-238
GCF_040790805.1_ASM4079080v1_genomic	NZ_CP161191.1	676871	676079	792	renamed_GCF_000008685.2	chromosome	679750	678958	792	100.0	1.55e-166
GCF_040790805.1_ASM4079080v1_genomic	NZ_CP161191.1	677684	676874	810	renamed_GCF_000008685.2	chromosome	680557	679753	810	99.6	5.278e-173
GCF_040790805.1_ASM4079080v1_genomic	NZ_CP161191.1	678727	677683	1044	renamed_GCF_000008685.2	chromosome	681606	680562	1044	100.0	8.539e-233
GCF_040790805.1_ASM4079080v1_genomic	NZ_CP161191.1	679645	678805	840	renamed_GCF_000008685.2	chromosome	682524	681684	840	100.0	1.641e-182
GCF_040790805.1_ASM4079080v1_genomic	NZ_CP161191.1	679799	680498	699	renamed_GCF_000008685.2	chromosome	682678	683377	699	100.0	1.337e-152
GCF_040790805.1_ASM4079080v1_genomic	NZ_CP161191.1	680543	682088	1545	renamed_GCF_000008685.2	chromosome	683422	684967	1545	99.8	0.0
GCF_040790805.1_ASM4079080v1_genomic	NZ_CP161191.1	683101	682117	984	renamed_GCF_000008685.2	chromosome	685980	684996	984	100.0	1.708e-223
GCF_040790805.1_ASM4079080v1_genomic	NZ_CP161191.1	683628	683097	531	renamed_GCF_000008685.2	chromosome	686507	685976	531	99.4	2.343e-118
GCF_040790805.1_ASM4079080v1_genomic	NZ_CP161191.1	685610	687248	1638	renamed_GCF_000008685.2	chromosome	688489	690127	1638	100.0	0.0
GCF_040790805.1_ASM4079080v1_genomic	NZ_CP161191.1	687313	687610	297	renamed_GCF_000008685.2	chromosome	690192	690489	297	100.0	1.037e-63
GCF_040790805.1_ASM4079080v1_genomic	NZ_CP161191.1	687623	687920	297	renamed_GCF_000008685.2	chromosome	690481	690799	297	98.9	6.955e-60
GCF_040790805.1_ASM4079080v1_genomic	NZ_CP161191.1	688005	689766	1761	renamed_GCF_000008685.2	chromosome	690884	692645	1761	100.0	0.0
GCF_040790805.1_ASM4079080v1_genomic	NZ_CP161191.1	689749	690649	900	renamed_GCF_000008685.2	chromosome	692628	693528	900	100.0	8.957e-191
GCF_040790805.1_ASM4079080v1_genomic	NZ_CP161191.1	690838	691840	1002	renamed_GCF_000008685.2	chromosome	693553	694696	1002	99.6	2.064e-224
GCF_040790805.1_ASM4079080v1_genomic	NZ_CP161191.1	692667	691836	831	renamed_GCF_000008685.2	chromosome	695523	694692	831	100.0	5.839e-184
GCF_040790805.1_ASM4079080v1_genomic	NZ_CP161191.1	692774	693908	1134	renamed_GCF_000008685.2	chromosome	695630	696764	1134	100.0	1.419e-259
GCF_040790805.1_ASM4079080v1_genomic	NZ_CP161191.1	694581	693894	687	renamed_GCF_000008685.2	chromosome	697437	696750	687	100.0	2.97e-150
GCF_040790805.1_ASM4079080v1_genomic	NZ_CP161191.1	694729	695476	747	renamed_GCF_000008685.2	chromosome	697585	698332	747	100.0	1.547e-167
GCF_040790805.1_ASM4079080v1_genomic	NZ_CP161191.1	697109	695543	1566	renamed_GCF_000008685.2	chromosome	699965	698399	1566	100.0	0.0
GCF_040790805.1_ASM4079080v1_genomic	NZ_CP161191.1	698068	697195	873	renamed_GCF_000008685.2	chromosome	700924	700051	873	100.0	5.874e-191
GCF_040790805.1_ASM4079080v1_genomic	NZ_CP161191.1	698172	698529	357	renamed_GCF_000008685.2	chromosome	701028	701385	357	100.0	2.301e-81
GCF_040790805.1_ASM4079080v1_genomic	NZ_CP161191.1	698538	698949	411	renamed_GCF_000008685.2	chromosome	701394	701805	411	100.0	2.78e-88
GCF_040790805.1_ASM4079080v1_genomic	NZ_CP161191.1	698968	699418	450	renamed_GCF_000008685.2	chromosome	701824	702274	450	100.0	9.762e-98
GCF_040790805.1_ASM4079080v1_genomic	NZ_CP161191.1	700110	699426	684	renamed_GCF_000008685.2	chromosome	702951	702282	684	100.0	4.537e-145
GCF_040790805.1_ASM4079080v1_genomic	NZ_CP161191.1	700152	701112	960	renamed_GCF_000008685.2	chromosome	703008	703968	960	100.0	6.008e-214
GCF_040790805.1_ASM4079080v1_genomic	NZ_CP161191.1	701074	702103	1029	renamed_GCF_000008685.2	chromosome	703960	704959	1029	99.6	3.451e-223
GCF_040790805.1_ASM4079080v1_genomic	NZ_CP161191.1	702092	702644	552	renamed_GCF_000008685.2	chromosome	704948	705500	552	100.0	2.458e-121
GCF_040790805.1_ASM4079080v1_genomic	NZ_CP161191.1	702723	703749	1026	renamed_GCF_000008685.2	chromosome	705579	706605	1026	100.0	2.737e-225
GCF_040790805.1_ASM4079080v1_genomic	NZ_CP161191.1	703816	706411	2595	renamed_GCF_000008685.2	chromosome	706672	709267	2595	100.0	0.0
GCF_040790805.1_ASM4079080v1_genomic	NZ_CP161191.1	706417	707818	1401	renamed_GCF_000008685.2	chromosome	709273	710674	1401	100.0	3.758e-311
GCF_040790805.1_ASM4079080v1_genomic	NZ_CP161191.1	707829	708315	486	renamed_GCF_000008685.2	chromosome	710685	711171	486	100.0	5.304e-102
GCF_040790805.1_ASM4079080v1_genomic	NZ_CP161191.1	708354	708795	441	renamed_GCF_000008685.2	chromosome	711210	711651	441	100.0	1.245e-93
GCF_040790805.1_ASM4079080v1_genomic	NZ_CP161191.1	709351	708835	516	renamed_GCF_000008685.2	chromosome	712207	711691	516	100.0	1.621e-111
GCF_040790805.1_ASM4079080v1_genomic	NZ_CP161191.1	710394	709347	1047	renamed_GCF_000008685.2	chromosome	713250	712203	1047	100.0	1.709e-225
GCF_040790805.1_ASM4079080v1_genomic	NZ_CP161191.1	711251	710387	864	renamed_GCF_000008685.2	chromosome	714107	713243	864	100.0	1.134e-190
GCF_040790805.1_ASM4079080v1_genomic	NZ_CP161191.1	711910	711247	663	renamed_GCF_000008685.2	chromosome	714766	714103	663	100.0	1.333e-146
GCF_040790805.1_ASM4079080v1_genomic	NZ_CP161191.1	712152	713763	1611	renamed_GCF_000008685.2	chromosome	715008	716619	1611	100.0	0.0
GCF_040790805.1_ASM4079080v1_genomic	NZ_CP161191.1	735549	735915	366	renamed_GCF_000008685.2	chromosome	738405	738771	366	100.0	9.695e-76
GCF_040790805.1_ASM4079080v1_genomic	NZ_CP161191.1	736287	736827	540	renamed_GCF_000008685.2	chromosome	739143	739683	540	100.0	2.458e-119
GCF_040790805.1_ASM4079080v1_genomic	NZ_CP161191.1	736828	737320	492	renamed_GCF_000008685.2	chromosome	739684	740176	492	100.0	4.374e-105
GCF_040790805.1_ASM4079080v1_genomic	NZ_CP161191.1	737383	737566	183	renamed_GCF_000008685.2	chromosome	740239	740422	183	100.0	1.805e-39
GCF_040790805.1_ASM4079080v1_genomic	NZ_CP161191.1	737589	737832	243	renamed_GCF_000008685.2	chromosome	740445	740688	243	100.0	1.755e-49
GCF_040790805.1_ASM4079080v1_genomic	NZ_CP161191.1	737831	738569	738	renamed_GCF_000008685.2	chromosome	740687	741425	738	100.0	4.772e-162
GCF_040790805.1_ASM4079080v1_genomic	NZ_CP161191.1	739772	738539	1233	renamed_GCF_000008685.2	chromosome	742628	741395	1233	100.0	3.707e-274
GCF_040790805.1_ASM4079080v1_genomic	NZ_CP161191.1	739887	741660	1773	renamed_GCF_000008685.2	chromosome	742743	744516	1773	100.0	0.0
GCF_040790805.1_ASM4079080v1_genomic	NZ_CP161191.1	741665	741989	324	renamed_GCF_000008685.2	chromosome	744521	744845	324	100.0	1.32e-65
GCF_040790805.1_ASM4079080v1_genomic	NZ_CP161191.1	768284	766691	1593	renamed_GCF_000008685.2	chromosome	771139	769546	1593	100.0	0.0
GCF_040790805.1_ASM4079080v1_genomic	NZ_CP161191.1	818339	819524	1185	renamed_GCF_000008685.2	chromosome	821184	822369	1185	100.0	1.177e-261
GCF_040790805.1_ASM4079080v1_genomic	NZ_CP161191.1	819498	819849	351	renamed_GCF_000008685.2	chromosome	822343	822694	351	100.0	6.889e-77
GCF_040790805.1_ASM4079080v1_genomic	NZ_CP161191.1	819964	820258	294	renamed_GCF_000008685.2	chromosome	822809	823103	294	100.0	1.207e-61
GCF_040790805.1_ASM4079080v1_genomic	NZ_CP161191.1	820417	820966	549	renamed_GCF_000008685.2	chromosome	823262	823811	549	100.0	1.698e-116
GCF_040790805.1_ASM4079080v1_genomic	NZ_CP161191.1	820970	821537	567	renamed_GCF_000008685.2	chromosome	823815	824382	567	100.0	1.275e-122
GCF_040790805.1_ASM4079080v1_genomic	NZ_CP161191.1	821536	822859	1323	renamed_GCF_000008685.2	chromosome	824381	825704	1323	100.0	8.966e-297
GCF_040790805.1_ASM4079080v1_genomic	NZ_CP161191.1	822855	824775	1920	renamed_GCF_000008685.2	chromosome	825700	827620	1920	100.0	0.0
GCF_040790805.1_ASM4079080v1_genomic	NZ_CP161191.1	824785	826267	1482	renamed_GCF_000008685.2	chromosome	827630	829112	1482	100.0	0.0
GCF_040790805.1_ASM4079080v1_genomic	NZ_CP161191.1	826372	827476	1104	renamed_GCF_000008685.2	chromosome	829217	830321	1104	100.0	4.529e-250
GCF_040790805.1_ASM4079080v1_genomic	NZ_CP161191.1	883603	881383	2220	renamed_GCF_000008685.2	chromosome	886447	884227	2220	100.0	0.0
GCF_040790805.1_ASM4079080v1_genomic	NZ_CP161199.1	6676	7714	1038	renamed_GCF_000008685.2	cp26	6676	7714	1038	100.0	8.529e-232
GCF_040790805.1_ASM4079080v1_genomic	NZ_CP161199.1	7835	8765	930	renamed_GCF_000008685.2	cp26	7835	8765	930	100.0	7.897e-206
GCF_040790805.1_ASM4079080v1_genomic	NZ_CP161199.1	9274	10036	762	renamed_GCF_000008685.2	cp26	9274	10036	762	100.0	1.063e-165
GCF_040790805.1_ASM4079080v1_genomic	NZ_CP161199.1	10103	10652	549	renamed_GCF_000008685.2	cp26	10103	10652	549	100.0	6.94e-118
GCF_040790805.1_ASM4079080v1_genomic	NZ_CP161199.1	11417	10919	498	renamed_GCF_000008685.2	cp26	11417	10919	498	100.0	3.608e-108
GCF_040790805.1_ASM4079080v1_genomic	NZ_CP161199.1	12013	13606	1593	renamed_GCF_000008685.2	cp26	12013	13606	1593	100.0	0.0
GCF_040790805.1_ASM4079080v1_genomic	NZ_CP161199.1	15107	13892	1215	renamed_GCF_000008685.2	cp26	15107	13892	1215	100.0	5.333e-267
GCF_040790805.1_ASM4079080v1_genomic	NZ_CP161199.1	16667	15131	1536	renamed_GCF_000008685.2	cp26	16667	15131	1536	100.0	0.0
GCF_040790805.1_ASM4079080v1_genomic	NZ_CP161201.1	8891	9317	426	renamed_GCF_000008685.2	cp32-3	25068	25494	426	100.0	3.62e-96
GCF_040790805.1_ASM4079080v1_genomic	NZ_CP161195.1	22829	24155	1326	renamed_GCF_000008685.2	cp32-4	22830	24156	1326	100.0	6.506e-301
GCF_040790805.1_ASM4079080v1_genomic	NZ_CP161195.1	24208	24634	426	renamed_GCF_000008685.2	cp32-4	24209	24635	426	100.0	8.056e-96
GCF_040790805.1_ASM4079080v1_genomic	NZ_CP161195.1	25434	24639	795	renamed_GCF_000008685.2	cp32-4	25435	24640	795	100.0	5.809e-178
GCF_040790805.1_ASM4079080v1_genomic	NZ_CP161195.1	26003	26819	816	renamed_GCF_000008685.2	cp32-4	26004	26820	816	100.0	2.075e-184
GCF_040790805.1_ASM4079080v1_genomic	NZ_CP161195.1	26851	27526	675	renamed_GCF_000008685.2	cp32-4	26852	27527	675	100.0	3.937e-145
GCF_040790805.1_ASM4079080v1_genomic	NZ_CP161195.1	27674	28202	528	renamed_GCF_000008685.2	cp32-4	27675	28203	528	100.0	1.105e-117
GCF_040790805.1_ASM4079080v1_genomic	NZ_CP161195.1	28382	28949	567	renamed_GCF_000008685.2	cp32-4	28383	28950	567	100.0	1.275e-122
GCF_040790805.1_ASM4079080v1_genomic	NZ_CP161194.1	5767	6157	390	renamed_GCF_000008685.2	cp32-9	5783	6173	390	100.0	3.229e-83
GCF_040790805.1_ASM4079080v1_genomic	NZ_CP161194.1	12823	13699	876	renamed_GCF_000008685.2	cp32-8	12823	13699	876	100.0	1.247e-191
GCF_040790805.1_ASM4079080v1_genomic	NZ_CP161194.1	13708	14314	606	renamed_GCF_000008685.2	cp32-8	13708	14314	606	100.0	5.47e-130
GCF_040790805.1_ASM4079080v1_genomic	NZ_CP161194.1	14323	15139	816	renamed_GCF_000008685.2	cp32-8	14323	15139	816	100.0	1.636e-178
GCF_040790805.1_ASM4079080v1_genomic	NZ_CP161194.1	15214	15418	204	renamed_GCF_000008685.2	cp32-1	15214	15418	204	100.0	2.578e-39
GCF_040790805.1_ASM4079080v1_genomic	NZ_CP161194.1	15421	15769	348	renamed_GCF_000008685.2	cp32-1	15421	15769	348	100.0	3.962e-74
GCF_040790805.1_ASM4079080v1_genomic	NZ_CP161194.1	15758	16094	336	renamed_GCF_000008685.2	cp32-1	15758	16094	336	100.0	2.402e-69
GCF_040790805.1_ASM4079080v1_genomic	NZ_CP161194.1	16086	16440	354	renamed_GCF_000008685.2	cp32-1	16086	16440	354	100.0	6.554e-78
GCF_040790805.1_ASM4079080v1_genomic	NZ_CP161194.1	17060	16577	483	renamed_GCF_000008685.2	cp32-1	17060	16577	483	100.0	5.056e-102
GCF_040790805.1_ASM4079080v1_genomic	NZ_CP161194.1	17231	17678	447	renamed_GCF_000008685.2	cp32-1	17231	17678	447	100.0	3.796e-99
GCF_040790805.1_ASM4079080v1_genomic	NZ_CP161196.1	14560	13795	765	renamed_GCF_000008685.2	lp28-1	13793	13028	765	100.0	1.871e-168
GCF_040790805.1_ASM4079080v1_genomic	NZ_CP161196.1	28918	29986	1068	renamed_GCF_000008685.2	lp28-1	26996	28073	1068	93.5	2.512e-207
GCF_040790805.1_ASM4079080v1_genomic	NZ_CP161197.1	224	1118	894	renamed_GCF_000008685.2	lp28-2	115	1009	894	100.0	3.048e-193
GCF_040790805.1_ASM4079080v1_genomic	NZ_CP161197.1	1155	2037	882	renamed_GCF_000008685.2	lp28-2	1046	1928	882	100.0	1.741e-197
GCF_040790805.1_ASM4079080v1_genomic	NZ_CP161191.1	178889	177896	993	renamed_GCF_000008685.2	chromosome	178860	177867	993	100.0	4.528e-214
GCF_040790805.1_ASM4079080v1_genomic	NZ_CP161191.1	181434	179568	1866	renamed_GCF_000008685.2	chromosome	181405	179539	1866	100.0	0.0
GCF_040790805.1_ASM4079080v1_genomic	NZ_CP161191.1	189888	189327	561	renamed_GCF_000008685.2	chromosome	189859	189298	561	100.0	1.275e-121
GCF_040790805.1_ASM4079080v1_genomic	NZ_CP161191.1	190747	191488	741	renamed_GCF_000008685.2	chromosome	190718	191459	741	100.0	7.281e-158
GCF_040790805.1_ASM4079080v1_genomic	NZ_CP161191.1	193492	192352	1140	renamed_GCF_000008685.2	chromosome	193463	192323	1140	100.0	4.164e-257
GCF_040790805.1_ASM4079080v1_genomic	NZ_CP161191.1	195721	197725	2004	renamed_GCF_000008685.2	chromosome	195692	197696	2004	100.0	0.0
GCF_040790805.1_ASM4079080v1_genomic	NZ_CP161191.1	201079	199993	1086	renamed_GCF_000008685.2	chromosome	201050	199964	1086	100.0	2.679e-244
GCF_040790805.1_ASM4079080v1_genomic	NZ_CP161191.1	202878	204117	1239	renamed_GCF_000008685.2	chromosome	202849	204088	1239	99.7	6.044e-261
GCF_040790805.1_ASM4079080v1_genomic	NZ_CP161191.1	206557	208135	1578	renamed_GCF_000008685.2	chromosome	206528	208106	1578	100.0	0.0
GCF_040790805.1_ASM4079080v1_genomic	NZ_CP161191.1	208649	208112	537	renamed_GCF_000008685.2	chromosome	208581	208083	537	98.7	7.373e-107
GCF_040790805.1_ASM4079080v1_genomic	NZ_CP161191.1	254864	255479	615	renamed_GCF_000008685.2	chromosome	255645	256260	615	100.0	1.16e-131
GCF_040790805.1_ASM4079080v1_genomic	NZ_CP161191.1	275715	274461	1254	renamed_GCF_000008685.2	chromosome	276496	275242	1254	100.0	4.99e-283
GCF_040790805.1_ASM4079080v1_genomic	NZ_CP161191.1	277778	276308	1470	renamed_GCF_000008685.2	chromosome	278559	277089	1470	100.0	8.9e-322
GCF_040790805.1_ASM4079080v1_genomic	NZ_CP161191.1	278599	278296	303	renamed_GCF_000008685.2	chromosome	279380	279077	303	100.0	2.087e-65
GCF_040790805.1_ASM4079080v1_genomic	NZ_CP161191.1	281012	280532	480	renamed_GCF_000008685.2	chromosome	281793	281313	480	100.0	1.072e-101
GCF_040790805.1_ASM4079080v1_genomic	NZ_CP161191.1	283084	281917	1167	renamed_GCF_000008685.2	chromosome	283865	282698	1167	100.0	1.172e-258
GCF_040790805.1_ASM4079080v1_genomic	NZ_CP161191.1	286308	285189	1119	renamed_GCF_000008685.2	chromosome	287089	285970	1119	100.0	9.957e-244
GCF_040790805.1_ASM4079080v1_genomic	NZ_CP161191.1	287392	287128	264	renamed_GCF_000008685.2	chromosome	288173	287909	264	100.0	2.025e-51
GCF_040790805.1_ASM4079080v1_genomic	NZ_CP161191.1	289136	288794	342	renamed_GCF_000008685.2	chromosome	289917	289575	342	100.0	1.077e-70
GCF_040790805.1_ASM4079080v1_genomic	NZ_CP161191.1	291645	290862	783	renamed_GCF_000008685.2	chromosome	292426	291643	783	100.0	1.874e-171
GCF_040790805.1_ASM4079080v1_genomic	NZ_CP161191.1	319478	318899	579	renamed_GCF_000008685.2	chromosome	320249	319679	579	99.4	6.936e-123
GCF_040790805.1_ASM4079080v1_genomic	NZ_CP161191.1	320571	321258	687	renamed_GCF_000008685.2	chromosome	321351	322038	687	100.0	1.336e-150
GCF_040790805.1_ASM4079080v1_genomic	NZ_CP161191.1	322999	322066	933	renamed_GCF_000008685.2	chromosome	323779	322846	933	100.0	1.839e-205
GCF_040790805.1_ASM4079080v1_genomic	NZ_CP161191.1	325508	324455	1053	renamed_GCF_000008685.2	chromosome	326288	325235	1053	100.0	4.032e-234
GCF_040790805.1_ASM4079080v1_genomic	NZ_CP161191.1	327251	328385	1134	renamed_GCF_000008685.2	chromosome	328031	329165	1134	100.0	5.485e-253
GCF_040790805.1_ASM4079080v1_genomic	NZ_CP161191.1	344282	345584	1302	renamed_GCF_000008685.2	chromosome	345062	346364	1302	100.0	6.07e-289
GCF_040790805.1_ASM4079080v1_genomic	NZ_CP161191.1	347380	346570	810	renamed_GCF_000008685.2	chromosome	348160	347350	810	100.0	1.888e-184
GCF_040790805.1_ASM4079080v1_genomic	NZ_CP161191.1	350564	350288	276	renamed_GCF_000008685.2	chromosome	351331	351055	276	100.0	8.162e-55
GCF_040790805.1_ASM4079080v1_genomic	NZ_CP161191.1	353869	352672	1197	renamed_GCF_000008685.2	chromosome	354636	353439	1197	100.0	5.312e-264
GCF_040790805.1_ASM4079080v1_genomic	NZ_CP161191.1	388159	387739	420	renamed_GCF_000008685.2	chromosome	388926	388506	420	100.0	9.787e-93
GCF_040790805.1_ASM4079080v1_genomic	NZ_CP161191.1	391052	389627	1425	renamed_GCF_000008685.2	chromosome	391819	390391	1425	100.0	0.0
GCF_040790805.1_ASM4079080v1_genomic	NZ_CP161191.1	393296	392276	1020	renamed_GCF_000008685.2	chromosome	394063	393043	1020	99.7	3.29e-222
GCF_040790805.1_ASM4079080v1_genomic	NZ_CP161191.1	394399	393337	1062	renamed_GCF_000008685.2	chromosome	395166	394104	1062	100.0	1.904e-235
GCF_040790805.1_ASM4079080v1_genomic	NZ_CP161191.1	396310	395836	474	renamed_GCF_000008685.2	chromosome	397077	396603	474	100.0	4.822e-101
GCF_040790805.1_ASM4079080v1_genomic	NZ_CP161191.1	400910	396776	4134	renamed_GCF_000008685.2	chromosome	401677	397543	4134	100.0	0.0
GCF_040790805.1_ASM4079080v1_genomic	NZ_CP161191.1	405409	404920	489	renamed_GCF_000008685.2	chromosome	406176	405687	489	100.0	1.238e-101
GCF_040790805.1_ASM4079080v1_genomic	NZ_CP161191.1	406525	406093	432	renamed_GCF_000008685.2	chromosome	407292	406860	432	100.0	3.534e-89
GCF_040790805.1_ASM4079080v1_genomic	NZ_CP161191.1	407325	407154	171	renamed_GCF_000008685.2	chromosome	408092	407921	171	100.0	1.118e-34
GCF_040790805.1_ASM4079080v1_genomic	NZ_CP161191.1	418739	417620	1119	renamed_GCF_000008685.2	chromosome	419506	418387	1119	100.0	8.015e-255
GCF_040790805.1_ASM4079080v1_genomic	NZ_CP161191.1	489715	491080	1365	renamed_GCF_000008685.2	chromosome	492587	493952	1365	99.7	1.887e-295
GCF_040790805.1_ASM4079080v1_genomic	NZ_CP161191.1	492160	493345	1185	renamed_GCF_000008685.2	chromosome	495032	496217	1185	100.0	4.832e-263
GCF_040790805.1_ASM4079080v1_genomic	NZ_CP161191.1	493742	494363	621	renamed_GCF_000008685.2	chromosome	496614	497235	621	100.0	8.732e-136
GCF_040790805.1_ASM4079080v1_genomic	NZ_CP161191.1	495022	495319	297	renamed_GCF_000008685.2	chromosome	497894	498191	297	100.0	5.69e-62
GCF_040790805.1_ASM4079080v1_genomic	NZ_CP161191.1	496183	496462	279	renamed_GCF_000008685.2	chromosome	499055	499334	279	100.0	1.411e-57
GCF_040790805.1_ASM4079080v1_genomic	NZ_CP161191.1	496834	497716	882	renamed_GCF_000008685.2	chromosome	499706	500588	882	100.0	1.248e-192
GCF_040790805.1_ASM4079080v1_genomic	NZ_CP161191.1	498139	498340	201	renamed_GCF_000008685.2	chromosome	501014	501212	201	98.4	1.098e-39
GCF_040790805.1_ASM4079080v1_genomic	NZ_CP161191.1	498624	498993	369	renamed_GCF_000008685.2	chromosome	501496	501865	369	100.0	9.223e-77
GCF_040790805.1_ASM4079080v1_genomic	NZ_CP161191.1	499318	499867	549	renamed_GCF_000008685.2	chromosome	502190	502739	549	100.0	1.698e-116
GCF_040790805.1_ASM4079080v1_genomic	NZ_CP161191.1	504941	505976	1035	renamed_GCF_000008685.2	chromosome	507813	508848	1035	100.0	4.156e-222
GCF_040790805.1_ASM4079080v1_genomic	NZ_CP161191.1	546742	546043	699	renamed_GCF_000008685.2	chromosome	549618	548919	699	100.0	1.058e-146
GCF_040790805.1_ASM4079080v1_genomic	NZ_CP161191.1	551114	552335	1221	renamed_GCF_000008685.2	chromosome	553991	555212	1221	100.0	5.34e-268
GCF_040790805.1_ASM4079080v1_genomic	NZ_CP161191.1	565392	566262	870	renamed_GCF_000008685.2	chromosome	568269	569139	870	100.0	1.737e-195
GCF_040790805.1_ASM4079080v1_genomic	NZ_CP161191.1	566681	568403	1722	renamed_GCF_000008685.2	chromosome	569558	571280	1722	100.0	0.0
GCF_040790805.1_ASM4079080v1_genomic	NZ_CP161191.1	570863	569012	1851	renamed_GCF_000008685.2	chromosome	573740	571889	1851	100.0	0.0
GCF_040790805.1_ASM4079080v1_genomic	NZ_CP161191.1	572939	572396	543	renamed_GCF_000008685.2	chromosome	575816	575273	543	100.0	3.121e-117
GCF_040790805.1_ASM4079080v1_genomic	NZ_CP161191.1	574310	573704	606	renamed_GCF_000008685.2	chromosome	577187	576581	606	100.0	4.975e-131
GCF_040790805.1_ASM4079080v1_genomic	NZ_CP161191.1	574517	575060	543	renamed_GCF_000008685.2	chromosome	577394	577937	543	100.0	3.121e-117
GCF_040790805.1_ASM4079080v1_genomic	NZ_CP161191.1	601892	600848	1044	renamed_GCF_000008685.2	chromosome	604769	603725	1044	100.0	3.194e-235
GCF_040790805.1_ASM4079080v1_genomic	NZ_CP161191.1	604106	601901	2205	renamed_GCF_000008685.2	chromosome	606983	604778	2205	100.0	0.0
GCF_040790805.1_ASM4079080v1_genomic	NZ_CP161191.1	604260	605058	798	renamed_GCF_000008685.2	chromosome	607137	607935	798	100.0	9.72e-173
GCF_040790805.1_ASM4079080v1_genomic	NZ_CP161191.1	607029	606183	846	renamed_GCF_000008685.2	chromosome	609906	609060	846	100.0	3.324e-184
GCF_040790805.1_ASM4079080v1_genomic	NZ_CP161191.1	608316	607065	1251	renamed_GCF_000008685.2	chromosome	611193	609942	1251	100.0	7.081e-270
GCF_040790805.1_ASM4079080v1_genomic	NZ_CP161191.1	608431	609145	714	renamed_GCF_000008685.2	chromosome	611308	612022	714	100.0	1.949e-159
GCF_040790805.1_ASM4079080v1_genomic	NZ_CP161191.1	609170	611108	1938	renamed_GCF_000008685.2	chromosome	612047	613985	1938	100.0	0.0
GCF_040790805.1_ASM4079080v1_genomic	NZ_CP161191.1	612894	611136	1758	renamed_GCF_000008685.2	chromosome	615771	614013	1758	100.0	0.0
GCF_040790805.1_ASM4079080v1_genomic	NZ_CP161191.1	613513	612886	627	renamed_GCF_000008685.2	chromosome	616390	615763	627	100.0	5.736e-133
GCF_040790805.1_ASM4079080v1_genomic	NZ_CP161191.1	726756	727650	894	renamed_GCF_000008685.2	chromosome	729612	730506	894	100.0	2.531e-195
GCF_040790805.1_ASM4079080v1_genomic	NZ_CP161191.1	728243	727775	468	renamed_GCF_000008685.2	chromosome	731099	730631	468	100.0	1.969e-101
GCF_040790805.1_ASM4079080v1_genomic	NZ_CP161191.1	728327	728864	537	renamed_GCF_000008685.2	chromosome	731183	731720	537	100.0	1.936e-121
GCF_040790805.1_ASM4079080v1_genomic	NZ_CP161191.1	728937	730947	2010	renamed_GCF_000008685.2	chromosome	731793	733803	2010	100.0	0.0
GCF_040790805.1_ASM4079080v1_genomic	NZ_CP161191.1	731224	732433	1209	renamed_GCF_000008685.2	chromosome	734080	735289	1209	100.0	8.188e-270
GCF_040790805.1_ASM4079080v1_genomic	NZ_CP161191.1	732495	733830	1335	renamed_GCF_000008685.2	chromosome	735351	736686	1335	100.0	6.003e-286
GCF_040790805.1_ASM4079080v1_genomic	NZ_CP161191.1	733842	734103	261	renamed_GCF_000008685.2	chromosome	736698	736959	261	100.0	3.165e-54
GCF_040790805.1_ASM4079080v1_genomic	NZ_CP161191.1	734103	734352	249	renamed_GCF_000008685.2	chromosome	736959	737208	249	100.0	2.148e-48
GCF_040790805.1_ASM4079080v1_genomic	NZ_CP161191.1	734355	734856	501	renamed_GCF_000008685.2	chromosome	737211	737712	501	100.0	9.268e-107
GCF_040790805.1_ASM4079080v1_genomic	NZ_CP161191.1	734852	735572	720	renamed_GCF_000008685.2	chromosome	737708	738428	720	100.0	9.639e-160
GCF_040790805.1_ASM4079080v1_genomic	NZ_CP161191.1	768708	768306	402	renamed_GCF_000008685.2	chromosome	771563	771161	402	100.0	3.917e-83
GCF_040790805.1_ASM4079080v1_genomic	NZ_CP161191.1	771513	768714	2799	renamed_GCF_000008685.2	chromosome	774368	771569	2799	100.0	0.0
GCF_040790805.1_ASM4079080v1_genomic	NZ_CP161191.1	771821	772607	786	renamed_GCF_000008685.2	chromosome	774676	775462	786	100.0	1.17e-168
GCF_040790805.1_ASM4079080v1_genomic	NZ_CP161191.1	773824	772810	1014	renamed_GCF_000008685.2	chromosome	776679	775665	1014	100.0	1.623e-220
GCF_040790805.1_ASM4079080v1_genomic	NZ_CP161191.1	773929	774718	789	renamed_GCF_000008685.2	chromosome	776784	777573	789	100.0	8.439e-173
GCF_040790805.1_ASM4079080v1_genomic	NZ_CP161191.1	774909	775899	990	renamed_GCF_000008685.2	chromosome	777764	778754	990	100.0	1.559e-225
GCF_040790805.1_ASM4079080v1_genomic	NZ_CP161191.1	775902	778530	2628	renamed_GCF_000008685.2	chromosome	778757	781385	2628	100.0	0.0
GCF_040790805.1_ASM4079080v1_genomic	NZ_CP161191.1	779974	779296	678	renamed_GCF_000008685.2	chromosome	782829	782151	678	100.0	4.744e-152
GCF_040790805.1_ASM4079080v1_genomic	NZ_CP161191.1	780393	780120	273	renamed_GCF_000008685.2	chromosome	783248	782975	273	100.0	3.858e-54
GCF_040790805.1_ASM4079080v1_genomic	NZ_CP161191.1	798155	798923	768	renamed_GCF_000008685.2	chromosome	801118	801778	768	99.5	4.938e-141
GCF_040790805.1_ASM4079080v1_genomic	NZ_CP161191.1	800313	799983	330	renamed_GCF_000008685.2	chromosome	803167	802837	330	100.0	2.178e-69
GCF_040790805.1_ASM4079080v1_genomic	NZ_CP161191.1	805112	804065	1047	renamed_GCF_000008685.2	chromosome	807966	806919	1047	100.0	5.315e-230
GCF_040790805.1_ASM4079080v1_genomic	NZ_CP161191.1	806698	805606	1092	renamed_GCF_000008685.2	chromosome	809552	808460	1092	100.0	7.863e-242
GCF_040790805.1_ASM4079080v1_genomic	NZ_CP161191.1	808656	807615	1041	renamed_GCF_000008685.2	chromosome	811510	810469	1041	100.0	2.778e-236
GCF_040790805.1_ASM4079080v1_genomic	NZ_CP161191.1	810385	809584	801	renamed_GCF_000008685.2	chromosome	813239	812438	801	100.0	9.279e-174
GCF_040790805.1_ASM4079080v1_genomic	NZ_CP161191.1	811852	810844	1008	renamed_GCF_000008685.2	chromosome	814697	813689	1008	100.0	5.214e-215
GCF_040790805.1_ASM4079080v1_genomic	NZ_CP161191.1	813454	812656	798	renamed_GCF_000008685.2	chromosome	816299	815501	798	100.0	1.968e-173
GCF_040790805.1_ASM4079080v1_genomic	NZ_CP161191.1	814550	815111	561	renamed_GCF_000008685.2	chromosome	817395	817956	561	100.0	3.237e-128
GCF_040790805.1_ASM4079080v1_genomic	NZ_CP161191.1	850929	851997	1068	renamed_GCF_000008685.2	chromosome	853774	854842	1068	100.0	1.362e-231
GCF_040790805.1_ASM4079080v1_genomic	NZ_CP161191.1	853143	854664	1521	renamed_GCF_000008685.2	chromosome	855988	857509	1521	100.0	0.0
GCF_040790805.1_ASM4079080v1_genomic	NZ_CP161191.1	857266	856093	1173	renamed_GCF_000008685.2	chromosome	860111	858938	1173	100.0	1.287e-258
GCF_040790805.1_ASM4079080v1_genomic	NZ_CP161191.1	859854	860802	948	renamed_GCF_000008685.2	chromosome	862698	863646	948	100.0	4.292e-207
GCF_040790805.1_ASM4079080v1_genomic	NZ_CP161191.1	863071	863614	543	renamed_GCF_000008685.2	chromosome	865915	866458	543	100.0	2.343e-120
GCF_040790805.1_ASM4079080v1_genomic	NZ_CP161191.1	863649	863850	201	renamed_GCF_000008685.2	chromosome	866493	866694	201	100.0	2.206e-40
GCF_040790805.1_ASM4079080v1_genomic	NZ_CP161191.1	865270	864898	372	renamed_GCF_000008685.2	chromosome	868114	867742	372	100.0	7.954e-79
GCF_040790805.1_ASM4079080v1_genomic	NZ_CP161191.1	885335	883625	1710	renamed_GCF_000008685.2	chromosome	888179	886469	1710	100.0	0.0
GCF_040790805.1_ASM4079080v1_genomic	NZ_CP161191.1	890284	893725	3441	renamed_GCF_000008685.2	chromosome	893128	896569	3441	100.0	0.0
GCF_040790805.1_ASM4079080v1_genomic	NZ_CP161199.1	23254	24499	1245	renamed_GCF_000008685.2	cp26	23254	24499	1245	100.0	1.056e-281
GCF_040790805.1_ASM4079080v1_genomic	NZ_CP161201.1	10099	9322	777	renamed_GCF_000008685.2	cp32-3	26276	25499	777	100.0	3.144e-173
GCF_040790805.1_ASM4079080v1_genomic	NZ_CP161201.1	11232	11742	510	renamed_GCF_000008685.2	cp32-3	27409	27919	510	100.0	3.969e-109
GCF_040790805.1_ASM4079080v1_genomic	NZ_CP161195.1	2012	2576	564	renamed_GCF_000008685.2	cp32-4	2012	2576	564	100.0	2.235e-124
GCF_040790805.1_ASM4079080v1_genomic	NZ_CP161195.1	3375	3906	531	renamed_GCF_000008685.2	cp32-4	3375	3951	531	100.0	2.578e-117
GCF_040790805.1_ASM4079080v1_genomic	NZ_CP161195.1	4950	5406	456	renamed_GCF_000008685.2	cp32-4	4951	5407	456	100.0	1.075e-97
GCF_040790805.1_ASM4079080v1_genomic	NZ_CP161195.1	5776	6166	390	renamed_GCF_000008685.2	cp32-4	5777	6167	390	100.0	3.229e-83
GCF_040790805.1_ASM4079080v1_genomic	NZ_CP161195.1	20607	21363	756	renamed_GCF_000008685.2	cp32-4	20608	21364	756	100.0	8.022e-168
GCF_040790805.1_ASM4079080v1_genomic	NZ_CP161194.1	6700	7813	1113	renamed_GCF_000008685.2	cp32-1	6700	7813	1113	100.0	6.876e-247
GCF_040790805.1_ASM4079080v1_genomic	NZ_CP161194.1	7827	8256	429	renamed_GCF_000008685.2	cp32-6	7837	8266	429	100.0	5.601e-92
GCF_040790805.1_ASM4079080v1_genomic	NZ_CP161194.1	8723	8960	237	renamed_GCF_000008685.2	cp32-3	8723	8960	237	100.0	7.893e-49
GCF_040790805.1_ASM4079080v1_genomic	NZ_CP161194.1	10264	10948	684	renamed_GCF_000008685.2	cp32-8	10264	10948	684	100.0	3.113e-149
GCF_040790805.1_ASM4079080v1_genomic	NZ_CP161194.1	11919	12465	546	renamed_GCF_000008685.2	cp32-8	11919	12465	546	100.0	7.28e-117
GCF_040790805.1_ASM4079080v1_genomic	NZ_CP161194.1	19124	20213	1089	renamed_GCF_000008685.2	cp32-7	19116	20214	1089	94.5	5.876e-236
GCF_040790805.1_ASM4079080v1_genomic	NZ_CP161194.1	24536	24962	426	renamed_GCF_000008685.2	cp32-7	24512	24938	426	98.5	3.989e-95
GCF_040790805.1_ASM4079080v1_genomic	NZ_CP161202.1	11262	11781	519	renamed_GCF_000008685.2	cp32-9	28025	28544	519	99.4	3.122e-113
GCF_040790805.1_ASM4079080v1_genomic	NZ_CP161200.1	1439	1796	357	renamed_GCF_000008685.2	lp17	1409	1766	357	100.0	1.532e-77
GCF_040790805.1_ASM4079080v1_genomic	NZ_CP161200.1	5085	5769	684	renamed_GCF_000008685.2	lp17	5055	5739	684	100.0	2.578e-151
GCF_040790805.1_ASM4079080v1_genomic	NZ_CP161200.1	8296	9409	1113	renamed_GCF_000008685.2	lp17	8266	9379	1113	100.0	6.27e-248
GCF_040790805.1_ASM4079080v1_genomic	NZ_CP161196.1	15096	14535	561	renamed_GCF_000008685.2	lp28-1	14329	13768	561	100.0	4.308e-125
GCF_040790805.1_ASM4079080v1_genomic	NZ_CP161197.1	22768	22381	387	renamed_GCF_000008685.2	lp28-2	22659	22272	387	100.0	4.63e-87
GCF_040790805.1_ASM4079080v1_genomic	NZ_CP161197.1	23142	22767	375	renamed_GCF_000008685.2	lp28-2	23033	22658	375	100.0	2.05e-77
GCF_040790805.1_ASM4079080v1_genomic	NZ_CP161197.1	24597	26064	1467	renamed_GCF_000008685.2	lp28-2	24488	25955	1467	100.0	0.0
GCF_040790805.1_ASM4079080v1_genomic	NZ_CP161197.1	26765	27194	429	renamed_GCF_000008685.2	lp28-2	26569	27085	429	100.0	3.799e-96
GCF_040790805.1_ASM4079080v1_genomic	NZ_CP161197.1	28139	28940	801	renamed_GCF_000008685.2	lp28-2	28030	28831	801	100.0	3.29e-168
GCF_040790805.1_ASM4079080v1_genomic	NZ_CP161198.1	410	878	468	renamed_GCF_000008685.2	lp28-3	390	858	468	100.0	3.979e-102
GCF_040790805.1_ASM4079080v1_genomic	NZ_CP161198.1	18816	19446	630	renamed_GCF_000008685.2	lp28-3	18797	19427	630	100.0	1.007e-135
GCF_040790805.1_ASM4079080v1_genomic	NZ_CP161198.1	21488	22238	750	renamed_GCF_000008685.2	lp28-3	21469	22219	750	100.0	6.33e-161
GCF_040790805.1_ASM4079080v1_genomic	NZ_CP161198.1	26363	25451	912	renamed_GCF_000008685.2	lp28-3	26371	25432	912	100.0	5.639e-198
GCF_040790805.1_ASM4079080v1_genomic	NZ_CP161198.1	28216	27643	573	renamed_GCF_000008685.2	lp28-3	28197	27624	573	100.0	5.735e-124
GCF_040790805.1_ASM4079080v1_genomic	NZ_CP161191.1	103	676	573	renamed_GCF_000008685.2	chromosome	104	677	573	100.0	8.715e-128
GCF_040790805.1_ASM4079080v1_genomic	NZ_CP161191.1	3394	5188	1794	renamed_GCF_000008685.2	chromosome	3418	5188	1794	100.0	0.0
GCF_040790805.1_ASM4079080v1_genomic	NZ_CP161191.1	6306	5250	1056	renamed_GCF_000008685.2	chromosome	6306	5250	1056	99.7	7.804e-236
GCF_040790805.1_ASM4079080v1_genomic	NZ_CP161191.1	7397	6308	1089	renamed_GCF_000008685.2	chromosome	7397	6308	1089	100.0	1.828e-240
GCF_040790805.1_ASM4079080v1_genomic	NZ_CP161191.1	8315	7457	858	renamed_GCF_000008685.2	chromosome	8315	7457	858	100.0	6.472e-196
GCF_040790805.1_ASM4079080v1_genomic	NZ_CP161191.1	9201	10206	1005	renamed_GCF_000008685.2	chromosome	9201	10206	1005	100.0	1.697e-218
GCF_040790805.1_ASM4079080v1_genomic	NZ_CP161191.1	10202	10577	375	renamed_GCF_000008685.2	chromosome	10202	10577	375	100.0	3.75e-79
GCF_040790805.1_ASM4079080v1_genomic	NZ_CP161191.1	11420	12161	741	renamed_GCF_000008685.2	chromosome	11420	12161	741	100.0	4.147e-164
GCF_040790805.1_ASM4079080v1_genomic	NZ_CP161191.1	12153	12753	600	renamed_GCF_000008685.2	chromosome	12153	12753	600	100.0	4.114e-132
GCF_040790805.1_ASM4079080v1_genomic	NZ_CP161191.1	39635	38132	1503	renamed_GCF_000008685.2	chromosome	39638	38135	1503	99.8	0.0
GCF_040790805.1_ASM4079080v1_genomic	NZ_CP161191.1	39822	40674	852	renamed_GCF_000008685.2	chromosome	39825	40677	852	100.0	1.031e-189
GCF_040790805.1_ASM4079080v1_genomic	NZ_CP161191.1	42878	42476	402	renamed_GCF_000008685.2	chromosome	42881	42479	402	100.0	2.405e-88
GCF_040790805.1_ASM4079080v1_genomic	NZ_CP161191.1	45442	45988	546	renamed_GCF_000008685.2	chromosome	45445	45991	546	100.0	3.273e-117
GCF_040790805.1_ASM4079080v1_genomic	NZ_CP161191.1	47163	47838	675	renamed_GCF_000008685.2	chromosome	47166	47841	675	100.0	3.937e-145
GCF_040790805.1_ASM4079080v1_genomic	NZ_CP161191.1	49337	50009	672	renamed_GCF_000008685.2	chromosome	49340	50012	672	100.0	9.591e-152
GCF_040790805.1_ASM4079080v1_genomic	NZ_CP161191.1	60530	60032	498	renamed_GCF_000008685.2	chromosome	60533	60035	498	100.0	3.278e-109
GCF_040790805.1_ASM4079080v1_genomic	NZ_CP161191.1	61254	60564	690	renamed_GCF_000008685.2	chromosome	61257	60567	690	100.0	1.401e-150
GCF_040790805.1_ASM4079080v1_genomic	NZ_CP161191.1	64034	65273	1239	renamed_GCF_000008685.2	chromosome	64037	65276	1239	100.0	5.707e-279
GCF_040790805.1_ASM4079080v1_genomic	NZ_CP161191.1	102977	101552	1425	renamed_GCF_000008685.2	chromosome	102949	101524	1425	100.0	1.009e-312
GCF_040790805.1_ASM4079080v1_genomic	NZ_CP161191.1	122518	121906	612	renamed_GCF_000008685.2	chromosome	122491	121879	612	100.0	3.269e-128
GCF_040790805.1_ASM4079080v1_genomic	NZ_CP161191.1	124173	122517	1656	renamed_GCF_000008685.2	chromosome	124146	122490	1656	100.0	0.0
GCF_040790805.1_ASM4079080v1_genomic	NZ_CP161191.1	124841	124175	666	renamed_GCF_000008685.2	chromosome	124814	124148	666	100.0	8.347e-144
GCF_040790805.1_ASM4079080v1_genomic	NZ_CP161191.1	125574	124824	750	renamed_GCF_000008685.2	chromosome	125547	124797	750	100.0	1.281e-161
GCF_040790805.1_ASM4079080v1_genomic	NZ_CP161191.1	126328	125560	768	renamed_GCF_000008685.2	chromosome	126301	125533	768	100.0	3.291e-171
GCF_040790805.1_ASM4079080v1_genomic	NZ_CP161191.1	127440	126342	1098	renamed_GCF_000008685.2	chromosome	127413	126315	1098	100.0	1.369e-236
GCF_040790805.1_ASM4079080v1_genomic	NZ_CP161191.1	130159	127453	2706	renamed_GCF_000008685.2	chromosome	130132	127426	2706	100.0	0.0
GCF_040790805.1_ASM4079080v1_genomic	NZ_CP161191.1	131141	130196	945	renamed_GCF_000008685.2	chromosome	131114	130169	945	100.0	6.888e-210
GCF_040790805.1_ASM4079080v1_genomic	NZ_CP161191.1	131324	132452	1128	renamed_GCF_000008685.2	chromosome	131297	132425	1128	100.0	3.566e-248
GCF_040790805.1_ASM4079080v1_genomic	NZ_CP161191.1	241508	239501	2007	renamed_GCF_000008685.2	chromosome	242289	240282	2007	100.0	0.0
GCF_040790805.1_ASM4079080v1_genomic	NZ_CP161191.1	243932	243161	771	renamed_GCF_000008685.2	chromosome	244713	243942	771	100.0	4.161e-169
GCF_040790805.1_ASM4079080v1_genomic	NZ_CP161191.1	255681	258204	2523	renamed_GCF_000008685.2	chromosome	256462	258985	2523	100.0	0.0
GCF_040790805.1_ASM4079080v1_genomic	NZ_CP161191.1	262931	260510	2421	renamed_GCF_000008685.2	chromosome	263712	261291	2421	100.0	0.0
GCF_040790805.1_ASM4079080v1_genomic	NZ_CP161191.1	265325	266270	945	renamed_GCF_000008685.2	chromosome	266106	267051	945	100.0	6.277e-211
GCF_040790805.1_ASM4079080v1_genomic	NZ_CP161191.1	271899	269706	2193	renamed_GCF_000008685.2	chromosome	272641	270487	2193	100.0	0.0
GCF_040790805.1_ASM4079080v1_genomic	NZ_CP161191.1	292427	291644	783	renamed_GCF_000008685.2	chromosome	293208	292425	783	100.0	6.057e-167
GCF_040790805.1_ASM4079080v1_genomic	NZ_CP161191.1	292648	292423	225	renamed_GCF_000008685.2	chromosome	293429	293204	225	100.0	8.8e-46
GCF_040790805.1_ASM4079080v1_genomic	NZ_CP161191.1	333735	332838	897	renamed_GCF_000008685.2	chromosome	334515	333618	897	100.0	1.666e-200
GCF_040790805.1_ASM4079080v1_genomic	NZ_CP161191.1	334156	335728	1572	renamed_GCF_000008685.2	chromosome	334936	336508	1572	100.0	0.0
GCF_040790805.1_ASM4079080v1_genomic	NZ_CP161191.1	337577	339203	1626	renamed_GCF_000008685.2	chromosome	338357	339983	1626	100.0	0.0
GCF_040790805.1_ASM4079080v1_genomic	NZ_CP161191.1	339560	340481	921	renamed_GCF_000008685.2	chromosome	340340	341261	921	100.0	2.92e-198
GCF_040790805.1_ASM4079080v1_genomic	NZ_CP161191.1	340493	341543	1050	renamed_GCF_000008685.2	chromosome	341273	342323	1050	100.0	1.489e-227
GCF_040790805.1_ASM4079080v1_genomic	NZ_CP161191.1	341554	342427	873	renamed_GCF_000008685.2	chromosome	342334	343207	873	100.0	1.573e-188
GCF_040790805.1_ASM4079080v1_genomic	NZ_CP161191.1	374893	375172	279	renamed_GCF_000008685.2	chromosome	375660	375939	279	100.0	3.143e-57
GCF_040790805.1_ASM4079080v1_genomic	NZ_CP161191.1	376252	375193	1059	renamed_GCF_000008685.2	chromosome	377019	375960	1059	100.0	5.328e-232
GCF_040790805.1_ASM4079080v1_genomic	NZ_CP161191.1	378563	376271	2292	renamed_GCF_000008685.2	chromosome	379258	377038	2292	99.8	0.0
GCF_040790805.1_ASM4079080v1_genomic	NZ_CP161191.1	379791	378573	1218	renamed_GCF_000008685.2	chromosome	380558	379340	1218	100.0	1.741e-271
GCF_040790805.1_ASM4079080v1_genomic	NZ_CP161191.1	381125	379787	1338	renamed_GCF_000008685.2	chromosome	381892	380554	1338	100.0	1.408e-311
GCF_040790805.1_ASM4079080v1_genomic	NZ_CP161191.1	382615	381142	1473	renamed_GCF_000008685.2	chromosome	383382	381909	1473	100.0	0.0
GCF_040790805.1_ASM4079080v1_genomic	NZ_CP161191.1	383395	382627	768	renamed_GCF_000008685.2	chromosome	384162	383394	768	100.0	1.961e-168
GCF_040790805.1_ASM4079080v1_genomic	NZ_CP161191.1	383519	384659	1140	renamed_GCF_000008685.2	chromosome	384286	385426	1140	100.0	7.242e-251
GCF_040790805.1_ASM4079080v1_genomic	NZ_CP161191.1	384681	385395	714	renamed_GCF_000008685.2	chromosome	385448	386162	714	100.0	3.427e-153
GCF_040790805.1_ASM4079080v1_genomic	NZ_CP161191.1	385391	386570	1179	renamed_GCF_000008685.2	chromosome	386158	387337	1179	100.0	1.981e-263
GCF_040790805.1_ASM4079080v1_genomic	NZ_CP161191.1	408635	407786	849	renamed_GCF_000008685.2	chromosome	409402	408553	849	100.0	9.834e-190
GCF_040790805.1_ASM4079080v1_genomic	NZ_CP161191.1	409680	408648	1032	renamed_GCF_000008685.2	chromosome	410447	409415	1032	100.0	9.895e-238
GCF_040790805.1_ASM4079080v1_genomic	NZ_CP161191.1	410019	410679	660	renamed_GCF_000008685.2	chromosome	410786	411446	660	100.0	1.008e-140
GCF_040790805.1_ASM4079080v1_genomic	NZ_CP161191.1	412233	410688	1545	renamed_GCF_000008685.2	chromosome	413006	411455	1545	99.8	0.0
GCF_040790805.1_ASM4079080v1_genomic	NZ_CP161193.1	24103	24280	177	renamed_GCF_000008685.2	lp36	24066	24243	177	100.0	7.659e-32
GCF_040790805.1_ASM4079080v1_genomic	NZ_CP161193.1	24329	24707	378	renamed_GCF_000008685.2	lp38	23365	24088	378	39.2	3.947e-22
GCF_040790805.1_ASM4079080v1_genomic	NZ_CP161193.1	25139	25694	555	renamed_GCF_000008685.2	lp36	25102	25657	555	100.0	3.12e-119
GCF_040790805.1_ASM4079080v1_genomic	NZ_CP161193.1	26395	25849	546	renamed_GCF_000008685.2	lp36	26358	25812	546	100.0	8.009e-116
GCF_040790805.1_ASM4079080v1_genomic	NZ_CP161193.1	26840	26621	219	renamed_GCF_000008685.2	lp36	26803	26584	219	100.0	9.792e-44
GCF_040790805.1_ASM4079080v1_genomic	NZ_CP161193.1	28325	27419	906	renamed_GCF_000008685.2	lp36	28288	27382	906	100.0	5.634e-197
GCF_040790805.1_ASM4079080v1_genomic	NZ_CP161193.1	30500	29513	987	renamed_GCF_000008685.2	lp36	30463	29476	987	100.0	5.255e-220
GCF_040790805.1_ASM4079080v1_genomic	NZ_CP161192.1	5315	5651	336	renamed_GCF_000008685.2	lp54	5313	5649	336	100.0	1.784e-72
GCF_040790805.1_ASM4079080v1_genomic	NZ_CP161192.1	23275	21685	1590	renamed_GCF_000008685.2	lp54	23273	21683	1590	100.0	0.0
GCF_040790805.1_ASM4079080v1_genomic	NZ_CP161192.1	23778	24417	639	renamed_GCF_000008685.2	lp54	23776	24415	639	100.0	9.606e-138
GCF_040790805.1_ASM4079080v1_genomic	NZ_CP161192.1	24499	25105	606	renamed_GCF_000008685.2	lp54	24497	25103	606	100.0	6.612e-128
GCF_040790805.1_ASM4079080v1_genomic	NZ_CP161192.1	25454	26696	1242	renamed_GCF_000008685.2	lp54	25467	26694	1242	100.0	1.5e-268
GCF_040790805.1_ASM4079080v1_genomic	NZ_CP161192.1	27391	28000	609	renamed_GCF_000008685.2	lp54	27389	27998	609	100.0	2.346e-131
GCF_040790805.1_ASM4079080v1_genomic	NZ_CP161192.1	28015	28933	918	renamed_GCF_000008685.2	lp54	28013	28931	918	100.0	2.109e-201
GCF_040790805.1_ASM4079080v1_genomic	NZ_CP161192.1	28936	29389	453	renamed_GCF_000008685.2	lp54	28934	29387	453	100.0	2.51e-96
GCF_040790805.1_ASM4079080v1_genomic	NZ_CP161192.1	29385	29760	375	renamed_GCF_000008685.2	lp54	29383	29758	375	100.0	1.685e-79
GCF_040790805.1_ASM4079080v1_genomic	NZ_CP161191.1	51248	50486	762	renamed_GCF_000008685.2	chromosome	51251	50489	762	100.0	1.168e-164
GCF_040790805.1_ASM4079080v1_genomic	NZ_CP161191.1	52431	51249	1182	renamed_GCF_000008685.2	chromosome	52434	51252	1182	100.0	6.664e-259
GCF_040790805.1_ASM4079080v1_genomic	NZ_CP161191.1	53458	52450	1008	renamed_GCF_000008685.2	chromosome	53461	52453	1008	100.0	6.65e-221
GCF_040790805.1_ASM4079080v1_genomic	NZ_CP161191.1	55501	53530	1971	renamed_GCF_000008685.2	chromosome	55504	53533	1971	100.0	0.0
GCF_040790805.1_ASM4079080v1_genomic	NZ_CP161191.1	56277	55497	780	renamed_GCF_000008685.2	chromosome	56280	55500	780	99.6	1.628e-172
GCF_040790805.1_ASM4079080v1_genomic	NZ_CP161191.1	56745	56277	468	renamed_GCF_000008685.2	chromosome	56748	56280	468	100.0	3.979e-102
GCF_040790805.1_ASM4079080v1_genomic	NZ_CP161191.1	57182	56828	354	renamed_GCF_000008685.2	chromosome	57185	56831	354	100.0	1.322e-78
GCF_040790805.1_ASM4079080v1_genomic	NZ_CP161191.1	57255	57972	717	renamed_GCF_000008685.2	chromosome	57258	57975	717	100.0	1.471e-154
GCF_040790805.1_ASM4079080v1_genomic	NZ_CP161191.1	59033	58025	1008	renamed_GCF_000008685.2	chromosome	58982	58028	1008	100.0	2.425e-206
GCF_040790805.1_ASM4079080v1_genomic	NZ_CP161191.1	81010	81436	426	renamed_GCF_000008685.2	chromosome	80982	81408	426	100.0	5.338e-92
GCF_040790805.1_ASM4079080v1_genomic	NZ_CP161191.1	105459	103791	1668	renamed_GCF_000008685.2	chromosome	105299	103763	1668	100.0	0.0
GCF_040790805.1_ASM4079080v1_genomic	NZ_CP161191.1	105874	105445	429	renamed_GCF_000008685.2	chromosome	105846	105417	429	100.0	3.057e-90
GCF_040790805.1_ASM4079080v1_genomic	NZ_CP161191.1	106922	105911	1011	renamed_GCF_000008685.2	chromosome	106894	105883	1011	100.0	4.14e-218
GCF_040790805.1_ASM4079080v1_genomic	NZ_CP161191.1	108198	107001	1197	renamed_GCF_000008685.2	chromosome	108170	106973	1197	100.0	8.414e-259
GCF_040790805.1_ASM4079080v1_genomic	NZ_CP161191.1	111069	109701	1368	renamed_GCF_000008685.2	chromosome	111042	109674	1368	100.0	1.976e-295
GCF_040790805.1_ASM4079080v1_genomic	NZ_CP161191.1	111594	111072	522	renamed_GCF_000008685.2	chromosome	111567	111045	522	100.0	1.783e-111
GCF_040790805.1_ASM4079080v1_genomic	NZ_CP161191.1	111902	111611	291	renamed_GCF_000008685.2	chromosome	111875	111584	291	100.0	1.894e-64
GCF_040790805.1_ASM4079080v1_genomic	NZ_CP161191.1	112365	111915	450	renamed_GCF_000008685.2	chromosome	112338	111888	450	100.0	4.387e-98
GCF_040790805.1_ASM4079080v1_genomic	NZ_CP161191.1	112796	112376	420	renamed_GCF_000008685.2	chromosome	112769	112349	420	100.0	6.488e-89
GCF_040790805.1_ASM4079080v1_genomic	NZ_CP161191.1	114630	112935	1695	renamed_GCF_000008685.2	chromosome	114603	112908	1695	100.0	0.0
GCF_040790805.1_ASM4079080v1_genomic	NZ_CP161191.1	137793	135900	1893	renamed_GCF_000008685.2	chromosome	137766	135873	1893	100.0	0.0
GCF_040790805.1_ASM4079080v1_genomic	NZ_CP161191.1	138772	138460	312	renamed_GCF_000008685.2	chromosome	138745	138433	312	100.0	1.981e-67
GCF_040790805.1_ASM4079080v1_genomic	NZ_CP161191.1	142961	142007	954	renamed_GCF_000008685.2	chromosome	142932	141978	954	100.0	1.517e-202
GCF_040790805.1_ASM4079080v1_genomic	NZ_CP161191.1	144295	142972	1323	renamed_GCF_000008685.2	chromosome	144230	142943	1323	99.7	1.75e-280
GCF_040790805.1_ASM4079080v1_genomic	NZ_CP161191.1	145487	144614	873	renamed_GCF_000008685.2	chromosome	145458	144585	873	100.0	2.787e-199
GCF_040790805.1_ASM4079080v1_genomic	NZ_CP161191.1	146399	145499	900	renamed_GCF_000008685.2	chromosome	146370	145470	900	99.6	7.439e-193
GCF_040790805.1_ASM4079080v1_genomic	NZ_CP161191.1	147524	146405	1119	renamed_GCF_000008685.2	chromosome	147495	146376	1119	100.0	3.727e-246
GCF_040790805.1_ASM4079080v1_genomic	NZ_CP161191.1	159396	160071	675	renamed_GCF_000008685.2	chromosome	159367	160042	675	100.0	1.946e-144
GCF_040790805.1_ASM4079080v1_genomic	NZ_CP161191.1	189305	189104	201	renamed_GCF_000008685.2	chromosome	189276	189075	201	100.0	9.889e-41
GCF_040790805.1_ASM4079080v1_genomic	NZ_CP161191.1	190092	190746	654	renamed_GCF_000008685.2	chromosome	190186	190717	654	100.0	6.314e-111
GCF_040790805.1_ASM4079080v1_genomic	NZ_CP161191.1	192356	191546	810	renamed_GCF_000008685.2	chromosome	192327	191517	810	100.0	2.276e-182
GCF_040790805.1_ASM4079080v1_genomic	NZ_CP161191.1	194904	195765	861	renamed_GCF_000008685.2	chromosome	194875	195736	861	99.6	3.179e-187
GCF_040790805.1_ASM4079080v1_genomic	NZ_CP161191.1	202607	201080	1527	renamed_GCF_000008685.2	chromosome	202578	201051	1527	100.0	0.0
GCF_040790805.1_ASM4079080v1_genomic	NZ_CP161191.1	204165	205101	936	renamed_GCF_000008685.2	chromosome	204136	205072	936	100.0	4.7e-204
GCF_040790805.1_ASM4079080v1_genomic	NZ_CP161191.1	205101	206073	972	renamed_GCF_000008685.2	chromosome	205174	206044	972	99.6	3.289e-188
GCF_040790805.1_ASM4079080v1_genomic	NZ_CP161191.1	254163	254868	705	renamed_GCF_000008685.2	chromosome	254944	255649	705	100.0	7.263e-152
GCF_040790805.1_ASM4079080v1_genomic	NZ_CP161191.1	273072	274455	1383	renamed_GCF_000008685.2	chromosome	273856	275236	1383	99.7	2.662e-303
GCF_040790805.1_ASM4079080v1_genomic	NZ_CP161191.1	275776	276283	507	renamed_GCF_000008685.2	chromosome	276671	277064	507	100.0	6.298e-87
GCF_040790805.1_ASM4079080v1_genomic	NZ_CP161191.1	278277	277755	522	renamed_GCF_000008685.2	chromosome	279058	278536	522	100.0	3.966e-111
GCF_040790805.1_ASM4079080v1_genomic	NZ_CP161191.1	280530	278625	1905	renamed_GCF_000008685.2	chromosome	281311	279406	1905	100.0	0.0
GCF_040790805.1_ASM4079080v1_genomic	NZ_CP161191.1	281906	281018	888	renamed_GCF_000008685.2	chromosome	282687	281799	888	100.0	4.025e-189
GCF_040790805.1_ASM4079080v1_genomic	NZ_CP161191.1	285178	283087	2091	renamed_GCF_000008685.2	chromosome	285962	283868	2091	99.8	0.0
GCF_040790805.1_ASM4079080v1_genomic	NZ_CP161191.1	287096	286307	789	renamed_GCF_000008685.2	chromosome	287877	287088	789	100.0	1.783e-164
GCF_040790805.1_ASM4079080v1_genomic	NZ_CP161191.1	288165	287400	765	renamed_GCF_000008685.2	chromosome	288946	288181	765	100.0	2.478e-165
GCF_040790805.1_ASM4079080v1_genomic	NZ_CP161191.1	288802	288175	627	renamed_GCF_000008685.2	chromosome	289583	288956	627	100.0	2.836e-132
GCF_040790805.1_ASM4079080v1_genomic	NZ_CP161191.1	315363	314526	837	renamed_GCF_000008685.2	chromosome	316143	315306	837	99.6	1.426e-183
GCF_040790805.1_ASM4079080v1_genomic	NZ_CP161191.1	317225	316466	759	renamed_GCF_000008685.2	chromosome	318005	317246	759	100.0	1.223e-163
GCF_040790805.1_ASM4079080v1_genomic	NZ_CP161191.1	318856	318325	531	renamed_GCF_000008685.2	chromosome	319636	319105	531	100.0	1.699e-113
GCF_040790805.1_ASM4079080v1_genomic	NZ_CP161191.1	319528	320572	1044	renamed_GCF_000008685.2	chromosome	320308	321352	1044	100.0	3.013e-227
GCF_040790805.1_ASM4079080v1_genomic	NZ_CP161191.1	322066	321259	807	renamed_GCF_000008685.2	chromosome	322846	322039	807	99.6	2.064e-174
GCF_040790805.1_ASM4079080v1_genomic	NZ_CP161191.1	324456	322995	1461	renamed_GCF_000008685.2	chromosome	325236	323775	1461	100.0	0.0
GCF_040790805.1_ASM4079080v1_genomic	NZ_CP161191.1	326947	325918	1029	renamed_GCF_000008685.2	chromosome	327757	326698	1029	99.7	7.409e-232
GCF_040790805.1_ASM4079080v1_genomic	NZ_CP161191.1	342427	343399	972	renamed_GCF_000008685.2	chromosome	343207	344179	972	100.0	3.579e-213
GCF_040790805.1_ASM4079080v1_genomic	NZ_CP161191.1	346061	345650	411	renamed_GCF_000008685.2	chromosome	346841	346430	411	100.0	6.821e-87
GCF_040790805.1_ASM4079080v1_genomic	NZ_CP161191.1	346521	346080	441	renamed_GCF_000008685.2	chromosome	347301	346860	441	100.0	1.706e-98
GCF_040790805.1_ASM4079080v1_genomic	NZ_CP161191.1	369259	370246	987	renamed_GCF_000008685.2	chromosome	370026	371013	987	100.0	7.343e-225
GCF_040790805.1_ASM4079080v1_genomic	NZ_CP161191.1	372372	372753	381	renamed_GCF_000008685.2	chromosome	373139	373520	381	100.0	1.683e-80
GCF_040790805.1_ASM4079080v1_genomic	NZ_CP161191.1	373509	374886	1377	renamed_GCF_000008685.2	chromosome	374276	375653	1377	100.0	1.277e-310
GCF_040790805.1_ASM4079080v1_genomic	NZ_CP161191.1	387713	387050	663	renamed_GCF_000008685.2	chromosome	388480	387817	663	100.0	4.965e-149
GCF_040790805.1_ASM4079080v1_genomic	NZ_CP161191.1	389574	388209	1365	renamed_GCF_000008685.2	chromosome	390341	388976	1365	99.5	7.255e-289
GCF_040790805.1_ASM4079080v1_genomic	NZ_CP161191.1	392190	391164	1026	renamed_GCF_000008685.2	chromosome	392957	391931	1026	100.0	1.232e-225
GCF_040790805.1_ASM4079080v1_genomic	NZ_CP161191.1	395739	394713	1026	renamed_GCF_000008685.2	chromosome	396506	395480	1026	100.0	3.003e-224
GCF_040790805.1_ASM4079080v1_genomic	NZ_CP161191.1	396709	396334	375	renamed_GCF_000008685.2	chromosome	397476	397101	375	100.0	1.385e-81
GCF_040790805.1_ASM4079080v1_genomic	NZ_CP161191.1	404850	404475	375	renamed_GCF_000008685.2	chromosome	405617	405242	375	100.0	5.555e-75
GCF_040790805.1_ASM4079080v1_genomic	NZ_CP161191.1	450462	448029	2433	renamed_GCF_000008685.2	chromosome	454472	452039	2433	100.0	0.0
GCF_040790805.1_ASM4079080v1_genomic	NZ_CP161191.1	452565	454026	1461	renamed_GCF_000008685.2	chromosome	456575	458036	1461	100.0	0.0
GCF_040790805.1_ASM4079080v1_genomic	NZ_CP161191.1	455905	456061	156	renamed_GCF_000008685.2	chromosome	459915	460071	156	100.0	2.965e-30
GCF_040790805.1_ASM4079080v1_genomic	NZ_CP161191.1	456041	456401	360	renamed_GCF_000008685.2	chromosome	460051	460411	360	100.0	4.812e-74
GCF_040790805.1_ASM4079080v1_genomic	NZ_CP161191.1	458808	459876	1068	renamed_GCF_000008685.2	chromosome	462818	463886	1068	100.0	4.491e-244
GCF_040790805.1_ASM4079080v1_genomic	NZ_CP161191.1	460042	461122	1080	renamed_GCF_000008685.2	chromosome	464052	465132	1080	100.0	9.122e-247
GCF_040790805.1_ASM4079080v1_genomic	NZ_CP161191.1	465378	463299	2079	renamed_GCF_000008685.2	chromosome	469387	467281	2079	99.2	0.0
GCF_040790805.1_ASM4079080v1_genomic	NZ_CP161191.1	465962	465668	294	renamed_GCF_000008685.2	chromosome	469971	469677	294	100.0	2.2e-63
GCF_040790805.1_ASM4079080v1_genomic	NZ_CP161191.1	481414	481714	300	renamed_GCF_000008685.2	chromosome	484286	484586	300	100.0	5.976e-62
GCF_040790805.1_ASM4079080v1_genomic	NZ_CP161191.1	497720	498137	417	renamed_GCF_000008685.2	chromosome	500592	501009	417	100.0	2.778e-89
GCF_040790805.1_ASM4079080v1_genomic	NZ_CP161191.1	498342	498597	255	renamed_GCF_000008685.2	chromosome	501214	501469	255	100.0	1.745e-51
GCF_040790805.1_ASM4079080v1_genomic	NZ_CP161191.1	499007	499313	306	renamed_GCF_000008685.2	chromosome	501879	502185	306	100.0	2.959e-62
GCF_040790805.1_ASM4079080v1_genomic	NZ_CP161191.1	504533	504926	393	renamed_GCF_000008685.2	chromosome	507405	507798	393	100.0	3.073e-84
GCF_040790805.1_ASM4079080v1_genomic	NZ_CP161191.1	505997	506369	372	renamed_GCF_000008685.2	chromosome	508869	509241	372	100.0	8.775e-78
GCF_040790805.1_ASM4079080v1_genomic	NZ_CP161191.1	507963	508752	789	renamed_GCF_000008685.2	chromosome	510835	511624	789	100.0	3.149e-175
GCF_040790805.1_ASM4079080v1_genomic	NZ_CP161191.1	510353	511655	1302	renamed_GCF_000008685.2	chromosome	513225	514527	1302	100.0	1.62e-286
GCF_040790805.1_ASM4079080v1_genomic	NZ_CP161191.1	511651	512911	1260	renamed_GCF_000008685.2	chromosome	514523	515783	1260	100.0	5.48e-283
GCF_040790805.1_ASM4079080v1_genomic	NZ_CP161191.1	532724	532301	423	renamed_GCF_000008685.2	chromosome	535600	535177	423	100.0	5.606e-91
GCF_040790805.1_ASM4079080v1_genomic	NZ_CP161191.1	534643	535432	789	renamed_GCF_000008685.2	chromosome	537543	538308	789	99.6	2.994e-167
GCF_040790805.1_ASM4079080v1_genomic	NZ_CP161191.1	570975	572370	1395	renamed_GCF_000008685.2	chromosome	573852	575247	1395	100.0	2.85e-313
GCF_040790805.1_ASM4079080v1_genomic	NZ_CP161191.1	573649	573103	546	renamed_GCF_000008685.2	chromosome	576499	575980	546	100.0	1.781e-115
GCF_040790805.1_ASM4079080v1_genomic	NZ_CP161191.1	789397	788938	459	renamed_GCF_000008685.2	chromosome	792252	791793	459	100.0	5.068e-98
GCF_040790805.1_ASM4079080v1_genomic	NZ_CP161191.1	792000	790986	1014	renamed_GCF_000008685.2	chromosome	794855	793841	1014	100.0	1.719e-228
GCF_040790805.1_ASM4079080v1_genomic	NZ_CP161191.1	796161	795201	960	renamed_GCF_000008685.2	chromosome	799016	798056	960	100.0	6.008e-214
GCF_040790805.1_ASM4079080v1_genomic	NZ_CP161191.1	797620	798217	597	renamed_GCF_000008685.2	chromosome	800475	801072	597	100.0	2.836e-127
GCF_040790805.1_ASM4079080v1_genomic	NZ_CP161191.1	799944	799086	858	renamed_GCF_000008685.2	chromosome	802798	801940	858	100.0	3.462e-177
GCF_040790805.1_ASM4079080v1_genomic	NZ_CP161191.1	804069	802920	1149	renamed_GCF_000008685.2	chromosome	806923	805774	1149	100.0	1.098e-247
GCF_040790805.1_ASM4079080v1_genomic	NZ_CP161191.1	833215	835681	2466	renamed_GCF_000008685.2	chromosome	836060	838526	2466	100.0	0.0
GCF_040790805.1_ASM4079080v1_genomic	NZ_CP161191.1	836398	838987	2589	renamed_GCF_000008685.2	chromosome	839243	841832	2589	100.0	0.0
GCF_040790805.1_ASM4079080v1_genomic	NZ_CP161191.1	839655	840144	489	renamed_GCF_000008685.2	chromosome	842500	842989	489	100.0	2.063e-104
GCF_040790805.1_ASM4079080v1_genomic	NZ_CP161191.1	841608	844257	2649	renamed_GCF_000008685.2	chromosome	844453	847102	2649	100.0	0.0
GCF_040790805.1_ASM4079080v1_genomic	NZ_CP161191.1	844645	845494	849	renamed_GCF_000008685.2	chromosome	847490	848339	849	100.0	6.426e-186
GCF_040790805.1_ASM4079080v1_genomic	NZ_CP161191.1	845973	848142	2169	renamed_GCF_000008685.2	chromosome	848836	850987	2169	99.8	0.0
GCF_040790805.1_ASM4079080v1_genomic	NZ_CP161191.1	849643	850933	1290	renamed_GCF_000008685.2	chromosome	852488	853778	1290	100.0	6.634e-286
GCF_040790805.1_ASM4079080v1_genomic	NZ_CP161191.1	852023	853151	1128	renamed_GCF_000008685.2	chromosome	854868	855996	1128	100.0	2.385e-261
GCF_040790805.1_ASM4079080v1_genomic	NZ_CP161191.1	854660	856070	1410	renamed_GCF_000008685.2	chromosome	857505	858915	1410	100.0	1.384e-306
GCF_040790805.1_ASM4079080v1_genomic	NZ_CP161191.1	857594	858929	1335	renamed_GCF_000008685.2	chromosome	860439	861774	1335	100.0	8.434e-291
GCF_040790805.1_ASM4079080v1_genomic	NZ_CP161199.1	45	324	279	renamed_GCF_000008685.2	cp26	45	324	279	100.0	2.323e-60
GCF_040790805.1_ASM4079080v1_genomic	NZ_CP161199.1	2186	836	1350	renamed_GCF_000008685.2	cp26	2186	836	1350	100.0	7.868e-303
GCF_040790805.1_ASM4079080v1_genomic	NZ_CP161199.1	4083	4431	348	renamed_GCF_000008685.2	cp26	4083	4431	348	100.0	1.075e-71
GCF_040790805.1_ASM4079080v1_genomic	NZ_CP161199.1	4768	5866	1098	renamed_GCF_000008685.2	cp26	4768	5866	1098	100.0	2.035e-249
GCF_040790805.1_ASM4079080v1_genomic	NZ_CP161199.1	20786	19430	1356	renamed_GCF_000008685.2	cp26	20786	19430	1356	100.0	1.798e-294
GCF_040790805.1_ASM4079080v1_genomic	NZ_CP161199.1	21824	21338	486	renamed_GCF_000008685.2	cp26	21833	21338	486	100.0	3.279e-107
GCF_040790805.1_ASM4079080v1_genomic	NZ_CP161199.1	23154	22602	552	renamed_GCF_000008685.2	cp26	23154	22602	552	100.0	6.015e-120
GCF_040790805.1_ASM4079080v1_genomic	NZ_CP161199.1	24824	26453	1629	renamed_GCF_000008685.2	cp26	24824	26453	1629	100.0	0.0
GCF_040790805.1_ASM4079080v1_genomic	NZ_CP161201.1	408	726	318	renamed_GCF_000008685.2	cp32-3	16585	16903	318	100.0	2.414e-66
GCF_040790805.1_ASM4079080v1_genomic	NZ_CP161195.1	8280	8736	456	renamed_GCF_000008685.2	cp32-4	8281	8737	456	100.0	1.971e-99
GCF_040790805.1_ASM4079080v1_genomic	NZ_CP161195.1	8976	10272	1296	renamed_GCF_000008685.2	cp32-4	8977	10273	1296	100.0	2.13e-282
GCF_040790805.1_ASM4079080v1_genomic	NZ_CP161195.1	10894	11845	951	renamed_GCF_000008685.2	cp32-4	10895	11846	951	100.0	4.333e-216
GCF_040790805.1_ASM4079080v1_genomic	NZ_CP161195.1	12446	12779	333	renamed_GCF_000008685.2	cp32-3	12494	12827	333	100.0	8.424e-72
GCF_040790805.1_ASM4079080v1_genomic	NZ_CP161195.1	14275	15091	816	renamed_GCF_000008685.2	cp32-4	14276	15092	816	100.0	1.49e-179
GCF_040790805.1_ASM4079080v1_genomic	NZ_CP161195.1	15165	15369	204	renamed_GCF_000008685.2	cp32-7	15221	15425	204	100.0	2.578e-39
GCF_040790805.1_ASM4079080v1_genomic	NZ_CP161195.1	16037	16391	354	renamed_GCF_000008685.2	cp32-4	16038	16392	354	100.0	6.554e-78
GCF_040790805.1_ASM4079080v1_genomic	NZ_CP161195.1	16495	16996	501	renamed_GCF_000008685.2	cp32-4	16496	16997	501	100.0	5.048e-105
GCF_040790805.1_ASM4079080v1_genomic	NZ_CP161195.1	17101	17524	423	renamed_GCF_000008685.2	cp32-4	17102	17525	423	100.0	4.616e-93
GCF_040790805.1_ASM4079080v1_genomic	NZ_CP161195.1	20065	20632	567	renamed_GCF_000008685.2	cp32-4	20066	20633	567	100.0	2.944e-130
GCF_040790805.1_ASM4079080v1_genomic	NZ_CP161194.1	26723	27860	1137	renamed_GCF_000008685.2	cp32-1	26795	27932	1137	100.0	3.741e-249
GCF_040790805.1_ASM4079080v1_genomic	NZ_CP161194.1	28762	29329	567	renamed_GCF_000008685.2	cp32-1	28834	29401	567	100.0	2.836e-122
GCF_040790805.1_ASM4079080v1_genomic	NZ_CP161202.1	2400	3501	1101	renamed_GCF_000008685.2	cp32-9	19163	20264	1101	100.0	3.592e-252
GCF_040790805.1_ASM4079080v1_genomic	NZ_CP161202.1	4053	4809	756	renamed_GCF_000008685.2	cp32-9	20816	21572	756	100.0	2.151e-165
GCF_040790805.1_ASM4079080v1_genomic	NZ_CP161202.1	5420	5960	540	renamed_GCF_000008685.2	cp32-9	22183	22723	540	100.0	1.782e-114
GCF_040790805.1_ASM4079080v1_genomic	NZ_CP161202.1	7808	8234	426	renamed_GCF_000008685.2	cp32-9	24571	24997	426	100.0	1.627e-96
GCF_040790805.1_ASM4079080v1_genomic	NZ_CP161202.1	10034	11066	1032	renamed_GCF_000008685.2	cp32-9	26797	27829	1032	100.0	2.498e-227
GCF_040790805.1_ASM4079080v1_genomic	NZ_CP161197.1	6019	6787	768	renamed_GCF_000008685.2	lp28-2	5910	6678	768	100.0	2.365e-166
GCF_040790805.1_ASM4079080v1_genomic	NZ_CP161197.1	12428	11609	819	renamed_GCF_000008685.2	lp28-2	12319	11500	819	99.6	5.309e-183
GCF_040790805.1_ASM4079080v1_genomic	NZ_CP161197.1	13250	12857	393	renamed_GCF_000008685.2	lp28-2	13141	12748	393	100.0	6.841e-84
GCF_040790805.1_ASM4079080v1_genomic	NZ_CP161197.1	14450	13616	834	renamed_GCF_000008685.2	lp28-2	14341	13507	834	100.0	1.239e-184
GCF_040790805.1_ASM4079080v1_genomic	NZ_CP161197.1	15540	14994	546	renamed_GCF_000008685.2	lp28-2	15431	14885	546	100.0	8.811e-115
GCF_040790805.1_ASM4079080v1_genomic	NZ_CP161197.1	17793	16602	1191	renamed_GCF_000008685.2	lp28-2	17684	16493	1191	100.0	6.781e-269
GCF_040790805.1_ASM4079080v1_genomic	NZ_CP161197.1	18936	18138	798	renamed_GCF_000008685.2	lp28-2	18827	18029	798	100.0	7.719e-184
GCF_040790805.1_ASM4079080v1_genomic	NZ_CP161193.1	224	1118	894	renamed_GCF_000008685.2	lp36	187	1081	894	100.0	7.433e-192
GCF_040790805.1_ASM4079080v1_genomic	NZ_CP161193.1	14363	13613	750	renamed_GCF_000008685.2	lp36	14326	13576	750	100.0	1.062e-163
GCF_040790805.1_ASM4079080v1_genomic	NZ_CP161193.1	15797	14870	927	renamed_GCF_000008685.2	lp36	15760	14833	927	100.0	2.815e-208
GCF_040790805.1_ASM4079080v1_genomic	NZ_CP161193.1	16311	16923	612	renamed_GCF_000008685.2	lp36	16274	16886	612	100.0	9.153e-134
GCF_040790805.1_ASM4079080v1_genomic	NZ_CP161193.1	20425	21490	1065	renamed_GCF_000008685.2	lp36	20388	21453	1065	100.0	2.633e-232
GCF_040790805.1_ASM4079080v1_genomic	NZ_CP161193.1	22330	22504	174	renamed_GCF_000008685.2	lp36	22293	22467	174	100.0	8.56e-38
GCF_040790805.1_ASM4079080v1_genomic	NZ_CP161193.1	32859	31863	996	renamed_GCF_000008685.2	lp36	32822	31826	996	100.0	2.481e-221
GCF_040790805.1_ASM4079080v1_genomic	NZ_CP161193.1	35480	34631	849	renamed_GCF_000008685.2	lp36	35443	34594	849	100.0	4.031e-191
GCF_040790805.1_ASM4079080v1_genomic	NZ_CP161193.1	35904	36456	552	renamed_GCF_000008685.2	lp36	35867	36422	552	99.4	5.467e-121
GCF_040790805.1_ASM4079080v1_genomic	NZ_CP161192.1	1462	1972	510	renamed_GCF_000008685.2	lp54	1460	1970	510	100.0	8.829e-109
GCF_040790805.1_ASM4079080v1_genomic	NZ_CP161192.1	2895	2046	849	renamed_GCF_000008685.2	lp54	2893	2044	849	100.0	5.332e-188
GCF_040790805.1_ASM4079080v1_genomic	NZ_CP161192.1	4258	3004	1254	renamed_GCF_000008685.2	lp54	4256	3002	1254	100.0	3.245e-279
GCF_040790805.1_ASM4079080v1_genomic	NZ_CP161192.1	5142	4668	474	renamed_GCF_000008685.2	lp54	5140	4666	474	100.0	5.31e-100
GCF_040790805.1_ASM4079080v1_genomic	NZ_CP161192.1	12996	13581	585	renamed_GCF_000008685.2	lp54	12994	13579	585	100.0	1.763e-130
GCF_040790805.1_ASM4079080v1_genomic	NZ_CP161192.1	13556	14309	753	renamed_GCF_000008685.2	lp54	13554	14307	753	100.0	4.561e-165
GCF_040790805.1_ASM4079080v1_genomic	NZ_CP161192.1	14339	14885	546	renamed_GCF_000008685.2	lp54	14337	14883	546	100.0	1.338e-118
GCF_040790805.1_ASM4079080v1_genomic	NZ_CP161192.1	15371	15803	432	renamed_GCF_000008685.2	lp54	15369	15801	432	100.0	1.792e-96
GCF_040790805.1_ASM4079080v1_genomic	NZ_CP161192.1	16578	16002	576	renamed_GCF_000008685.2	lp54	16576	16000	576	100.0	1.337e-123
GCF_040790805.1_ASM4079080v1_genomic	NZ_CP161192.1	42020	41396	624	renamed_GCF_000008685.2	lp54	42019	41395	624	100.0	3.1e-139
GCF_040790805.1_ASM4079080v1_genomic	NZ_CP161192.1	42267	42474	207	renamed_GCF_000008685.2	lp54	42266	42473	207	100.0	9.856e-42
GCF_040790805.1_ASM4079080v1_genomic	NZ_CP161192.1	43533	42624	909	renamed_GCF_000008685.2	lp54	43532	42623	909	100.0	1.089e-198
GCF_040790805.1_ASM4079080v1_genomic	NZ_CP161192.1	44534	43685	849	renamed_GCF_000008685.2	lp54	44533	43684	849	100.0	7.054e-185
GCF_040790805.1_ASM4079080v1_genomic	NZ_CP161192.1	45942	44712	1230	renamed_GCF_000008685.2	lp54	45947	44711	1230	98.7	1.97e-263
GCF_040790805.1_ASM4079080v1_genomic	NZ_CP161192.1	47222	46466	756	renamed_GCF_000008685.2	lp54	47228	46472	756	100.0	2.151e-165
GCF_040790805.1_ASM4079080v1_genomic	NZ_CP161192.1	48261	47469	792	renamed_GCF_000008685.2	lp54	48267	47475	792	100.0	4.37e-172
GCF_040790805.1_ASM4079080v1_genomic	NZ_CP161192.1	50071	49846	225	renamed_GCF_000008685.2	lp54	50077	49852	225	100.0	1.962e-45
GCF_040790805.1_ASM4079080v1_genomic	NZ_CP161192.1	51170	50279	891	renamed_GCF_000008685.2	lp54	51176	50285	891	100.0	3.698e-199
GCF_040790805.1_ASM4079080v1_genomic	NZ_CP161191.1	22101	21057	1044	renamed_GCF_000008685.2	chromosome	22101	21057	1044	100.0	6.693e-227
GCF_040790805.1_ASM4079080v1_genomic	NZ_CP161191.1	22818	23958	1140	renamed_GCF_000008685.2	chromosome	22818	23958	1140	100.0	2.624e-262
GCF_040790805.1_ASM4079080v1_genomic	NZ_CP161191.1	24696	23964	732	renamed_GCF_000008685.2	chromosome	24696	23964	732	100.0	2.844e-158
GCF_040790805.1_ASM4079080v1_genomic	NZ_CP161191.1	25752	26391	639	renamed_GCF_000008685.2	chromosome	25752	26391	639	100.0	1.211e-143
GCF_040790805.1_ASM4079080v1_genomic	NZ_CP161191.1	28490	27854	636	renamed_GCF_000008685.2	chromosome	28490	27854	636	100.0	8.334e-139
GCF_040790805.1_ASM4079080v1_genomic	NZ_CP161191.1	29472	28491	981	renamed_GCF_000008685.2	chromosome	29472	28491	981	100.0	8.047e-223
GCF_040790805.1_ASM4079080v1_genomic	NZ_CP161191.1	31026	31479	453	renamed_GCF_000008685.2	chromosome	31026	31479	453	100.0	2.279e-97
GCF_040790805.1_ASM4079080v1_genomic	NZ_CP161191.1	34037	32156	1881	renamed_GCF_000008685.2	chromosome	34037	32156	1881	100.0	0.0
GCF_040790805.1_ASM4079080v1_genomic	NZ_CP161191.1	36609	35856	753	renamed_GCF_000008685.2	chromosome	36609	35856	753	98.0	1.62e-159
GCF_040790805.1_ASM4079080v1_genomic	NZ_CP161191.1	41429	40757	672	renamed_GCF_000008685.2	chromosome	41432	40760	672	100.0	1.856e-144
GCF_040790805.1_ASM4079080v1_genomic	NZ_CP161191.1	70169	71216	1047	renamed_GCF_000008685.2	chromosome	70141	71219	1047	100.0	1.295e-228
GCF_040790805.1_ASM4079080v1_genomic	NZ_CP161191.1	72643	73489	846	renamed_GCF_000008685.2	chromosome	72646	73492	846	100.0	5.813e-178
GCF_040790805.1_ASM4079080v1_genomic	NZ_CP161191.1	77102	77729	627	renamed_GCF_000008685.2	chromosome	76450	77701	627	100.0	1.541e-130
GCF_040790805.1_ASM4079080v1_genomic	NZ_CP161191.1	79380	79029	351	renamed_GCF_000008685.2	chromosome	79322	79001	351	100.0	3.732e-67
GCF_040790805.1_ASM4079080v1_genomic	NZ_CP161191.1	93451	92905	546	renamed_GCF_000008685.2	chromosome	93423	92877	546	100.0	2.704e-119
GCF_040790805.1_ASM4079080v1_genomic	NZ_CP161191.1	94060	93460	600	renamed_GCF_000008685.2	chromosome	94032	93432	600	100.0	1.47e-126
GCF_040790805.1_ASM4079080v1_genomic	NZ_CP161191.1	96981	94638	2343	renamed_GCF_000008685.2	chromosome	96953	94610	2343	100.0	0.0
GCF_040790805.1_ASM4079080v1_genomic	NZ_CP161191.1	98676	97890	786	renamed_GCF_000008685.2	chromosome	98648	97862	786	100.0	2.735e-176
GCF_040790805.1_ASM4079080v1_genomic	NZ_CP161191.1	98844	100233	1389	renamed_GCF_000008685.2	chromosome	98816	100205	1389	100.0	9.726e-316
GCF_040790805.1_ASM4079080v1_genomic	NZ_CP161191.1	216499	217531	1032	renamed_GCF_000008685.2	chromosome	217277	218312	1032	100.0	9.666e-221
GCF_040790805.1_ASM4079080v1_genomic	NZ_CP161191.1	218853	218274	579	renamed_GCF_000008685.2	chromosome	219634	219055	579	100.0	8.388e-121
GCF_040790805.1_ASM4079080v1_genomic	NZ_CP161191.1	219947	220856	909	renamed_GCF_000008685.2	chromosome	220728	221637	909	100.0	9.393e-192
GCF_040790805.1_ASM4079080v1_genomic	NZ_CP161191.1	222397	223180	783	renamed_GCF_000008685.2	chromosome	223178	223961	783	100.0	3.455e-173
GCF_040790805.1_ASM4079080v1_genomic	NZ_CP161191.1	236361	234813	1548	renamed_GCF_000008685.2	chromosome	237142	235594	1548	100.0	0.0
GCF_040790805.1_ASM4079080v1_genomic	NZ_CP161191.1	237445	237187	258	renamed_GCF_000008685.2	chromosome	238226	237968	258	100.0	9.113e-51
GCF_040790805.1_ASM4079080v1_genomic	NZ_CP161191.1	239469	238362	1107	renamed_GCF_000008685.2	chromosome	240250	239143	1107	100.0	3.718e-244
GCF_040790805.1_ASM4079080v1_genomic	NZ_CP161191.1	241656	243222	1566	renamed_GCF_000008685.2	chromosome	242437	244003	1566	100.0	0.0
GCF_040790805.1_ASM4079080v1_genomic	NZ_CP161191.1	244598	243995	603	renamed_GCF_000008685.2	chromosome	245382	244776	603	99.5	7.936e-134
GCF_040790805.1_ASM4079080v1_genomic	NZ_CP161191.1	297995	296684	1311	renamed_GCF_000008685.2	chromosome	298776	297465	1311	100.0	6.981e-289
GCF_040790805.1_ASM4079080v1_genomic	NZ_CP161191.1	298934	298013	921	renamed_GCF_000008685.2	chromosome	299715	298794	921	100.0	4.644e-193
GCF_040790805.1_ASM4079080v1_genomic	NZ_CP161191.1	299983	298948	1035	renamed_GCF_000008685.2	chromosome	300764	299729	1035	100.0	3.255e-216
GCF_040790805.1_ASM4079080v1_genomic	NZ_CP161191.1	328481	328841	360	renamed_GCF_000008685.2	chromosome	329261	329621	360	100.0	1.609e-77
GCF_040790805.1_ASM4079080v1_genomic	NZ_CP161191.1	329972	328862	1110	renamed_GCF_000008685.2	chromosome	330752	329642	1110	100.0	1.105e-249
GCF_040790805.1_ASM4079080v1_genomic	NZ_CP161191.1	332818	330022	2796	renamed_GCF_000008685.2	chromosome	333598	330802	2796	100.0	0.0
GCF_040790805.1_ASM4079080v1_genomic	NZ_CP161191.1	415026	413559	1467	renamed_GCF_000008685.2	chromosome	415793	414326	1467	100.0	0.0
GCF_040790805.1_ASM4079080v1_genomic	NZ_CP161191.1	415756	415078	678	renamed_GCF_000008685.2	chromosome	416478	415845	678	99.5	1.008e-143
GCF_040790805.1_ASM4079080v1_genomic	NZ_CP161191.1	415921	416338	417	renamed_GCF_000008685.2	chromosome	416688	417105	417	100.0	1.248e-89
GCF_040790805.1_ASM4079080v1_genomic	NZ_CP161191.1	416334	416946	612	renamed_GCF_000008685.2	chromosome	417101	417713	612	100.0	4.975e-132
GCF_040790805.1_ASM4079080v1_genomic	NZ_CP161191.1	444581	444191	390	renamed_GCF_000008685.2	chromosome	448591	448201	390	100.0	7.926e-82
GCF_040790805.1_ASM4079080v1_genomic	NZ_CP161191.1	467747	467213	534	renamed_GCF_000008685.2	chromosome	471756	471222	534	100.0	8.816e-113
GCF_040790805.1_ASM4079080v1_genomic	NZ_CP161191.1	468466	467761	705	renamed_GCF_000008685.2	chromosome	472358	471770	705	99.4	1.099e-121
GCF_040790805.1_ASM4079080v1_genomic	NZ_CP161191.1	468556	469399	843	renamed_GCF_000008685.2	chromosome	472565	473408	843	100.0	5.328e-187
GCF_040790805.1_ASM4079080v1_genomic	NZ_CP161191.1	470547	469395	1152	renamed_GCF_000008685.2	chromosome	474556	473404	1152	100.0	7.714e-261
GCF_040790805.1_ASM4079080v1_genomic	NZ_CP161191.1	470603	471593	990	renamed_GCF_000008685.2	chromosome	474612	475602	990	100.0	3.939e-215
GCF_040790805.1_ASM4079080v1_genomic	NZ_CP161191.1	471596	472202	606	renamed_GCF_000008685.2	chromosome	475605	476211	606	100.0	1.006e-131
GCF_040790805.1_ASM4079080v1_genomic	NZ_CP161191.1	474065	472253	1812	renamed_GCF_000008685.2	chromosome	478005	476262	1812	100.0	0.0
GCF_040790805.1_ASM4079080v1_genomic	NZ_CP161191.1	475699	477010	1311	renamed_GCF_000008685.2	chromosome	479708	481019	1311	100.0	7.438e-297
GCF_040790805.1_ASM4079080v1_genomic	NZ_CP161191.1	531424	532279	855	renamed_GCF_000008685.2	chromosome	534300	535155	855	100.0	8.967e-192
GCF_040790805.1_ASM4079080v1_genomic	NZ_CP161191.1	554546	553685	861	renamed_GCF_000008685.2	chromosome	557423	556562	861	100.0	5.864e-189
GCF_040790805.1_ASM4079080v1_genomic	NZ_CP161191.1	555147	554529	618	renamed_GCF_000008685.2	chromosome	558024	557406	618	100.0	1.216e-131
GCF_040790805.1_ASM4079080v1_genomic	NZ_CP161191.1	557855	555128	2727	renamed_GCF_000008685.2	chromosome	560732	558005	2727	100.0	0.0
GCF_040790805.1_ASM4079080v1_genomic	NZ_CP161191.1	558250	557851	399	renamed_GCF_000008685.2	chromosome	561127	560728	399	100.0	7.535e-84
GCF_040790805.1_ASM4079080v1_genomic	NZ_CP161191.1	558677	558239	438	renamed_GCF_000008685.2	chromosome	561554	561116	438	100.0	1.44e-91
GCF_040790805.1_ASM4079080v1_genomic	NZ_CP161191.1	559066	558685	381	renamed_GCF_000008685.2	chromosome	561943	561562	381	100.0	2.258e-77
GCF_040790805.1_ASM4079080v1_genomic	NZ_CP161191.1	559307	561290	1983	renamed_GCF_000008685.2	chromosome	562184	564167	1983	100.0	0.0
GCF_040790805.1_ASM4079080v1_genomic	NZ_CP161191.1	563092	564946	1854	renamed_GCF_000008685.2	chromosome	565954	567823	1854	99.8	0.0
GCF_040790805.1_ASM4079080v1_genomic	NZ_CP161191.1	564932	565400	468	renamed_GCF_000008685.2	chromosome	567809	568277	468	100.0	1.969e-101
GCF_040790805.1_ASM4079080v1_genomic	NZ_CP161191.1	587331	586806	525	renamed_GCF_000008685.2	chromosome	590208	589683	525	100.0	5.037e-109
GCF_040790805.1_ASM4079080v1_genomic	NZ_CP161191.1	587470	588058	588	renamed_GCF_000008685.2	chromosome	590347	590935	588	100.0	4.112e-130
GCF_040790805.1_ASM4079080v1_genomic	NZ_CP161191.1	588310	589480	1170	renamed_GCF_000008685.2	chromosome	591187	592357	1170	100.0	9.606e-253
GCF_040790805.1_ASM4079080v1_genomic	NZ_CP161191.1	589610	593054	3444	renamed_GCF_000008685.2	chromosome	592445	595931	3444	99.9	0.0
GCF_040790805.1_ASM4079080v1_genomic	NZ_CP161191.1	593065	593644	579	renamed_GCF_000008685.2	chromosome	595942	596521	579	100.0	3.772e-121
GCF_040790805.1_ASM4079080v1_genomic	NZ_CP161191.1	593653	595714	2061	renamed_GCF_000008685.2	chromosome	596530	598591	2061	100.0	0.0
GCF_040790805.1_ASM4079080v1_genomic	NZ_CP161191.1	596499	595710	789	renamed_GCF_000008685.2	chromosome	599376	598587	789	100.0	1.07e-178
GCF_040790805.1_ASM4079080v1_genomic	NZ_CP161191.1	596617	597967	1350	renamed_GCF_000008685.2	chromosome	599494	600844	1350	100.0	3.989e-293
GCF_040790805.1_ASM4079080v1_genomic	NZ_CP161191.1	598132	599467	1335	renamed_GCF_000008685.2	chromosome	601009	602344	1335	100.0	3.161e-293
GCF_040790805.1_ASM4079080v1_genomic	NZ_CP161191.1	742445	743477	1032	renamed_GCF_000008685.2	chromosome	745301	746333	1032	100.0	2.498e-227
GCF_040790805.1_ASM4079080v1_genomic	NZ_CP161191.1	756730	757360	630	renamed_GCF_000008685.2	chromosome	759585	760215	630	100.0	3.747e-138
GCF_040790805.1_ASM4079080v1_genomic	NZ_CP161191.1	757346	758792	1446	renamed_GCF_000008685.2	chromosome	760225	761647	1446	99.7	9.686e-317
GCF_040790805.1_ASM4079080v1_genomic	NZ_CP161191.1	760723	761506	783	renamed_GCF_000008685.2	chromosome	763578	764361	783	100.0	1.874e-171
GCF_040790805.1_ASM4079080v1_genomic	NZ_CP161191.1	761515	762487	972	renamed_GCF_000008685.2	chromosome	764370	765342	972	100.0	2.973e-215
GCF_040790805.1_ASM4079080v1_genomic	NZ_CP161191.1	762517	763861	1344	renamed_GCF_000008685.2	chromosome	765372	766716	1344	100.0	2.685e-305
GCF_040790805.1_ASM4079080v1_genomic	NZ_CP161191.1	765209	763877	1332	renamed_GCF_000008685.2	chromosome	768064	766732	1332	100.0	1.239e-294
GCF_040790805.1_ASM4079080v1_genomic	NZ_CP161191.1	766615	765223	1392	renamed_GCF_000008685.2	chromosome	769470	768078	1392	100.0	1.696e-292
GCF_040790805.1_ASM4079080v1_genomic	NZ_CP161191.1	828096	827472	624	renamed_GCF_000008685.2	chromosome	830941	830317	624	100.0	5.187e-142
GCF_040790805.1_ASM4079080v1_genomic	NZ_CP161191.1	866671	865888	783	renamed_GCF_000008685.2	chromosome	869380	868732	783	99.5	1.931e-145
GCF_040790805.1_ASM4079080v1_genomic	NZ_CP161191.1	867179	866663	516	renamed_GCF_000008685.2	chromosome	870023	869507	516	100.0	1.621e-111
GCF_040790805.1_ASM4079080v1_genomic	NZ_CP161191.1	869739	867267	2472	renamed_GCF_000008685.2	chromosome	872583	870111	2472	100.0	0.0
GCF_040790805.1_ASM4079080v1_genomic	NZ_CP161191.1	872288	869741	2547	renamed_GCF_000008685.2	chromosome	875132	872585	2547	99.8	0.0
GCF_040790805.1_ASM4079080v1_genomic	NZ_CP161191.1	872362	873604	1242	renamed_GCF_000008685.2	chromosome	875206	876448	1242	100.0	1.008e-281
GCF_040790805.1_ASM4079080v1_genomic	NZ_CP161191.1	873584	876437	2853	renamed_GCF_000008685.2	chromosome	876491	879281	2853	99.8	0.0
GCF_040790805.1_ASM4079080v1_genomic	NZ_CP161191.1	876470	877406	936	renamed_GCF_000008685.2	chromosome	879314	880250	936	100.0	3.242e-208
GCF_040790805.1_ASM4079080v1_genomic	NZ_CP161191.1	878247	877422	825	renamed_GCF_000008685.2	chromosome	881091	880266	825	100.0	2.882e-182
GCF_040790805.1_ASM4079080v1_genomic	NZ_CP161191.1	881369	878240	3129	renamed_GCF_000008685.2	chromosome	884213	881084	3129	100.0	0.0
GCF_040790805.1_ASM4079080v1_genomic	NZ_CP161199.1	16902	17535	633	renamed_GCF_000008685.2	cp26	16902	17535	633	100.0	1.275e-133
GCF_040790805.1_ASM4079080v1_genomic	NZ_CP161201.1	911	1520	609	renamed_GCF_000008685.2	cp32-3	17088	17697	609	100.0	2.836e-129
GCF_040790805.1_ASM4079080v1_genomic	NZ_CP161201.1	1625	2072	447	renamed_GCF_000008685.2	cp32-3	17802	18249	447	100.0	7.667e-100
GCF_040790805.1_ASM4079080v1_genomic	NZ_CP161201.1	3051	2109	942	renamed_GCF_000008685.2	cp32-3	19228	18286	942	100.0	4.129e-215
GCF_040790805.1_ASM4079080v1_genomic	NZ_CP161201.1	3427	4528	1101	renamed_GCF_000008685.2	cp32-3	19604	20705	1101	100.0	1.773e-251
GCF_040790805.1_ASM4079080v1_genomic	NZ_CP161201.1	4537	5104	567	renamed_GCF_000008685.2	cp32-3	20714	21281	567	100.0	2.944e-130
GCF_040790805.1_ASM4079080v1_genomic	NZ_CP161201.1	5079	5820	741	renamed_GCF_000008685.2	cp32-3	21256	21997	741	100.0	5.003e-162
GCF_040790805.1_ASM4079080v1_genomic	NZ_CP161201.1	5860	6403	543	renamed_GCF_000008685.2	cp32-1	21560	22118	543	64.0	6.304e-76
GCF_040790805.1_ASM4079080v1_genomic	NZ_CP161201.1	6415	7006	591	renamed_GCF_000008685.2	cp32-3	22592	23183	591	100.0	1.16e-127
GCF_040790805.1_ASM4079080v1_genomic	NZ_CP161201.1	7513	8839	1326	renamed_GCF_000008685.2	cp32-3	23690	25016	1326	100.0	1.445e-300
GCF_040790805.1_ASM4079080v1_genomic	NZ_CP161194.1	2	1289	1287	renamed_GCF_000008685.2	cp32-6	65	1289	1287	99.7	2.746e-269
GCF_040790805.1_ASM4079080v1_genomic	NZ_CP161194.1	1305	1998	693	renamed_GCF_000008685.2	cp32-1	1305	1998	693	100.0	2.582e-144
GCF_040790805.1_ASM4079080v1_genomic	NZ_CP161194.1	2010	2568	558	renamed_GCF_000008685.2	cp32-1	2010	2568	558	100.0	1.105e-122
GCF_040790805.1_ASM4079080v1_genomic	NZ_CP161194.1	2574	3339	765	renamed_GCF_000008685.2	cp32-1	2574	3339	765	100.0	3.139e-171
GCF_040790805.1_ASM4079080v1_genomic	NZ_CP161194.1	3962	4922	960	renamed_GCF_000008685.2	cp32-1	3962	4922	960	100.0	6.593e-213
GCF_040790805.1_ASM4079080v1_genomic	NZ_CP161194.1	4941	5397	456	renamed_GCF_000008685.2	cp32-1	4941	5397	456	100.0	1.075e-97
GCF_040790805.1_ASM4079080v1_genomic	NZ_CP161194.1	5396	5780	384	renamed_GCF_000008685.2	cp32-1	5396	5780	384	100.0	2.931e-83
GCF_040790805.1_ASM4079080v1_genomic	NZ_CP161194.1	18731	17714	1017	renamed_GCF_000008685.2	cp32-1	18728	17714	1017	99.7	1.801e-228
GCF_040790805.1_ASM4079080v1_genomic	NZ_CP161200.1	11676	11013	663	renamed_GCF_000008685.2	lp17	11646	10983	663	100.0	1.005e-149
GCF_040790805.1_ASM4079080v1_genomic	NZ_CP161200.1	13368	14109	741	renamed_GCF_000008685.2	lp17	13338	14079	741	100.0	7.64e-166
GCF_040790805.1_ASM4079080v1_genomic	NZ_CP161200.1	14099	14369	270	renamed_GCF_000008685.2	lp17	14069	14339	270	100.0	1.489e-55
GCF_040790805.1_ASM4079080v1_genomic	NZ_CP161196.1	1233	2232	999	renamed_GCF_000008685.2	lp28-1	466	1465	999	100.0	6.954e-219
GCF_040790805.1_ASM4079080v1_genomic	NZ_CP161196.1	3380	2864	516	renamed_GCF_000008685.2	lp28-1	2619	2097	516	100.0	2.617e-106
GCF_040790805.1_ASM4079080v1_genomic	NZ_CP161196.1	3967	4147	180	renamed_GCF_000008685.2	lp28-1	3200	3380	180	100.0	1.305e-34
GCF_040790805.1_ASM4079080v1_genomic	NZ_CP161196.1	4616	4448	168	renamed_GCF_000008685.2	lp28-1	3849	3681	168	100.0	3.274e-31
GCF_040790805.1_ASM4079080v1_genomic	NZ_CP161196.1	8678	8120	558	renamed_GCF_000008685.2	lp28-1	7869	7353	558	100.0	3.959e-117
GCF_040790805.1_ASM4079080v1_genomic	NZ_CP161196.1	9538	9796	258	renamed_GCF_000008685.2	lp28-1	8771	9029	258	100.0	1.351e-54
GCF_040790805.1_ASM4079080v1_genomic	NZ_CP161196.1	11758	11464	294	renamed_GCF_000008685.2	lp28-1	10895	10697	294	100.0	9.155e-41
GCF_040790805.1_ASM4079080v1_genomic	NZ_CP161196.1	13759	13207	552	renamed_GCF_000008685.2	lp28-1	12992	12440	552	100.0	6.015e-120
GCF_040790805.1_ASM4079080v1_genomic	NZ_CP161198.1	1064	1388	324	renamed_GCF_000008685.2	lp28-3	1044	1368	324	100.0	1.789e-70
GCF_040790805.1_ASM4079080v1_genomic	NZ_CP161198.1	2990	2279	711	renamed_GCF_000008685.2	lp28-3	2970	2259	711	100.0	1.615e-152
GCF_040790805.1_ASM4079080v1_genomic	NZ_CP161191.1	160118	161237	1119	renamed_GCF_000008685.2	chromosome	160089	161208	1119	100.0	2.349e-251
GCF_040790805.1_ASM4079080v1_genomic	NZ_CP161191.1	162906	163074	168	renamed_GCF_000008685.2	chromosome	162877	163045	168	100.0	5.294e-34
GCF_040790805.1_ASM4079080v1_genomic	NZ_CP161191.1	167788	165943	1845	renamed_GCF_000008685.2	chromosome	167759	165914	1845	100.0	0.0
GCF_040790805.1_ASM4079080v1_genomic	NZ_CP161191.1	169567	170737	1170	renamed_GCF_000008685.2	chromosome	169562	170708	1170	99.7	6.062e-258
GCF_040790805.1_ASM4079080v1_genomic	NZ_CP161191.1	173609	171560	2049	renamed_GCF_000008685.2	chromosome	173535	171531	2049	99.8	0.0
GCF_040790805.1_ASM4079080v1_genomic	NZ_CP161191.1	175113	174126	987	renamed_GCF_000008685.2	chromosome	174970	174097	987	100.0	1.551e-190
GCF_040790805.1_ASM4079080v1_genomic	NZ_CP161191.1	177003	176097	906	renamed_GCF_000008685.2	chromosome	176974	176068	906	100.0	1.374e-195
GCF_040790805.1_ASM4079080v1_genomic	NZ_CP161191.1	211329	212097	768	renamed_GCF_000008685.2	chromosome	211300	212068	768	100.0	8.822e-169
GCF_040790805.1_ASM4079080v1_genomic	NZ_CP161191.1	227046	225828	1218	renamed_GCF_000008685.2	chromosome	227827	226609	1218	100.0	6.126e-266
GCF_040790805.1_ASM4079080v1_genomic	NZ_CP161191.1	228435	229443	1008	renamed_GCF_000008685.2	chromosome	229216	230224	1008	100.0	1.228e-222
GCF_040790805.1_ASM4079080v1_genomic	NZ_CP161191.1	230839	231541	702	renamed_GCF_000008685.2	chromosome	231620	232322	702	100.0	1.161e-154
GCF_040790805.1_ASM4079080v1_genomic	NZ_CP161191.1	234753	234507	246	renamed_GCF_000008685.2	chromosome	235534	235288	246	100.0	3.025e-52
GCF_040790805.1_ASM4079080v1_genomic	NZ_CP161191.1	245815	247321	1506	renamed_GCF_000008685.2	chromosome	246596	248102	1506	100.0	0.0
GCF_040790805.1_ASM4079080v1_genomic	NZ_CP161191.1	249889	249394	495	renamed_GCF_000008685.2	chromosome	250670	250175	495	100.0	5.051e-104
GCF_040790805.1_ASM4079080v1_genomic	NZ_CP161191.1	251456	250430	1026	renamed_GCF_000008685.2	chromosome	252237	251211	1026	100.0	5.545e-226
GCF_040790805.1_ASM4079080v1_genomic	NZ_CP161191.1	252377	254150	1773	renamed_GCF_000008685.2	chromosome	253158	254931	1773	100.0	0.0
GCF_040790805.1_ASM4079080v1_genomic	NZ_CP161191.1	302055	301722	333	renamed_GCF_000008685.2	chromosome	302839	302503	333	99.0	1.253e-67
GCF_040790805.1_ASM4079080v1_genomic	NZ_CP161191.1	302959	302551	408	renamed_GCF_000008685.2	chromosome	303740	303332	408	100.0	2.649e-88
GCF_040790805.1_ASM4079080v1_genomic	NZ_CP161191.1	304880	304331	549	renamed_GCF_000008685.2	chromosome	305661	305112	549	100.0	9.24e-115
GCF_040790805.1_ASM4079080v1_genomic	NZ_CP161191.1	306536	305843	693	renamed_GCF_000008685.2	chromosome	307317	306624	693	100.0	2.971e-151
GCF_040790805.1_ASM4079080v1_genomic	NZ_CP161191.1	308999	307757	1242	renamed_GCF_000008685.2	chromosome	309780	308538	1242	100.0	1.368e-269
GCF_040790805.1_ASM4079080v1_genomic	NZ_CP161191.1	310872	309777	1095	renamed_GCF_000008685.2	chromosome	311617	310558	1095	99.7	2.491e-229
GCF_040790805.1_ASM4079080v1_genomic	NZ_CP161191.1	313343	311951	1392	renamed_GCF_000008685.2	chromosome	314123	312728	1392	100.0	1.047e-306
GCF_040790805.1_ASM4079080v1_genomic	NZ_CP161191.1	314534	313643	891	renamed_GCF_000008685.2	chromosome	315314	314423	891	100.0	4.455e-197
GCF_040790805.1_ASM4079080v1_genomic	NZ_CP161191.1	316436	315359	1077	renamed_GCF_000008685.2	chromosome	317216	316139	1077	100.0	1.824e-238
GCF_040790805.1_ASM4079080v1_genomic	NZ_CP161191.1	318336	317496	840	renamed_GCF_000008685.2	chromosome	319116	318276	840	99.6	1.977e-180
GCF_040790805.1_ASM4079080v1_genomic	NZ_CP161191.1	354723	356142	1419	renamed_GCF_000008685.2	chromosome	355490	356909	1419	100.0	1.415e-316
GCF_040790805.1_ASM4079080v1_genomic	NZ_CP161191.1	357690	358431	741	renamed_GCF_000008685.2	chromosome	358457	359198	741	100.0	9.218e-164
GCF_040790805.1_ASM4079080v1_genomic	NZ_CP161191.1	360311	358745	1566	renamed_GCF_000008685.2	chromosome	361078	359512	1566	100.0	0.0
GCF_040790805.1_ASM4079080v1_genomic	NZ_CP161191.1	363350	361550	1800	renamed_GCF_000008685.2	chromosome	364117	362317	1800	100.0	0.0
GCF_040790805.1_ASM4079080v1_genomic	NZ_CP161191.1	364836	364347	489	renamed_GCF_000008685.2	chromosome	365603	365114	489	100.0	3.787e-106
GCF_040790805.1_ASM4079080v1_genomic	NZ_CP161191.1	366193	365461	732	renamed_GCF_000008685.2	chromosome	366960	366228	732	100.0	5.239e-160
GCF_040790805.1_ASM4079080v1_genomic	NZ_CP161191.1	368117	369260	1143	renamed_GCF_000008685.2	chromosome	368884	370027	1143	100.0	3.212e-243
GCF_040790805.1_ASM4079080v1_genomic	NZ_CP161191.1	370266	372279	2013	renamed_GCF_000008685.2	chromosome	371033	373046	2013	100.0	0.0
GCF_040790805.1_ASM4079080v1_genomic	NZ_CP161191.1	373384	372799	585	renamed_GCF_000008685.2	chromosome	374151	373566	585	100.0	4.312e-129
GCF_040790805.1_ASM4079080v1_genomic	NZ_CP161191.1	386566	387040	474	renamed_GCF_000008685.2	chromosome	387333	387807	474	100.0	1.339e-106
GCF_040790805.1_ASM4079080v1_genomic	NZ_CP161191.1	420786	421416	630	renamed_GCF_000008685.2	chromosome	421553	422183	630	100.0	5.705e-142
GCF_040790805.1_ASM4079080v1_genomic	NZ_CP161191.1	423681	423057	624	renamed_GCF_000008685.2	chromosome	424442	423821	624	100.0	2.036e-135
GCF_040790805.1_ASM4079080v1_genomic	NZ_CP161191.1	424818	425946	1128	renamed_GCF_000008685.2	chromosome	425583	426711	1128	100.0	1.044e-244
GCF_040790805.1_ASM4079080v1_genomic	NZ_CP161191.1	427221	427857	636	renamed_GCF_000008685.2	chromosome	427986	428622	636	100.0	3.41e-140
GCF_040790805.1_ASM4079080v1_genomic	NZ_CP161191.1	445408	446161	753	renamed_GCF_000008685.2	chromosome	449418	450171	753	100.0	3.278e-160
GCF_040790805.1_ASM4079080v1_genomic	NZ_CP161191.1	447911	447128	783	renamed_GCF_000008685.2	chromosome	451921	451138	783	100.0	1.017e-169
GCF_040790805.1_ASM4079080v1_genomic	NZ_CP161191.1	452378	450473	1905	renamed_GCF_000008685.2	chromosome	456388	454483	1905	100.0	0.0
GCF_040790805.1_ASM4079080v1_genomic	NZ_CP161191.1	454266	455424	1158	renamed_GCF_000008685.2	chromosome	458276	459434	1158	100.0	2.482e-257
GCF_040790805.1_ASM4079080v1_genomic	NZ_CP161191.1	455514	455814	300	renamed_GCF_000008685.2	chromosome	459524	459824	300	100.0	7.304e-60
GCF_040790805.1_ASM4079080v1_genomic	NZ_CP161191.1	458034	458763	729	renamed_GCF_000008685.2	chromosome	462044	462773	729	100.0	2.248e-160
GCF_040790805.1_ASM4079080v1_genomic	NZ_CP161191.1	463268	461507	1761	renamed_GCF_000008685.2	chromosome	467278	465517	1761	100.0	0.0
GCF_040790805.1_ASM4079080v1_genomic	NZ_CP161191.1	465656	465380	276	renamed_GCF_000008685.2	chromosome	469665	469389	276	100.0	1.644e-55
GCF_040790805.1_ASM4079080v1_genomic	NZ_CP161191.1	467211	465951	1260	renamed_GCF_000008685.2	chromosome	471220	469960	1260	100.0	2.539e-274
GCF_040790805.1_ASM4079080v1_genomic	NZ_CP161191.1	479727	481410	1683	renamed_GCF_000008685.2	chromosome	482599	484282	1683	100.0	0.0
GCF_040790805.1_ASM4079080v1_genomic	NZ_CP161191.1	481890	482394	504	renamed_GCF_000008685.2	chromosome	484756	485266	504	100.0	1.216e-112
GCF_040790805.1_ASM4079080v1_genomic	NZ_CP161191.1	482677	483205	528	renamed_GCF_000008685.2	chromosome	485549	486077	528	100.0	1.004e-118
GCF_040790805.1_ASM4079080v1_genomic	NZ_CP161191.1	483844	484666	822	renamed_GCF_000008685.2	chromosome	486746	487538	822	100.0	1.872e-169
GCF_040790805.1_ASM4079080v1_genomic	NZ_CP161191.1	485353	486100	747	renamed_GCF_000008685.2	chromosome	488225	488972	747	100.0	3.778e-166
GCF_040790805.1_ASM4079080v1_genomic	NZ_CP161191.1	486860	487682	822	renamed_GCF_000008685.2	chromosome	489732	490554	822	100.0	2.749e-182
GCF_040790805.1_ASM4079080v1_genomic	NZ_CP161191.1	506441	507974	1533	renamed_GCF_000008685.2	chromosome	509313	510846	1533	100.0	0.0
GCF_040790805.1_ASM4079080v1_genomic	NZ_CP161191.1	510267	509520	747	renamed_GCF_000008685.2	chromosome	513139	512392	747	100.0	7.284e-159
GCF_040790805.1_ASM4079080v1_genomic	NZ_CP161191.1	532827	534651	1824	renamed_GCF_000008685.2	chromosome	535703	537527	1824	100.0	0.0
GCF_040790805.1_ASM4079080v1_genomic	NZ_CP161191.1	536399	535451	948	renamed_GCF_000008685.2	chromosome	539275	538327	948	100.0	1.008e-214
GCF_040790805.1_ASM4079080v1_genomic	NZ_CP161191.1	539386	540148	762	renamed_GCF_000008685.2	chromosome	542262	543024	762	100.0	5.516e-173
GCF_040790805.1_ASM4079080v1_genomic	NZ_CP161191.1	540955	541729	774	renamed_GCF_000008685.2	chromosome	543831	544605	774	99.6	4.362e-169
GCF_040790805.1_ASM4079080v1_genomic	NZ_CP161191.1	545614	544969	645	renamed_GCF_000008685.2	chromosome	548490	547845	645	100.0	1.056e-137
GCF_040790805.1_ASM4079080v1_genomic	NZ_CP161191.1	575072	575384	312	renamed_GCF_000008685.2	chromosome	577949	578261	312	100.0	5.387e-65
GCF_040790805.1_ASM4079080v1_genomic	NZ_CP161191.1	575399	577544	2145	renamed_GCF_000008685.2	chromosome	578276	580421	2145	100.0	0.0
GCF_040790805.1_ASM4079080v1_genomic	NZ_CP161191.1	577608	578766	1158	renamed_GCF_000008685.2	chromosome	580485	581643	1158	100.0	7.971e-253
GCF_040790805.1_ASM4079080v1_genomic	NZ_CP161191.1	578767	580540	1773	renamed_GCF_000008685.2	chromosome	581644	583417	1773	100.0	0.0
GCF_040790805.1_ASM4079080v1_genomic	NZ_CP161191.1	580580	580955	375	renamed_GCF_000008685.2	chromosome	583457	583832	375	100.0	8.349e-79
GCF_040790805.1_ASM4079080v1_genomic	NZ_CP161191.1	582003	581313	690	renamed_GCF_000008685.2	chromosome	584880	584190	690	100.0	9.609e-155
GCF_040790805.1_ASM4079080v1_genomic	NZ_CP161191.1	582214	583279	1065	renamed_GCF_000008685.2	chromosome	585079	586156	1065	99.7	1.659e-237
GCF_040790805.1_ASM4079080v1_genomic	NZ_CP161191.1	584153	585005	852	renamed_GCF_000008685.2	chromosome	587030	587882	852	100.0	3.506e-193
GCF_040790805.1_ASM4079080v1_genomic	NZ_CP161191.1	585188	586790	1602	renamed_GCF_000008685.2	chromosome	588065	589667	1602	100.0	0.0
GCF_040790805.1_ASM4079080v1_genomic	NZ_CP161191.1	713763	714915	1152	renamed_GCF_000008685.2	chromosome	716619	717771	1152	100.0	1.261e-246
GCF_040790805.1_ASM4079080v1_genomic	NZ_CP161191.1	714886	715813	927	renamed_GCF_000008685.2	chromosome	717742	718669	927	100.0	3.519e-197
GCF_040790805.1_ASM4079080v1_genomic	NZ_CP161191.1	715970	718232	2262	renamed_GCF_000008685.2	chromosome	718826	721088	2262	100.0	0.0
GCF_040790805.1_ASM4079080v1_genomic	NZ_CP161191.1	718262	720164	1902	renamed_GCF_000008685.2	chromosome	721118	723020	1902	100.0	0.0
GCF_040790805.1_ASM4079080v1_genomic	NZ_CP161191.1	721274	720206	1068	renamed_GCF_000008685.2	chromosome	724130	723062	1068	100.0	3.402e-247
GCF_040790805.1_ASM4079080v1_genomic	NZ_CP161191.1	721367	722591	1224	renamed_GCF_000008685.2	chromosome	724223	725447	1224	100.0	3.222e-274
GCF_040790805.1_ASM4079080v1_genomic	NZ_CP161191.1	722574	723639	1065	renamed_GCF_000008685.2	chromosome	725430	726495	1065	100.0	4.042e-236
GCF_040790805.1_ASM4079080v1_genomic	NZ_CP161191.1	723628	724897	1269	renamed_GCF_000008685.2	chromosome	726457	727753	1269	100.0	3.739e-280
GCF_040790805.1_ASM4079080v1_genomic	NZ_CP161191.1	724880	725819	939	renamed_GCF_000008685.2	chromosome	727736	728675	939	100.0	1.678e-207
GCF_040790805.1_ASM4079080v1_genomic	NZ_CP161191.1	725809	726763	954	renamed_GCF_000008685.2	chromosome	728665	729619	954	100.0	1.334e-212
GCF_040790805.1_ASM4079080v1_genomic	NZ_CP161191.1	745267	747163	1896	renamed_GCF_000008685.2	chromosome	748122	750018	1896	100.0	0.0
GCF_040790805.1_ASM4079080v1_genomic	NZ_CP161191.1	747175	747934	759	renamed_GCF_000008685.2	chromosome	750030	750789	759	100.0	2.255e-165
GCF_040790805.1_ASM4079080v1_genomic	NZ_CP161191.1	748335	749304	969	renamed_GCF_000008685.2	chromosome	751190	752159	969	100.0	4.772e-218
GCF_040790805.1_ASM4079080v1_genomic	NZ_CP161191.1	749314	750364	1050	renamed_GCF_000008685.2	chromosome	752169	753219	1050	100.0	6.109e-229
GCF_040790805.1_ASM4079080v1_genomic	NZ_CP161191.1	750367	751213	846	renamed_GCF_000008685.2	chromosome	753291	754068	846	100.0	1.342e-168
GCF_040790805.1_ASM4079080v1_genomic	NZ_CP161191.1	751212	751695	483	renamed_GCF_000008685.2	chromosome	754067	754550	483	100.0	1.405e-107
GCF_040790805.1_ASM4079080v1_genomic	NZ_CP161191.1	751694	753494	1800	renamed_GCF_000008685.2	chromosome	754636	756349	1800	100.0	0.0
GCF_040790805.1_ASM4079080v1_genomic	NZ_CP161191.1	753498	754815	1317	renamed_GCF_000008685.2	chromosome	756353	757670	1317	100.0	1.293e-291
GCF_040790805.1_ASM4079080v1_genomic	NZ_CP161191.1	780534	782166	1632	renamed_GCF_000008685.2	chromosome	783389	785021	1632	100.0	0.0
GCF_040790805.1_ASM4079080v1_genomic	NZ_CP161191.1	782201	783899	1698	renamed_GCF_000008685.2	chromosome	785056	786754	1698	100.0	0.0
GCF_040790805.1_ASM4079080v1_genomic	NZ_CP161191.1	784004	786107	2103	renamed_GCF_000008685.2	chromosome	786859	788962	2103	100.0	0.0
GCF_040790805.1_ASM4079080v1_genomic	NZ_CP161191.1	786465	787083	618	renamed_GCF_000008685.2	chromosome	789302	789938	618	100.0	3.406e-137
GCF_040790805.1_ASM4079080v1_genomic	NZ_CP161191.1	787952	787091	861	renamed_GCF_000008685.2	chromosome	790807	789946	861	100.0	1.57e-186
GCF_040790805.1_ASM4079080v1_genomic	NZ_CP161191.1	788932	787951	981	renamed_GCF_000008685.2	chromosome	791787	790806	981	100.0	5.759e-218
GCF_040790805.1_ASM4079080v1_genomic	NZ_CP161191.1	789495	790770	1275	renamed_GCF_000008685.2	chromosome	792350	793625	1275	100.0	1.279e-284
GCF_040790805.1_ASM4079080v1_genomic	NZ_CP161191.1	795193	794263	930	renamed_GCF_000008685.2	chromosome	798048	797118	930	100.0	3.063e-199
GCF_040790805.1_ASM4079080v1_genomic	NZ_CP161191.1	797420	796352	1068	renamed_GCF_000008685.2	chromosome	800275	799207	1068	100.0	8.292e-246
GCF_040790805.1_ASM4079080v1_genomic	NZ_CP161191.1	815759	816071	312	renamed_GCF_000008685.2	chromosome	818604	818916	312	100.0	1.086e-65
GCF_040790805.1_ASM4079080v1_genomic	NZ_CP161191.1	816396	816642	246	renamed_GCF_000008685.2	chromosome	819241	819487	246	100.0	8.275e-50
GCF_040790805.1_ASM4079080v1_genomic	NZ_CP161191.1	817761	818343	582	renamed_GCF_000008685.2	chromosome	820606	821188	582	100.0	9.143e-129
GCF_040790805.1_ASM4079080v1_genomic	NZ_CP161191.1	835701	836235	534	renamed_GCF_000008685.2	chromosome	838546	839080	534	100.0	7.282e-115
GCF_040790805.1_ASM4079080v1_genomic	NZ_CP161191.1	838988	839606	618	renamed_GCF_000008685.2	chromosome	841833	842451	618	100.0	1.393e-138
GCF_040790805.1_ASM4079080v1_genomic	NZ_CP161191.1	840157	841606	1449	renamed_GCF_000008685.2	chromosome	843002	844451	1449	100.0	7.712e-320
GCF_040790805.1_ASM4079080v1_genomic	NZ_CP161191.1	844280	844643	363	renamed_GCF_000008685.2	chromosome	847125	847488	363	100.0	2.269e-74
GCF_040790805.1_ASM4079080v1_genomic	NZ_CP161191.1	845692	845959	267	renamed_GCF_000008685.2	chromosome	848537	848804	267	100.0	3.495e-54
GCF_040790805.1_ASM4079080v1_genomic	NZ_CP161191.1	848148	849669	1521	renamed_GCF_000008685.2	chromosome	850993	852514	1521	100.0	0.0
GCF_040790805.1_ASM4079080v1_genomic	NZ_CP161191.1	894851	894251	600	renamed_GCF_000008685.2	chromosome	897695	897095	600	100.0	6.881e-135
GCF_040790805.1_ASM4079080v1_genomic	NZ_CP161191.1	896654	897887	1233	renamed_GCF_000008685.2	chromosome	899498	900731	1233	100.0	1.522e-275
GCF_040790805.1_ASM4079080v1_genomic	NZ_CP161191.1	898989	900414	1425	renamed_GCF_000008685.2	chromosome	901833	903258	1425	100.0	1.211e-310
GCF_040790805.1_ASM4079080v1_genomic	NZ_CP161191.1	905562	906747	1185	renamed_GCF_000008685.2	chromosome	908406	909591	1185	100.0	8.142e-266
GCF_040790805.1_ASM4079080v1_genomic	NZ_CP161199.1	751	307	444	renamed_GCF_000008685.2	cp26	751	307	444	100.0	2.98e-101
GCF_040790805.1_ASM4079080v1_genomic	NZ_CP161199.1	3798	2475	1323	renamed_GCF_000008685.2	cp26	3798	2475	1323	100.0	1.419e-291
GCF_040790805.1_ASM4079080v1_genomic	NZ_CP161199.1	4439	4757	318	renamed_GCF_000008685.2	cp26	4481	4757	318	100.0	7.253e-55
GCF_040790805.1_ASM4079080v1_genomic	NZ_CP161199.1	19321	17965	1356	renamed_GCF_000008685.2	cp26	19321	17965	1356	100.0	1.971e-293
GCF_040790805.1_ASM4079080v1_genomic	NZ_CP161199.1	21364	20857	507	renamed_GCF_000008685.2	cp26	21364	20857	507	100.0	3.123e-111
GCF_040790805.1_ASM4079080v1_genomic	NZ_CP161199.1	21897	22593	696	renamed_GCF_000008685.2	cp26	21897	22593	696	100.0	1.401e-151
GCF_040790805.1_ASM4079080v1_genomic	NZ_CP161195.1	7836	8265	429	renamed_GCF_000008685.2	cp32-4	7837	8266	429	100.0	5.601e-92
GCF_040790805.1_ASM4079080v1_genomic	NZ_CP161195.1	8732	8969	237	renamed_GCF_000008685.2	cp32-9	8741	8978	237	100.0	1.76e-48
GCF_040790805.1_ASM4079080v1_genomic	NZ_CP161195.1	10294	10891	597	renamed_GCF_000008685.2	cp32-4	10295	10892	597	100.0	4.743e-130
GCF_040790805.1_ASM4079080v1_genomic	NZ_CP161195.1	11862	12417	555	renamed_GCF_000008685.2	cp32-4	11863	12418	555	100.0	3.12e-119
GCF_040790805.1_ASM4079080v1_genomic	NZ_CP161195.1	12775	13651	876	renamed_GCF_000008685.2	cp32-4	12776	13652	876	100.0	5.609e-192
GCF_040790805.1_ASM4079080v1_genomic	NZ_CP161195.1	13660	14266	606	renamed_GCF_000008685.2	cp32-4	13661	14267	606	100.0	5.47e-130
GCF_040790805.1_ASM4079080v1_genomic	NZ_CP161195.1	15372	15720	348	renamed_GCF_000008685.2	lp56	18919	19267	348	100.0	3.962e-74
GCF_040790805.1_ASM4079080v1_genomic	NZ_CP161195.1	15709	16045	336	renamed_GCF_000008685.2	lp56	19256	19592	336	100.0	5.348e-69
GCF_040790805.1_ASM4079080v1_genomic	NZ_CP161195.1	18582	17571	1011	renamed_GCF_000008685.2	cp32-4	18583	17572	1011	100.0	1.362e-230
GCF_040790805.1_ASM4079080v1_genomic	NZ_CP161195.1	18958	20056	1098	renamed_GCF_000008685.2	cp32-4	18959	20057	1098	100.0	8.352e-251
GCF_040790805.1_ASM4079080v1_genomic	NZ_CP161194.1	26174	26696	522	renamed_GCF_000008685.2	cp32-8	26381	26903	522	100.0	1.338e-114
GCF_040790805.1_ASM4079080v1_genomic	NZ_CP161194.1	28043	28583	540	renamed_GCF_000008685.2	cp32-8	28250	28790	540	100.0	1.472e-116
GCF_040790805.1_ASM4079080v1_genomic	NZ_CP161194.1	29325	30678	1353	renamed_GCF_000008685.2	cp32-8	29532	30885	1353	100.0	6.259e-306
GCF_040790805.1_ASM4079080v1_genomic	NZ_CP161202.1	538	967	429	renamed_GCF_000008685.2	cp32-9	17301	17730	429	100.0	2.284e-93
GCF_040790805.1_ASM4079080v1_genomic	NZ_CP161202.1	3511	4078	567	renamed_GCF_000008685.2	cp32-9	20274	20841	567	100.0	1.456e-129
GCF_040790805.1_ASM4079080v1_genomic	NZ_CP161202.1	4850	5411	561	renamed_GCF_000008685.2	cp32-9	21613	22174	561	100.0	6.308e-121
GCF_040790805.1_ASM4079080v1_genomic	NZ_CP161202.1	6430	7756	1326	renamed_GCF_000008685.2	cp32-9	23193	24519	1326	100.0	7.132e-300
GCF_040790805.1_ASM4079080v1_genomic	NZ_CP161202.1	9446	10007	561	renamed_GCF_000008685.2	cp32-9	26209	26770	561	100.0	4.739e-124
GCF_040790805.1_ASM4079080v1_genomic	NZ_CP161197.1	5486	6059	573	renamed_GCF_000008685.2	lp28-2	5377	5950	573	100.0	1.602e-129
GCF_040790805.1_ASM4079080v1_genomic	NZ_CP161197.1	6845	7397	552	renamed_GCF_000008685.2	lp28-2	6736	7288	552	100.0	2.704e-120
GCF_040790805.1_ASM4079080v1_genomic	NZ_CP161197.1	11600	11171	429	renamed_GCF_000008685.2	lp28-2	11491	11062	429	100.0	3.057e-90
GCF_040790805.1_ASM4079080v1_genomic	NZ_CP161197.1	12861	12417	444	renamed_GCF_000008685.2	lp28-2	12752	12308	444	100.0	8.866e-98
GCF_040790805.1_ASM4079080v1_genomic	NZ_CP161197.1	13604	13265	339	renamed_GCF_000008685.2	lp28-2	13495	13156	339	100.0	3.422e-74
GCF_040790805.1_ASM4079080v1_genomic	NZ_CP161197.1	14994	14484	510	renamed_GCF_000008685.2	lp28-2	14885	14375	510	100.0	3.606e-110
GCF_040790805.1_ASM4079080v1_genomic	NZ_CP161197.1	16591	15565	1026	renamed_GCF_000008685.2	lp28-2	16482	15456	1026	100.0	1.723e-230
GCF_040790805.1_ASM4079080v1_genomic	NZ_CP161197.1	18128	17789	339	renamed_GCF_000008685.2	lp28-2	18019	17680	339	100.0	5.085e-70
GCF_040790805.1_ASM4079080v1_genomic	NZ_CP161197.1	19728	18945	783	renamed_GCF_000008685.2	lp28-2	19619	18836	783	100.0	1.354e-183
GCF_040790805.1_ASM4079080v1_genomic	NZ_CP161193.1	14878	14338	540	renamed_GCF_000008685.2	lp36	14841	14301	540	100.0	2.234e-120
GCF_040790805.1_ASM4079080v1_genomic	NZ_CP161193.1	17416	17620	204	renamed_GCF_000008685.2	lp36	17379	17583	204	100.0	8.441e-43
GCF_040790805.1_ASM4079080v1_genomic	NZ_CP161193.1	21948	22170	222	renamed_GCF_000008685.2	lp36	21911	22133	222	100.0	1.866e-45
GCF_040790805.1_ASM4079080v1_genomic	NZ_CP161193.1	31622	30755	867	renamed_GCF_000008685.2	lp36	31585	30718	867	100.0	3.181e-188
GCF_040790805.1_ASM4079080v1_genomic	NZ_CP161193.1	34116	33117	999	renamed_GCF_000008685.2	lp36	34079	33080	999	100.0	2.04e-215