QUERY_ID	QUERY_NAME	QUERY_START	QUERY_END	QUERY_LENGTH	REF_ID	REF_NAME	REF_START	REF_END	REF_LENGTH	IDENTITY	EVALUE
XYZ459H	contig_1	63	627	564	renamed_GCF_000008685.2	chromosome	104	677	564	98.9	4.519e-125
XYZ459H	contig_1	3372	5166	1794	renamed_GCF_000008685.2	chromosome	3418	5188	1794	99.3	0.0
XYZ459H	contig_1	6284	5228	1056	renamed_GCF_000008685.2	chromosome	6306	5250	1056	98.8	1.902e-234
XYZ459H	contig_1	8296	7438	858	renamed_GCF_000008685.2	chromosome	8315	7457	858	99.6	1.438e-195
XYZ459H	contig_1	9182	10187	1005	renamed_GCF_000008685.2	chromosome	9201	10206	1005	99.7	3.77e-218
XYZ459H	contig_1	10183	10558	375	renamed_GCF_000008685.2	chromosome	10202	10577	375	100.0	3.75e-79
XYZ459H	contig_1	10561	11401	840	renamed_GCF_000008685.2	chromosome	10580	11420	840	99.6	3.841e-190
XYZ459H	contig_1	12726	14709	1983	renamed_GCF_000008685.2	chromosome	12745	14728	1983	99.6	0.0
XYZ459H	contig_1	15703	15325	378	renamed_GCF_000008685.2	chromosome	15716	15344	378	99.1	3.937e-79
XYZ459H	contig_1	51246	50484	762	renamed_GCF_000008685.2	chromosome	51251	50489	762	100.0	1.168e-164
XYZ459H	contig_1	53456	52448	1008	renamed_GCF_000008685.2	chromosome	53461	52453	1008	100.0	6.65e-221
XYZ459H	contig_1	56275	55495	780	renamed_GCF_000008685.2	chromosome	56280	55500	780	99.6	1.628e-172
XYZ459H	contig_1	57180	56826	354	renamed_GCF_000008685.2	chromosome	57185	56831	354	98.2	6.554e-78
XYZ459H	contig_1	60033	59094	939	renamed_GCF_000008685.2	chromosome	60039	59100	939	99.3	4.489e-205
XYZ459H	contig_1	60527	60029	498	renamed_GCF_000008685.2	chromosome	60533	60035	498	99.3	3.608e-108
XYZ459H	contig_1	63140	64022	882	renamed_GCF_000008685.2	chromosome	63146	64028	882	99.6	6.762e-191
XYZ459H	contig_1	65284	65746	462	renamed_GCF_000008685.2	chromosome	65290	65752	462	100.0	3.193e-95
XYZ459H	contig_1	69556	70117	561	renamed_GCF_000008685.2	chromosome	69565	70126	561	99.4	8.395e-118
XYZ459H	contig_1	94593	94206	387	renamed_GCF_000008685.2	chromosome	94605	94218	387	100.0	1.031e-86
XYZ459H	contig_1	97854	96930	924	renamed_GCF_000008685.2	chromosome	97866	96942	924	99.6	1.753e-204
XYZ459H	contig_1	98803	100192	1389	renamed_GCF_000008685.2	chromosome	98816	100205	1389	99.7	4.799e-315
XYZ459H	contig_1	101326	100732	594	renamed_GCF_000008685.2	chromosome	101339	100745	594	100.0	6.255e-135
XYZ459H	contig_1	112755	112335	420	renamed_GCF_000008685.2	chromosome	112769	112349	420	97.8	3.541e-87
XYZ459H	contig_1	114793	115495	702	renamed_GCF_000008685.2	chromosome	114806	115508	702	99.1	1.161e-154
XYZ459H	contig_1	118916	118361	555	renamed_GCF_000008685.2	chromosome	118929	118374	555	99.4	3.776e-117
XYZ459H	contig_1	120576	119793	783	renamed_GCF_000008685.2	chromosome	120589	119806	783	100.0	5.024e-169
XYZ459H	contig_1	121809	121086	723	renamed_GCF_000008685.2	chromosome	121823	121100	723	99.1	4.138e-161
XYZ459H	contig_1	152196	153003	807	renamed_GCF_000008685.2	chromosome	152205	153012	807	100.0	9.769e-183
XYZ459H	contig_1	156391	153691	2700	renamed_GCF_000008685.2	chromosome	156400	153700	2700	99.7	0.0
XYZ459H	contig_1	157618	158053	435	renamed_GCF_000008685.2	chromosome	157626	158061	435	99.3	1.372e-91
XYZ459H	contig_1	171089	170711	378	renamed_GCF_000008685.2	chromosome	171097	170719	378	100.0	1.603e-80
XYZ459H	contig_1	173572	171523	2049	renamed_GCF_000008685.2	chromosome	173535	171531	2049	98.9	0.0
XYZ459H	contig_1	175076	174089	987	renamed_GCF_000008685.2	chromosome	174970	174097	987	98.2	1.865e-188
XYZ459H	contig_1	177845	176969	876	renamed_GCF_000008685.2	chromosome	177853	176977	876	100.0	9.427e-195
XYZ459H	contig_1	189851	189290	561	renamed_GCF_000008685.2	chromosome	189859	189298	561	100.0	1.275e-121
XYZ459H	contig_1	190723	191464	741	renamed_GCF_000008685.2	chromosome	190718	191459	741	98.7	8.782e-156
XYZ459H	contig_1	194882	195743	861	renamed_GCF_000008685.2	chromosome	194875	195736	861	98.9	3.489e-186
XYZ459H	contig_1	202585	201058	1527	renamed_GCF_000008685.2	chromosome	202578	201051	1527	96.8	0.0
XYZ459H	contig_1	202856	204095	1239	renamed_GCF_000008685.2	chromosome	202849	204088	1239	100.0	5.514e-262
XYZ459H	contig_1	206535	208086	1551	renamed_GCF_000008685.2	chromosome	206528	208106	1551	99.8	0.0
XYZ459H	contig_1	208626	208089	537	renamed_GCF_000008685.2	chromosome	208581	208083	537	98.7	8.112e-106
XYZ459H	contig_1	245633	246398	765	renamed_GCF_000008685.2	chromosome	245789	246554	765	100.0	7.663e-170
XYZ459H	contig_1	248370	249933	1563	renamed_GCF_000008685.2	chromosome	248505	250089	1563	99.6	0.0
XYZ459H	contig_1	251055	250500	555	renamed_GCF_000008685.2	chromosome	251211	250656	555	100.0	3.12e-119
XYZ459H	contig_1	252277	252883	606	renamed_GCF_000008685.2	chromosome	252433	253039	606	99.5	2.035e-132
XYZ459H	contig_1	254788	255493	705	renamed_GCF_000008685.2	chromosome	254944	255649	705	100.0	7.263e-152
XYZ459H	contig_1	285803	283712	2091	renamed_GCF_000008685.2	chromosome	285962	283868	2091	99.5	0.0
XYZ459H	contig_1	287721	286932	789	renamed_GCF_000008685.2	chromosome	287877	287088	789	98.8	2.148e-162
XYZ459H	contig_1	288790	288025	765	renamed_GCF_000008685.2	chromosome	288946	288181	765	99.6	2.721e-164
XYZ459H	contig_1	289427	288800	627	renamed_GCF_000008685.2	chromosome	289583	288956	627	94.7	5.001e-126
XYZ459H	contig_1	300608	299573	1035	renamed_GCF_000008685.2	chromosome	300764	299729	1035	100.0	3.255e-216
XYZ459H	contig_1	302683	302347	336	renamed_GCF_000008685.2	chromosome	302839	302503	336	99.0	5.906e-68
XYZ459H	contig_1	303584	303176	408	renamed_GCF_000008685.2	chromosome	303740	303332	408	99.2	2.649e-88
XYZ459H	contig_1	305505	304956	549	renamed_GCF_000008685.2	chromosome	305661	305112	549	100.0	9.24e-115
XYZ459H	contig_1	306461	305513	948	renamed_GCF_000008685.2	chromosome	306615	305670	948	99.0	4.292e-207
XYZ459H	contig_1	307160	306467	693	renamed_GCF_000008685.2	chromosome	307317	306624	693	99.5	6.606e-151
XYZ459H	contig_1	308360	307160	1200	renamed_GCF_000008685.2	chromosome	308517	307317	1200	99.7	1.629e-260
XYZ459H	contig_1	318980	318140	840	renamed_GCF_000008685.2	chromosome	319116	318276	840	99.6	1.977e-180
XYZ459H	contig_1	488101	488848	747	renamed_GCF_000008685.2	chromosome	488225	488972	747	99.1	2.05e-164
XYZ459H	contig_1	488858	489371	513	renamed_GCF_000008685.2	chromosome	488982	489495	513	98.8	1.701e-110
XYZ459H	contig_1	489367	489595	228	renamed_GCF_000008685.2	chromosome	489539	489719	228	96.6	1.618e-32
XYZ459H	contig_1	498931	499210	279	renamed_GCF_000008685.2	chromosome	499055	499334	279	100.0	1.411e-57
XYZ459H	contig_1	499216	499579	363	renamed_GCF_000008685.2	chromosome	499340	499703	363	100.0	3.407e-78
XYZ459H	contig_1	499582	500464	882	renamed_GCF_000008685.2	chromosome	499706	500588	882	100.0	1.248e-192
XYZ459H	contig_1	500468	500885	417	renamed_GCF_000008685.2	chromosome	500592	501009	417	100.0	2.778e-89
XYZ459H	contig_1	500887	501088	201	renamed_GCF_000008685.2	chromosome	501014	501212	201	98.4	1.098e-39
XYZ459H	contig_1	501090	501345	255	renamed_GCF_000008685.2	chromosome	501214	501469	255	100.0	1.745e-51
XYZ459H	contig_1	501372	501741	369	renamed_GCF_000008685.2	chromosome	501496	501865	369	99.1	4.571e-76
XYZ459H	contig_1	501755	502061	306	renamed_GCF_000008685.2	chromosome	501879	502185	306	100.0	2.959e-62
XYZ459H	contig_1	502066	502615	549	renamed_GCF_000008685.2	chromosome	502190	502739	549	100.0	1.698e-116
XYZ459H	contig_1	502631	502817	186	renamed_GCF_000008685.2	chromosome	502755	502941	186	100.0	7.664e-41
XYZ459H	contig_1	507689	508724	1035	renamed_GCF_000008685.2	chromosome	507813	508848	1035	99.4	2.25e-220
XYZ459H	contig_1	508745	509117	372	renamed_GCF_000008685.2	chromosome	508869	509241	372	100.0	8.775e-78
XYZ459H	contig_1	509189	510722	1533	renamed_GCF_000008685.2	chromosome	509313	510846	1533	100.0	0.0
XYZ459H	contig_1	542135	542897	762	renamed_GCF_000008685.2	chromosome	542262	543024	762	99.6	1.226e-172
XYZ459H	contig_1	542921	543689	768	renamed_GCF_000008685.2	chromosome	543048	543816	768	100.0	8.433e-178
XYZ459H	contig_1	543704	544478	774	renamed_GCF_000008685.2	chromosome	543831	544605	774	99.6	8.828e-170
XYZ459H	contig_1	544458	547260	2802	renamed_GCF_000008685.2	chromosome	544585	547387	2802	98.3	0.0
XYZ459H	contig_1	557777	557159	618	renamed_GCF_000008685.2	chromosome	558024	557406	618	97.5	7.989e-128
XYZ459H	contig_1	560485	557758	2727	renamed_GCF_000008685.2	chromosome	560732	558005	2727	99.1	0.0
XYZ459H	contig_1	560880	560481	399	renamed_GCF_000008685.2	chromosome	561127	560728	399	93.1	1.493e-76
XYZ459H	contig_1	664761	662928	1833	renamed_GCF_000008685.2	chromosome	665011	663178	1833	99.8	0.0
XYZ459H	contig_1	668267	664757	3510	renamed_GCF_000008685.2	chromosome	668517	665007	3510	99.7	0.0
XYZ459H	contig_1	672961	671515	1446	renamed_GCF_000008685.2	chromosome	673167	671766	1446	98.9	1.087e-306
XYZ459H	contig_1	673090	674527	1437	renamed_GCF_000008685.2	chromosome	673341	674778	1437	100.0	0.0
XYZ459H	contig_1	674783	675998	1215	renamed_GCF_000008685.2	chromosome	675034	676378	1215	99.5	7.027e-264
XYZ459H	contig_1	676216	677605	1389	renamed_GCF_000008685.2	chromosome	676471	677860	1389	100.0	1.442e-302
XYZ459H	contig_1	699698	698132	1566	renamed_GCF_000008685.2	chromosome	699965	698399	1566	100.0	0.0
XYZ459H	contig_1	700657	699784	873	renamed_GCF_000008685.2	chromosome	700924	700051	873	100.0	5.874e-191
XYZ459H	contig_1	700761	701118	357	renamed_GCF_000008685.2	chromosome	701028	701385	357	100.0	2.301e-81
XYZ459H	contig_1	730828	730360	468	renamed_GCF_000008685.2	chromosome	731099	730631	468	98.7	2.169e-100
XYZ459H	contig_1	731522	733532	2010	renamed_GCF_000008685.2	chromosome	731793	733803	2010	99.4	0.0
XYZ459H	contig_1	735078	736413	1335	renamed_GCF_000008685.2	chromosome	735351	736686	1335	99.7	2.962e-285
XYZ459H	contig_1	736938	737439	501	renamed_GCF_000008685.2	chromosome	737211	737712	501	99.3	4.586e-106
XYZ459H	contig_1	737435	738155	720	renamed_GCF_000008685.2	chromosome	737708	738428	720	99.5	4.764e-159
XYZ459H	contig_1	749758	750517	759	renamed_GCF_000008685.2	chromosome	750030	750789	759	99.6	2.476e-164
XYZ459H	contig_1	751897	752947	1050	renamed_GCF_000008685.2	chromosome	752169	753219	1050	100.0	6.109e-229
XYZ459H	contig_1	753795	754278	483	renamed_GCF_000008685.2	chromosome	754067	754550	483	100.0	1.405e-107
XYZ459H	contig_1	756081	757398	1317	renamed_GCF_000008685.2	chromosome	756353	757670	1317	99.5	2.871e-291
XYZ459H	contig_1	816941	816050	891	renamed_GCF_000008685.2	chromosome	817160	816311	891	99.6	1.029e-187
XYZ459H	contig_1	817761	818292	531	renamed_GCF_000008685.2	chromosome	818017	818548	531	100.0	1.403e-115
XYZ459H	contig_1	818665	818986	321	renamed_GCF_000008685.2	chromosome	819035	819242	321	97.0	1.267e-41
XYZ459H	contig_1	820350	820932	582	renamed_GCF_000008685.2	chromosome	820606	821188	582	100.0	9.143e-129
XYZ459H	contig_1	822087	822438	351	renamed_GCF_000008685.2	chromosome	822343	822694	351	99.1	1.534e-76
XYZ459H	contig_1	822553	822847	294	renamed_GCF_000008685.2	chromosome	822809	823103	294	100.0	1.207e-61
XYZ459H	contig_1	823559	824126	567	renamed_GCF_000008685.2	chromosome	823815	824382	567	99.4	6.307e-122
XYZ459H	contig_1	827374	828856	1482	renamed_GCF_000008685.2	chromosome	827630	829112	1482	98.9	0.0
XYZ459H	contig_1	830685	830061	624	renamed_GCF_000008685.2	chromosome	830941	830317	624	99.5	5.702e-141
XYZ459H	contig_1	863358	864765	1407	renamed_GCF_000008685.2	chromosome	863635	865042	1407	98.7	8.36e-312
XYZ459H	contig_1	865638	866181	543	renamed_GCF_000008685.2	chromosome	865915	866458	543	98.8	6.309e-118
XYZ459H	contig_1	866216	866417	201	renamed_GCF_000008685.2	chromosome	866493	866694	201	100.0	2.206e-40
XYZ459H	contig_1	867837	867465	372	renamed_GCF_000008685.2	chromosome	868114	867742	372	99.1	1.771e-78
XYZ459H	contig_1	869237	868454	783	renamed_GCF_000008685.2	chromosome	869380	868732	783	98.6	2.119e-144
XYZ459H	contig_1	892850	896291	3441	renamed_GCF_000008685.2	chromosome	893128	896569	3441	98.2	0.0
XYZ459H	contig_1	897417	896817	600	renamed_GCF_000008685.2	chromosome	897695	897095	600	99.4	6.881e-135
XYZ459H	contig_1	899219	900452	1233	renamed_GCF_000008685.2	chromosome	899498	900731	1233	99.5	8.235e-274
XYZ459H	contig_1	901554	902979	1425	renamed_GCF_000008685.2	chromosome	901833	903258	1425	99.1	7.174e-308
XYZ459H	contig_3	19786	20683	897	renamed_GCF_000008685.2	lp28-3	16518	17415	897	97.9	9.029e-199
XYZ459H	contig_3	21214	21970	756	renamed_GCF_000008685.2	lp28-3	17946	18702	756	99.6	4.353e-166
XYZ459H	contig_3	24737	25487	750	renamed_GCF_000008685.2	lp28-3	21469	22219	750	99.5	3.127e-160
XYZ459H	contig_3	29732	28769	963	renamed_GCF_000008685.2	lp28-3	26371	25432	963	90.6	1.699e-185
XYZ459H	contig_4	843	51	792	renamed_GCF_000008685.2	lp54	48267	47475	792	98.8	2.603e-169
XYZ459H	contig_4	10798	11554	756	renamed_GCF_000008685.2	lp54	47228	46472	756	98.0	1.408e-161
XYZ459H	contig_4	13196	14426	1230	renamed_GCF_000008685.2	lp54	45947	44711	1230	98.7	4.376e-263
XYZ459H	contig_4	15616	16525	909	renamed_GCF_000008685.2	lp54	43532	42623	909	99.6	5.38e-198
XYZ459H	contig_4	17129	17753	624	renamed_GCF_000008685.2	lp54	42019	41395	624	99.5	1.532e-138
XYZ459H	contig_4	19036	19276	240	renamed_GCF_000008685.2	lp54	40112	39872	240	100.0	3.722e-49
XYZ459H	contig_5	27483	27912	429	renamed_GCF_000008685.2	cp32-3	17802	18249	429	78.6	3.22e-73
XYZ459H	contig_6	173	938	765	renamed_GCF_000008685.2	lp28-2	29618	28853	765	100.0	1.703e-169
XYZ459H	contig_6	2679	1851	828	renamed_GCF_000008685.2	lp28-2	27112	27940	828	97.8	2.167e-177
XYZ459H	contig_6	24383	23810	573	renamed_GCF_000008685.2	lp28-2	5377	5950	573	97.8	4.31e-127
XYZ459H	contig_6	25704	26169	465	renamed_GCF_000008685.2	lp28-3	27445	26977	465	97.7	9.953e-92
XYZ459H	contig_6	28698	27768	930	renamed_GCF_000008685.2	lp28-2	1046	1928	930	97.9	7.053e-190
XYZ459H	contig_7	12407	13511	1104	renamed_GCF_000008685.2	lp28-4	10814	11927	1104	98.3	1.21e-247
XYZ459H	contig_7	14037	14790	753	renamed_GCF_000008685.2	lp28-4	12453	13206	753	100.0	4.561e-165
XYZ459H	contig_8	23481	23955	474	renamed_GCF_000008685.2	lp54	5140	4666	474	98.7	2.628e-99
XYZ459H	contig_8	25728	26577	849	renamed_GCF_000008685.2	lp54	2893	2044	849	100.0	5.332e-188
XYZ459H	contig_8	27971	27485	486	renamed_GCF_000008685.2	lp28-3	28197	27624	486	48.4	2.052e-45
XYZ459H	contig_9	6853	7090	237	renamed_GCF_000008685.2	cp32-7	8725	8962	237	79.4	8.093e-41
XYZ459H	contig_9	9950	10496	546	renamed_GCF_000008685.2	cp32-7	11927	12473	546	82.8	8.187e-99
XYZ459H	contig_11	17450	16586	864	renamed_GCF_000008685.2	lp25	6897	7761	864	99.3	1.905e-193
XYZ459H	contig_12	287	794	507	renamed_GCF_000008685.2	lp56	52608	52134	507	81.0	1.982e-74
XYZ459H	contig_12	10006	9712	294	renamed_GCF_000008685.2	lp17	9980	9590	294	94.7	6.621e-60
XYZ459H	contig_12	14186	14456	270	renamed_GCF_000008685.2	lp17	14069	14339	270	98.8	7.394e-55
XYZ459H	contig_13	1389	1725	336	renamed_GCF_000008685.2	lp56	19256	19592	336	100.0	5.348e-69
XYZ459H	contig_14	6294	6822	528	renamed_GCF_000008685.2	cp32-4	27675	28203	528	90.2	3.482e-105
XYZ459H	contig_19	284	899	615	renamed_GCF_000008685.2	lp56	20843	21455	615	92.6	7.62e-128
XYZ459H	contig_20	786	990	204	renamed_GCF_000008685.2	cp32-1	15214	15418	204	100.0	2.578e-39
XYZ459H	contig_1	103758	103002	756	renamed_GCF_000008685.2	chromosome	103771	103015	756	99.6	2.151e-165
XYZ459H	contig_1	105418	103750	1668	renamed_GCF_000008685.2	chromosome	105299	103763	1668	99.8	0.0
XYZ459H	contig_1	105842	105404	438	renamed_GCF_000008685.2	chromosome	105846	105417	438	97.8	2.122e-87
XYZ459H	contig_1	106881	105870	1011	renamed_GCF_000008685.2	chromosome	106894	105883	1011	100.0	4.14e-218
XYZ459H	contig_1	108157	106960	1197	renamed_GCF_000008685.2	chromosome	108170	106973	1197	99.4	9.224e-258
XYZ459H	contig_1	108293	109658	1365	renamed_GCF_000008685.2	chromosome	108306	109671	1365	99.7	2.146e-311
XYZ459H	contig_1	165879	164892	987	renamed_GCF_000008685.2	chromosome	165887	164900	987	99.6	2.948e-209
XYZ459H	contig_1	167751	165906	1845	renamed_GCF_000008685.2	chromosome	167759	165914	1845	99.5	0.0
XYZ459H	contig_1	169391	167870	1521	renamed_GCF_000008685.2	chromosome	169399	167878	1521	99.8	0.0
XYZ459H	contig_1	169530	170700	1170	renamed_GCF_000008685.2	chromosome	169562	170708	1170	99.2	3.281e-256
XYZ459H	contig_1	181397	179531	1866	renamed_GCF_000008685.2	chromosome	181405	179539	1866	99.5	0.0
XYZ459H	contig_1	182794	181399	1395	renamed_GCF_000008685.2	chromosome	182802	181407	1395	100.0	4.219e-300
XYZ459H	contig_1	182877	183372	495	renamed_GCF_000008685.2	chromosome	182885	183380	495	100.0	9.271e-106
XYZ459H	contig_1	186545	186938	393	renamed_GCF_000008685.2	chromosome	186553	186946	393	100.0	5.626e-86
XYZ459H	contig_1	219643	220483	840	renamed_GCF_000008685.2	chromosome	219799	220639	840	100.0	1.641e-182
XYZ459H	contig_1	220572	221481	909	renamed_GCF_000008685.2	chromosome	220728	221637	909	99.3	4.638e-191
XYZ459H	contig_1	221477	223022	1545	renamed_GCF_000008685.2	chromosome	221741	223178	1545	98.5	7.687e-310
XYZ459H	contig_1	223022	223805	783	renamed_GCF_000008685.2	chromosome	223178	223961	783	98.8	4.166e-171
XYZ459H	contig_1	224629	223807	822	renamed_GCF_000008685.2	chromosome	224785	223963	822	100.0	3.638e-179
XYZ459H	contig_1	226455	224670	1785	renamed_GCF_000008685.2	chromosome	226610	224825	1785	99.8	0.0
XYZ459H	contig_1	227672	226454	1218	renamed_GCF_000008685.2	chromosome	227827	226609	1218	100.0	6.126e-266
XYZ459H	contig_1	228366	227658	708	renamed_GCF_000008685.2	chromosome	228521	227813	708	99.5	4.758e-157
XYZ459H	contig_1	240095	238988	1107	renamed_GCF_000008685.2	chromosome	240250	239143	1107	99.4	4.077e-243
XYZ459H	contig_1	242134	240127	2007	renamed_GCF_000008685.2	chromosome	242289	240282	2007	99.1	0.0
XYZ459H	contig_1	242282	243848	1566	renamed_GCF_000008685.2	chromosome	242437	244003	1566	98.8	0.0
XYZ459H	contig_1	244558	243787	771	renamed_GCF_000008685.2	chromosome	244713	243942	771	99.6	9.248e-169
XYZ459H	contig_1	255489	256104	615	renamed_GCF_000008685.2	chromosome	255645	256260	615	99.5	2.579e-131
XYZ459H	contig_1	256306	258829	2523	renamed_GCF_000008685.2	chromosome	256462	258985	2523	98.4	0.0
XYZ459H	contig_1	263556	261135	2421	renamed_GCF_000008685.2	chromosome	263712	261291	2421	99.8	0.0
XYZ459H	contig_1	263831	265958	2127	renamed_GCF_000008685.2	chromosome	263987	266114	2127	99.5	0.0
XYZ459H	contig_1	265950	266895	945	renamed_GCF_000008685.2	chromosome	266106	267051	945	100.0	6.277e-211
XYZ459H	contig_1	279224	278921	303	renamed_GCF_000008685.2	chromosome	279380	279077	303	95.0	1.398e-61
XYZ459H	contig_1	281155	279250	1905	renamed_GCF_000008685.2	chromosome	281311	279406	1905	99.6	0.0
XYZ459H	contig_1	281637	281157	480	renamed_GCF_000008685.2	chromosome	281793	281313	480	99.3	2.386e-101
XYZ459H	contig_1	282531	281643	888	renamed_GCF_000008685.2	chromosome	282687	281799	888	100.0	4.025e-189
XYZ459H	contig_1	292270	291487	783	renamed_GCF_000008685.2	chromosome	292426	291643	783	100.0	1.874e-171
XYZ459H	contig_1	293052	292269	783	renamed_GCF_000008685.2	chromosome	293208	292425	783	100.0	6.057e-167
XYZ459H	contig_1	293273	293048	225	renamed_GCF_000008685.2	chromosome	293429	293204	225	100.0	8.8e-46
XYZ459H	contig_1	294621	293295	1326	renamed_GCF_000008685.2	chromosome	294780	293451	1326	99.7	5.57e-294
XYZ459H	contig_1	295072	294628	444	renamed_GCF_000008685.2	chromosome	295228	294784	444	100.0	1.185e-94
XYZ459H	contig_1	296264	295085	1179	renamed_GCF_000008685.2	chromosome	296420	295241	1179	99.2	2.863e-259
XYZ459H	contig_1	315178	314287	891	renamed_GCF_000008685.2	chromosome	315314	314423	891	99.3	4.889e-196
XYZ459H	contig_1	316007	315170	837	renamed_GCF_000008685.2	chromosome	316143	315306	837	99.2	1.426e-183
XYZ459H	contig_1	317080	316003	1077	renamed_GCF_000008685.2	chromosome	317216	316139	1077	99.7	9.003e-238
XYZ459H	contig_1	317869	317110	759	renamed_GCF_000008685.2	chromosome	318005	317246	759	100.0	1.223e-163
XYZ459H	contig_1	364958	364007	951	renamed_GCF_000008685.2	chromosome	364972	364129	951	99.6	1.174e-187
XYZ459H	contig_1	365480	364991	489	renamed_GCF_000008685.2	chromosome	365603	365114	489	100.0	3.787e-106
XYZ459H	contig_1	366837	366105	732	renamed_GCF_000008685.2	chromosome	366960	366228	732	98.7	5.755e-159
XYZ459H	contig_1	368332	368758	426	renamed_GCF_000008685.2	chromosome	368455	368881	426	92.1	1.555e-80
XYZ459H	contig_1	391696	390271	1425	renamed_GCF_000008685.2	chromosome	391819	390391	1425	100.0	0.0
XYZ459H	contig_1	392834	391808	1026	renamed_GCF_000008685.2	chromosome	392957	391931	1026	98.5	8.027e-222
XYZ459H	contig_1	393940	392920	1020	renamed_GCF_000008685.2	chromosome	394063	393043	1020	100.0	6.665e-223
XYZ459H	contig_1	395043	393981	1062	renamed_GCF_000008685.2	chromosome	395166	394104	1062	99.7	9.401e-235
XYZ459H	contig_1	408258	408078	180	renamed_GCF_000008685.2	chromosome	408380	408200	180	100.0	2.118e-37
XYZ459H	contig_1	409280	408431	849	renamed_GCF_000008685.2	chromosome	409402	408553	849	99.6	2.186e-189
XYZ459H	contig_1	410325	409293	1032	renamed_GCF_000008685.2	chromosome	410447	409415	1032	99.7	1.086e-236
XYZ459H	contig_1	410666	411326	660	renamed_GCF_000008685.2	chromosome	410786	411446	660	98.6	2.462e-139
XYZ459H	contig_1	412880	411335	1545	renamed_GCF_000008685.2	chromosome	413006	411455	1545	99.8	0.0
XYZ459H	contig_1	412992	414195	1203	renamed_GCF_000008685.2	chromosome	413112	414315	1203	100.0	6.394e-263
XYZ459H	contig_1	446755	446206	549	renamed_GCF_000008685.2	chromosome	446875	446326	549	98.9	2.344e-121
XYZ459H	contig_1	447524	446849	675	renamed_GCF_000008685.2	chromosome	447736	446968	675	99.5	9.618e-144
XYZ459H	contig_1	447735	448053	318	renamed_GCF_000008685.2	chromosome	447854	448172	318	100.0	8.883e-69
XYZ459H	contig_1	448472	448082	390	renamed_GCF_000008685.2	chromosome	448591	448201	390	100.0	7.926e-82
XYZ459H	contig_1	459931	460291	360	renamed_GCF_000008685.2	chromosome	460051	460411	360	99.1	5.311e-73
XYZ459H	contig_1	461924	462653	729	renamed_GCF_000008685.2	chromosome	462044	462773	729	99.1	5.489e-159
XYZ459H	contig_1	462698	463766	1068	renamed_GCF_000008685.2	chromosome	462818	463886	1068	99.7	2.217e-243
XYZ459H	contig_1	463932	465012	1080	renamed_GCF_000008685.2	chromosome	464052	465132	1080	100.0	9.122e-247
XYZ459H	contig_1	467158	465397	1761	renamed_GCF_000008685.2	chromosome	467278	465517	1761	99.6	0.0
XYZ459H	contig_1	496490	497111	621	renamed_GCF_000008685.2	chromosome	496614	497235	621	99.5	8.732e-136
XYZ459H	contig_1	497120	497750	630	renamed_GCF_000008685.2	chromosome	497244	497874	630	100.0	4.528e-136
XYZ459H	contig_1	497770	498067	297	renamed_GCF_000008685.2	chromosome	497894	498191	297	100.0	5.69e-62
XYZ459H	contig_1	498088	498922	834	renamed_GCF_000008685.2	chromosome	498212	499046	834	100.0	1.895e-188
XYZ459H	contig_1	502826	503225	399	renamed_GCF_000008685.2	chromosome	502950	503349	399	100.0	3.071e-85
XYZ459H	contig_1	503241	503784	543	renamed_GCF_000008685.2	chromosome	503365	503908	543	100.0	7.636e-116
XYZ459H	contig_1	503801	504161	360	renamed_GCF_000008685.2	chromosome	503925	504285	360	99.1	2.162e-74
XYZ459H	contig_1	504173	504671	498	renamed_GCF_000008685.2	chromosome	504297	504795	498	99.3	8.835e-107
XYZ459H	contig_1	504674	504980	306	renamed_GCF_000008685.2	chromosome	504798	505104	306	99.0	3.271e-61
XYZ459H	contig_1	504979	505417	438	renamed_GCF_000008685.2	chromosome	505103	505541	438	100.0	1.186e-93
XYZ459H	contig_1	531564	531000	564	renamed_GCF_000008685.2	chromosome	531692	531128	564	100.0	2.704e-122
XYZ459H	contig_1	534173	535028	855	renamed_GCF_000008685.2	chromosome	534300	535155	855	99.2	2.402e-189
XYZ459H	contig_1	535473	535050	423	renamed_GCF_000008685.2	chromosome	535600	535177	423	99.2	2.776e-90
XYZ459H	contig_1	548363	547718	645	renamed_GCF_000008685.2	chromosome	548490	547845	645	99.5	2.348e-137
XYZ459H	contig_1	548758	548359	399	renamed_GCF_000008685.2	chromosome	548885	548486	399	99.2	3.385e-84
XYZ459H	contig_1	549491	548792	699	renamed_GCF_000008685.2	chromosome	549618	548919	699	99.5	2.351e-146
XYZ459H	contig_1	551596	549514	2082	renamed_GCF_000008685.2	chromosome	551723	549641	2082	100.0	0.0
XYZ459H	contig_1	576262	575716	546	renamed_GCF_000008685.2	chromosome	576499	575980	546	100.0	1.781e-115
XYZ459H	contig_1	576923	576317	606	renamed_GCF_000008685.2	chromosome	577187	576581	606	100.0	4.975e-131
XYZ459H	contig_1	577130	577673	543	renamed_GCF_000008685.2	chromosome	577394	577937	543	99.4	3.433e-116
XYZ459H	contig_1	577685	577997	312	renamed_GCF_000008685.2	chromosome	577949	578261	312	100.0	5.387e-65
XYZ459H	contig_1	578012	580157	2145	renamed_GCF_000008685.2	chromosome	578276	580421	2145	99.1	0.0
XYZ459H	contig_1	580221	581379	1158	renamed_GCF_000008685.2	chromosome	580485	581643	1158	100.0	7.971e-253
XYZ459H	contig_1	581380	583153	1773	renamed_GCF_000008685.2	chromosome	581644	583417	1773	100.0	0.0
XYZ459H	contig_1	583193	583568	375	renamed_GCF_000008685.2	chromosome	583457	583832	375	100.0	8.349e-79
XYZ459H	contig_1	584628	583938	690	renamed_GCF_000008685.2	chromosome	584880	584190	690	99.1	4.749e-154
XYZ459H	contig_1	584839	585904	1065	renamed_GCF_000008685.2	chromosome	585079	586156	1065	98.0	9.851e-235
XYZ459H	contig_1	599252	600602	1350	renamed_GCF_000008685.2	chromosome	599494	600844	1350	100.0	3.989e-293
XYZ459H	contig_1	600767	602102	1335	renamed_GCF_000008685.2	chromosome	601009	602344	1335	99.7	1.56e-292
XYZ459H	contig_1	602131	603487	1356	renamed_GCF_000008685.2	chromosome	602373	603729	1356	99.1	5.612e-299
XYZ459H	contig_1	604527	603483	1044	renamed_GCF_000008685.2	chromosome	604769	603725	1044	100.0	3.194e-235
XYZ459H	contig_1	606741	604536	2205	renamed_GCF_000008685.2	chromosome	606983	604778	2205	99.4	0.0
XYZ459H	contig_1	606895	607693	798	renamed_GCF_000008685.2	chromosome	607137	607935	798	99.6	4.801e-172
XYZ459H	contig_1	609664	608818	846	renamed_GCF_000008685.2	chromosome	609906	609060	846	99.6	3.649e-183
XYZ459H	contig_1	610951	609700	1251	renamed_GCF_000008685.2	chromosome	611193	609942	1251	98.7	1.89e-267
XYZ459H	contig_1	611066	611780	714	renamed_GCF_000008685.2	chromosome	611308	612022	714	99.1	2.142e-158
XYZ459H	contig_1	628706	626849	1857	renamed_GCF_000008685.2	chromosome	628948	627091	1857	99.8	0.0
XYZ459H	contig_1	630456	628953	1503	renamed_GCF_000008685.2	chromosome	630698	629195	1503	99.8	3e-323
XYZ459H	contig_1	630526	631744	1218	renamed_GCF_000008685.2	chromosome	630795	631986	1218	99.4	4.366e-261
XYZ459H	contig_1	631748	632240	492	renamed_GCF_000008685.2	chromosome	631990	632482	492	100.0	1.786e-106
XYZ459H	contig_1	632242	634222	1980	renamed_GCF_000008685.2	chromosome	632484	634464	1980	98.9	0.0
XYZ459H	contig_1	634338	635769	1431	renamed_GCF_000008685.2	chromosome	634580	636011	1431	98.3	9.218e-315
XYZ459H	contig_1	636349	637714	1365	renamed_GCF_000008685.2	chromosome	636592	637957	1365	99.1	3.824e-296
XYZ459H	contig_1	637719	638313	594	renamed_GCF_000008685.2	chromosome	637971	638556	594	99.4	7.271e-125
XYZ459H	contig_1	638336	639629	1293	renamed_GCF_000008685.2	chromosome	638579	639872	1293	99.7	6.951e-286
XYZ459H	contig_1	639597	642006	2409	renamed_GCF_000008685.2	chromosome	639858	642249	2409	99.4	0.0
XYZ459H	contig_1	653637	654600	963	renamed_GCF_000008685.2	chromosome	653886	654849	963	100.0	5.23e-216
XYZ459H	contig_1	654559	656653	2094	renamed_GCF_000008685.2	chromosome	654862	656902	2094	99.4	0.0
XYZ459H	contig_1	658648	659374	726	renamed_GCF_000008685.2	chromosome	658897	659623	726	99.1	3.767e-154
XYZ459H	contig_1	678683	677636	1047	renamed_GCF_000008685.2	chromosome	678938	677891	1047	98.8	3.051e-236
XYZ459H	contig_1	679494	678702	792	renamed_GCF_000008685.2	chromosome	679750	678958	792	99.2	7.656e-166
XYZ459H	contig_1	680307	679497	810	renamed_GCF_000008685.2	chromosome	680557	679753	810	99.2	5.794e-172
XYZ459H	contig_1	681350	680306	1044	renamed_GCF_000008685.2	chromosome	681606	680562	1044	100.0	8.539e-233
XYZ459H	contig_1	682268	681428	840	renamed_GCF_000008685.2	chromosome	682524	681684	840	100.0	1.641e-182
XYZ459H	contig_1	682421	683120	699	renamed_GCF_000008685.2	chromosome	682678	683377	699	100.0	1.337e-152
XYZ459H	contig_1	714737	716348	1611	renamed_GCF_000008685.2	chromosome	715008	716619	1611	100.0	0.0
XYZ459H	contig_1	738870	739410	540	renamed_GCF_000008685.2	chromosome	739143	739683	540	100.0	2.458e-119
XYZ459H	contig_1	739966	740149	183	renamed_GCF_000008685.2	chromosome	740239	740422	183	100.0	1.805e-39
XYZ459H	contig_1	740414	741152	738	renamed_GCF_000008685.2	chromosome	740687	741425	738	100.0	4.772e-162
XYZ459H	contig_1	742470	744243	1773	renamed_GCF_000008685.2	chromosome	742743	744516	1773	98.3	0.0
XYZ459H	contig_1	745028	746060	1032	renamed_GCF_000008685.2	chromosome	745301	746333	1032	99.4	6.089e-226
XYZ459H	contig_1	759929	761375	1446	renamed_GCF_000008685.2	chromosome	760225	761647	1446	99.1	2.357e-315
XYZ459H	contig_1	763306	764089	783	renamed_GCF_000008685.2	chromosome	763578	764361	783	100.0	1.874e-171
XYZ459H	contig_1	765100	766444	1344	renamed_GCF_000008685.2	chromosome	765372	766716	1344	100.0	2.685e-305
XYZ459H	contig_1	814436	813428	1008	renamed_GCF_000008685.2	chromosome	814697	813689	1008	99.7	5.719e-214
XYZ459H	contig_1	869745	869229	516	renamed_GCF_000008685.2	chromosome	870023	869507	516	98.8	1.784e-110
XYZ459H	contig_1	874854	872307	2547	renamed_GCF_000008685.2	chromosome	875132	872585	2547	100.0	0.0
XYZ459H	contig_1	876150	879003	2853	renamed_GCF_000008685.2	chromosome	876491	879281	2853	99.4	0.0
XYZ459H	contig_1	880813	879988	825	renamed_GCF_000008685.2	chromosome	881091	880266	825	97.8	1.884e-178
XYZ459H	contig_1	886169	883949	2220	renamed_GCF_000008685.2	chromosome	886447	884227	2220	99.5	0.0
XYZ459H	contig_2	15571	14821	750	renamed_GCF_000008685.2	lp36	14326	13576	750	93.9	9.207e-157
XYZ459H	contig_2	16089	15546	543	renamed_GCF_000008685.2	lp36	14841	14301	543	89.3	1.489e-108
XYZ459H	contig_2	17296	17896	600	renamed_GCF_000008685.2	lp36	16274	16886	600	90.3	6.348e-119
XYZ459H	contig_2	20014	19630	384	renamed_GCF_000008685.2	lp38	16519	17329	384	44.5	4.41e-30
XYZ459H	contig_4	26888	26399	489	renamed_GCF_000008685.2	lp54	32260	32749	489	100.0	3.125e-108
XYZ459H	contig_5	3275	4601	1326	renamed_GCF_000008685.2	cp32-7	23134	24460	1326	98.8	8.571e-298
XYZ459H	contig_5	9368	10721	1353	renamed_GCF_000008685.2	cp32-6	28485	29838	1353	99.1	7.521e-304
XYZ459H	contig_5	18649	19105	456	renamed_GCF_000008685.2	cp32-6	8281	8737	456	98.6	2.171e-98
XYZ459H	contig_5	22829	23162	333	renamed_GCF_000008685.2	cp32-8	12494	12827	333	100.0	8.424e-72
XYZ459H	contig_5	24042	24648	606	renamed_GCF_000008685.2	lp56	17207	17813	606	98.0	1.47e-127
XYZ459H	contig_9	3904	4294	390	renamed_GCF_000008685.2	cp32-6	5774	6164	390	76.7	4.197e-64
XYZ459H	contig_9	17088	17655	567	renamed_GCF_000008685.2	cp32-4	20066	20633	567	100.0	2.944e-130
XYZ459H	contig_9	18430	18991	561	renamed_GCF_000008685.2	cp9	1891	2452	561	63.4	3.083e-78
XYZ459H	contig_12	2494	2764	270	renamed_GCF_000008685.2	lp5	1207	1576	270	78.6	9.198e-45
XYZ459H	contig_12	5167	5851	684	renamed_GCF_000008685.2	lp17	5055	5739	684	99.1	1.4e-149
XYZ459H	contig_12	8386	9499	1113	renamed_GCF_000008685.2	lp17	8266	9379	1113	98.1	9.069e-244
XYZ459H	contig_13	2863	3301	438	renamed_GCF_000008685.2	cp32-6	17246	17696	438	88.0	1.276e-84
XYZ459H	contig_13	4676	5774	1098	renamed_GCF_000008685.2	cp32-7	19116	20214	1098	96.4	1.918e-241
XYZ459H	contig_13	6325	7066	741	renamed_GCF_000008685.2	cp32-3	21256	21997	741	100.0	5.003e-162
XYZ459H	contig_13	7661	8165	504	renamed_GCF_000008685.2	lp56	25889	26426	504	92.6	1.178e-104
XYZ459H	contig_13	10037	10463	426	renamed_GCF_000008685.2	cp32-6	24618	25044	426	98.5	8.877e-95
XYZ459H	contig_16	8230	8473	243	renamed_GCF_000008685.2	cp32-3	27409	27919	243	95.0	4.805e-47
XYZ459H	contig_17	1077	2028	951	renamed_GCF_000008685.2	cp32-6	10961	11912	951	99.6	4.333e-216
XYZ459H	contig_17	2629	2962	333	renamed_GCF_000008685.2	cp32-3	12494	12827	333	100.0	8.424e-72
XYZ459H	contig_17	6225	6579	354	renamed_GCF_000008685.2	cp32-6	16102	16456	354	100.0	1.459e-77
XYZ459H	contig_17	6727	7045	318	renamed_GCF_000008685.2	cp32-3	16585	16903	318	100.0	2.414e-66
XYZ459H	contig_18	662	65	597	renamed_GCF_000008685.2	cp32-4	10295	10892	597	98.4	5.216e-129
XYZ459H	contig_1	28474	27838	636	renamed_GCF_000008685.2	chromosome	28490	27854	636	98.5	4.529e-137
XYZ459H	contig_1	29526	31008	1482	renamed_GCF_000008685.2	chromosome	29542	31015	1482	98.9	0.0
XYZ459H	contig_1	32082	31542	540	renamed_GCF_000008685.2	chromosome	32089	31549	540	100.0	3.274e-116
XYZ459H	contig_1	35831	34031	1800	renamed_GCF_000008685.2	chromosome	35836	34036	1800	99.8	0.0
XYZ459H	contig_1	39820	40672	852	renamed_GCF_000008685.2	chromosome	39825	40677	852	98.9	1.242e-187
XYZ459H	contig_1	42478	41437	1041	renamed_GCF_000008685.2	chromosome	42483	41442	1041	99.4	2.178e-230
XYZ459H	contig_1	45349	42901	2448	renamed_GCF_000008685.2	chromosome	45354	42906	2448	99.7	0.0
XYZ459H	contig_1	46374	46005	369	renamed_GCF_000008685.2	chromosome	46379	46010	369	100.0	3.085e-80
XYZ459H	contig_1	47899	48601	702	renamed_GCF_000008685.2	chromosome	47916	48606	702	99.5	1.009e-147
XYZ459H	contig_1	70400	71210	810	renamed_GCF_000008685.2	chromosome	70141	71219	810	99.2	1.356e-179
XYZ459H	contig_1	72637	73483	846	renamed_GCF_000008685.2	chromosome	72646	73492	846	99.6	1.292e-177
XYZ459H	contig_1	75763	76444	681	renamed_GCF_000008685.2	chromosome	75773	76454	681	100.0	3.584e-147
XYZ459H	contig_1	76440	77691	1251	renamed_GCF_000008685.2	chromosome	76450	77701	1251	99.5	4.198e-267
XYZ459H	contig_1	78999	77700	1299	renamed_GCF_000008685.2	chromosome	79009	77710	1299	99.5	2.036e-283
XYZ459H	contig_1	79491	80760	1269	renamed_GCF_000008685.2	chromosome	79504	80773	1269	98.3	4.098e-279
XYZ459H	contig_1	81390	82926	1536	renamed_GCF_000008685.2	chromosome	81404	82940	1536	100.0	0.0
XYZ459H	contig_1	85707	84027	1680	renamed_GCF_000008685.2	chromosome	85720	84040	1680	99.8	0.0
XYZ459H	contig_1	87348	86913	435	renamed_GCF_000008685.2	chromosome	87360	86925	435	100.0	2.772e-92
XYZ459H	contig_1	89796	89187	609	renamed_GCF_000008685.2	chromosome	89808	89199	609	99.5	2.836e-129
XYZ459H	contig_1	121068	120789	279	renamed_GCF_000008685.2	chromosome	121082	120803	279	100.0	1.411e-57
XYZ459H	contig_1	122477	121865	612	renamed_GCF_000008685.2	chromosome	122491	121879	612	99.0	7.99e-127
XYZ459H	contig_1	124800	124134	666	renamed_GCF_000008685.2	chromosome	124814	124148	666	99.0	4.534e-142
XYZ459H	contig_1	126287	125519	768	renamed_GCF_000008685.2	chromosome	126301	125533	768	98.8	1.961e-168
XYZ459H	contig_1	130118	127412	2706	renamed_GCF_000008685.2	chromosome	130132	127426	2706	99.5	0.0
XYZ459H	contig_1	131283	132411	1128	renamed_GCF_000008685.2	chromosome	131297	132425	1128	99.2	8.687e-247
XYZ459H	contig_1	133960	135850	1890	renamed_GCF_000008685.2	chromosome	133974	135864	1890	99.5	0.0
XYZ459H	contig_1	138734	138422	312	renamed_GCF_000008685.2	chromosome	138745	138433	312	100.0	9.828e-67
XYZ459H	contig_1	142923	141969	954	renamed_GCF_000008685.2	chromosome	142932	141978	954	99.3	1.665e-201
XYZ459H	contig_1	144257	142934	1323	renamed_GCF_000008685.2	chromosome	144230	142943	1323	99.2	9.462e-279
XYZ459H	contig_1	176966	176060	906	renamed_GCF_000008685.2	chromosome	176974	176068	906	99.6	1.374e-195
XYZ459H	contig_1	178852	177859	993	renamed_GCF_000008685.2	chromosome	178860	177867	993	100.0	4.528e-214
XYZ459H	contig_1	179535	178908	627	renamed_GCF_000008685.2	chromosome	179543	178916	627	99.0	1.402e-131
XYZ459H	contig_1	189268	189067	201	renamed_GCF_000008685.2	chromosome	189276	189075	201	98.4	4.922e-40
XYZ459H	contig_1	190068	190722	654	renamed_GCF_000008685.2	chromosome	190186	190717	654	99.4	1.404e-110
XYZ459H	contig_1	192332	191522	810	renamed_GCF_000008685.2	chromosome	192327	191517	810	99.6	1.125e-181
XYZ459H	contig_1	193468	192328	1140	renamed_GCF_000008685.2	chromosome	193463	192323	1140	99.7	9.252e-257
XYZ459H	contig_1	195699	197703	2004	renamed_GCF_000008685.2	chromosome	195692	197696	2004	99.7	0.0
XYZ459H	contig_1	201057	199971	1086	renamed_GCF_000008685.2	chromosome	201050	199964	1086	98.8	7.16e-242
XYZ459H	contig_1	288017	287753	264	renamed_GCF_000008685.2	chromosome	288173	287909	264	100.0	2.025e-51
XYZ459H	contig_1	289761	289419	342	renamed_GCF_000008685.2	chromosome	289917	289575	342	99.1	5.339e-70
XYZ459H	contig_1	290865	289806	1059	renamed_GCF_000008685.2	chromosome	291021	289962	1059	100.0	3.164e-229
XYZ459H	contig_1	291439	290902	537	renamed_GCF_000008685.2	chromosome	291595	291058	537	99.4	3.778e-114
XYZ459H	contig_1	302333	300623	1710	renamed_GCF_000008685.2	chromosome	302489	300779	1710	99.8	0.0
XYZ459H	contig_1	303153	302694	459	renamed_GCF_000008685.2	chromosome	303309	302850	459	100.0	4.601e-99
XYZ459H	contig_1	304964	303617	1347	renamed_GCF_000008685.2	chromosome	305120	303773	1347	100.0	1.016e-290
XYZ459H	contig_1	319500	318969	531	renamed_GCF_000008685.2	chromosome	319636	319105	531	100.0	1.699e-113
XYZ459H	contig_1	320122	319543	579	renamed_GCF_000008685.2	chromosome	320249	319679	579	99.4	6.936e-123
XYZ459H	contig_1	320172	321216	1044	renamed_GCF_000008685.2	chromosome	320308	321352	1044	99.7	6.693e-227
XYZ459H	contig_1	334391	333494	897	renamed_GCF_000008685.2	chromosome	334515	333618	897	100.0	1.666e-200
XYZ459H	contig_1	334812	336384	1572	renamed_GCF_000008685.2	chromosome	334936	336508	1572	100.0	0.0
XYZ459H	contig_1	338233	339859	1626	renamed_GCF_000008685.2	chromosome	338357	339983	1626	99.6	0.0
XYZ459H	contig_1	340216	341137	921	renamed_GCF_000008685.2	chromosome	340340	341261	921	98.6	1.582e-196
XYZ459H	contig_1	341149	342199	1050	renamed_GCF_000008685.2	chromosome	341273	342323	1050	99.7	3.308e-227
XYZ459H	contig_1	342210	343083	873	renamed_GCF_000008685.2	chromosome	342334	343207	873	99.6	3.495e-188
XYZ459H	contig_1	343083	344055	972	renamed_GCF_000008685.2	chromosome	343207	344179	972	100.0	3.579e-213
XYZ459H	contig_1	344938	346240	1302	renamed_GCF_000008685.2	chromosome	345062	346364	1302	99.7	2.995e-288
XYZ459H	contig_1	356884	358318	1434	renamed_GCF_000008685.2	chromosome	357006	358440	1434	97.2	9.034e-307
XYZ459H	contig_1	358335	359076	741	renamed_GCF_000008685.2	chromosome	358457	359198	741	99.1	2.251e-162
XYZ459H	contig_1	359373	359094	279	renamed_GCF_000008685.2	chromosome	359495	359216	279	100.0	2.841e-58
XYZ459H	contig_1	360956	359390	1566	renamed_GCF_000008685.2	chromosome	361078	359512	1566	99.6	0.0
XYZ459H	contig_1	361077	362199	1122	renamed_GCF_000008685.2	chromosome	361187	362321	1122	99.4	5.47e-251
XYZ459H	contig_1	363995	362195	1800	renamed_GCF_000008685.2	chromosome	364117	362317	1800	99.4	0.0
XYZ459H	contig_1	374028	373443	585	renamed_GCF_000008685.2	chromosome	374151	373566	585	98.9	1.055e-127
XYZ459H	contig_1	374153	375530	1377	renamed_GCF_000008685.2	chromosome	374276	375653	1377	99.1	7.568e-308
XYZ459H	contig_1	375537	375816	279	renamed_GCF_000008685.2	chromosome	375660	375939	279	100.0	3.143e-57
XYZ459H	contig_1	376896	375837	1059	renamed_GCF_000008685.2	chromosome	377019	375960	1059	98.2	7.708e-228
XYZ459H	contig_1	405495	405120	375	renamed_GCF_000008685.2	chromosome	405617	405242	375	99.1	2.753e-74
XYZ459H	contig_1	406054	405565	489	renamed_GCF_000008685.2	chromosome	406176	405687	489	99.3	2.753e-101
XYZ459H	contig_1	406739	406058	681	renamed_GCF_000008685.2	chromosome	406861	406180	681	99.5	6.006e-150
XYZ459H	contig_1	407170	406738	432	renamed_GCF_000008685.2	chromosome	407292	406860	432	100.0	3.534e-89
XYZ459H	contig_1	407776	407221	555	renamed_GCF_000008685.2	chromosome	407898	407343	555	100.0	5.734e-121
XYZ459H	contig_1	417603	418215	612	renamed_GCF_000008685.2	chromosome	417723	418335	612	99.0	1.684e-135
XYZ459H	contig_1	419386	418267	1119	renamed_GCF_000008685.2	chromosome	419506	418387	1119	99.4	1.953e-253
XYZ459H	contig_1	421260	419382	1878	renamed_GCF_000008685.2	chromosome	421380	419502	1878	99.0	0.0
XYZ459H	contig_1	421433	422063	630	renamed_GCF_000008685.2	chromosome	421553	422183	630	97.6	1.685e-138
XYZ459H	contig_1	454353	451920	2433	renamed_GCF_000008685.2	chromosome	454472	452039	2433	99.5	0.0
XYZ459H	contig_1	456269	454364	1905	renamed_GCF_000008685.2	chromosome	456388	454483	1905	99.8	0.0
XYZ459H	contig_1	456456	457917	1461	renamed_GCF_000008685.2	chromosome	456575	458036	1461	100.0	0.0
XYZ459H	contig_1	458156	459314	1158	renamed_GCF_000008685.2	chromosome	458276	459434	1158	99.7	1.225e-256
XYZ459H	contig_1	459404	459704	300	renamed_GCF_000008685.2	chromosome	459524	459824	300	98.9	3.625e-59
XYZ459H	contig_1	459795	459951	156	renamed_GCF_000008685.2	chromosome	459915	460071	156	100.0	2.965e-30
XYZ459H	contig_1	471636	471102	534	renamed_GCF_000008685.2	chromosome	471756	471222	534	99.4	1.961e-112
XYZ459H	contig_1	472355	471650	705	renamed_GCF_000008685.2	chromosome	472358	471770	705	99.4	1.099e-121
XYZ459H	contig_1	472445	473288	843	renamed_GCF_000008685.2	chromosome	472565	473408	843	100.0	5.328e-187
XYZ459H	contig_1	474436	473284	1152	renamed_GCF_000008685.2	chromosome	474556	473404	1152	100.0	7.714e-261
XYZ459H	contig_1	485949	486636	687	renamed_GCF_000008685.2	chromosome	486073	486769	687	100.0	2.97e-150
XYZ459H	contig_1	486592	487414	822	renamed_GCF_000008685.2	chromosome	486746	487538	822	99.2	4.565e-168
XYZ459H	contig_1	487410	488100	690	renamed_GCF_000008685.2	chromosome	487534	488224	690	99.5	4.749e-154
XYZ459H	contig_1	701127	701538	411	renamed_GCF_000008685.2	chromosome	701394	701805	411	98.5	3.065e-87
XYZ459H	contig_1	703663	704692	1029	renamed_GCF_000008685.2	chromosome	703960	704959	1029	99.3	3.786e-222
XYZ459H	contig_1	705310	706336	1026	renamed_GCF_000008685.2	chromosome	705579	706605	1026	100.0	2.737e-225
XYZ459H	contig_1	720847	722749	1902	renamed_GCF_000008685.2	chromosome	721118	723020	1902	99.8	0.0
XYZ459H	contig_1	723952	725176	1224	renamed_GCF_000008685.2	chromosome	724223	725447	1224	99.0	3.873e-272
XYZ459H	contig_1	726213	727482	1269	renamed_GCF_000008685.2	chromosome	726457	727753	1269	98.1	1.199e-275
XYZ459H	contig_1	728394	729348	954	renamed_GCF_000008685.2	chromosome	728665	729619	954	99.0	7.226e-211
XYZ459H	contig_1	774404	775190	786	renamed_GCF_000008685.2	chromosome	774676	775462	786	100.0	1.17e-168
XYZ459H	contig_1	776512	777301	789	renamed_GCF_000008685.2	chromosome	776784	777573	789	98.4	2.262e-170
XYZ459H	contig_1	777492	778482	990	renamed_GCF_000008685.2	chromosome	777764	778754	990	99.3	7.696e-225
XYZ459H	contig_1	782976	782703	273	renamed_GCF_000008685.2	chromosome	783248	782975	273	100.0	3.858e-54
XYZ459H	contig_1	797758	796828	930	renamed_GCF_000008685.2	chromosome	798048	797118	930	100.0	3.063e-199
XYZ459H	contig_1	799985	798917	1068	renamed_GCF_000008685.2	chromosome	800275	799207	1068	99.7	4.094e-245
XYZ459H	contig_1	800720	801488	768	renamed_GCF_000008685.2	chromosome	801118	801778	768	98.6	5.947e-139
XYZ459H	contig_1	802878	802548	330	renamed_GCF_000008685.2	chromosome	803167	802837	330	100.0	2.178e-69
XYZ459H	contig_1	831307	830698	609	renamed_GCF_000008685.2	chromosome	831563	830954	609	100.0	7.938e-135
XYZ459H	contig_1	835804	838270	2466	renamed_GCF_000008685.2	chromosome	836060	838526	2466	99.6	0.0
XYZ459H	contig_1	838290	838824	534	renamed_GCF_000008685.2	chromosome	838546	839080	534	100.0	7.282e-115
XYZ459H	contig_1	841577	842195	618	renamed_GCF_000008685.2	chromosome	841833	842451	618	100.0	1.393e-138
XYZ459H	contig_1	842746	844195	1449	renamed_GCF_000008685.2	chromosome	843002	844451	1449	99.7	3.805e-319
XYZ459H	contig_1	846839	847202	363	renamed_GCF_000008685.2	chromosome	847125	847488	363	100.0	2.269e-74
XYZ459H	contig_1	848251	848518	267	renamed_GCF_000008685.2	chromosome	848537	848804	267	100.0	3.495e-54
XYZ459H	contig_1	850707	852228	1521	renamed_GCF_000008685.2	chromosome	850993	852514	1521	99.8	0.0
XYZ459H	contig_1	853488	854556	1068	renamed_GCF_000008685.2	chromosome	853774	854842	1068	99.1	7.372e-230
XYZ459H	contig_1	857227	858637	1410	renamed_GCF_000008685.2	chromosome	857505	858915	1410	99.1	1.821e-303
XYZ459H	contig_2	884	77	807	renamed_GCF_000008685.2	lp56	2743	3496	807	55.0	1.408e-82
XYZ459H	contig_2	9050	10697	1647	renamed_GCF_000008685.2	lp36	10300	11947	1647	92.1	0.0
XYZ459H	contig_2	23238	22680	558	renamed_GCF_000008685.2	lp28-1	14329	13768	558	52.6	3.083e-69
XYZ459H	contig_2	32719	24451	8268	renamed_GCF_000008685.2	lp28-1	26996	28073	8268	50.1	8.295e-45
XYZ459H	contig_3	11471	11267	204	renamed_GCF_000008685.2	lp36	17379	17583	204	83.5	3.933e-35
XYZ459H	contig_4	27369	26946	423	renamed_GCF_000008685.2	lp54	31779	32202	423	100.0	5.086e-92
XYZ459H	contig_4	29041	28501	540	renamed_GCF_000008685.2	lp54	30093	30633	540	100.0	4.969e-120
XYZ459H	contig_4	30200	29747	453	renamed_GCF_000008685.2	lp54	28934	29387	453	100.0	2.51e-96
XYZ459H	contig_4	30539	30203	336	renamed_GCF_000008685.2	lp54	28013	28931	336	99.0	5.348e-69
XYZ459H	contig_5	1658	2219	561	renamed_GCF_000008685.2	cp32-9	21613	22174	561	100.0	6.308e-121
XYZ459H	contig_5	12730	13294	564	renamed_GCF_000008685.2	cp32-6	2009	2573	564	99.4	1.105e-123
XYZ459H	contig_5	14091	14667	576	renamed_GCF_000008685.2	cp32-6	3372	3948	576	96.8	6.614e-123
XYZ459H	contig_5	15667	16123	456	renamed_GCF_000008685.2	cp32-6	4948	5404	456	98.6	2.634e-96
XYZ459H	contig_6	27652	27145	507	renamed_GCF_000008685.2	lp56	3622	4108	507	92.4	4.568e-82
XYZ459H	contig_6	29641	28747	894	renamed_GCF_000008685.2	lp28-2	115	1009	894	99.3	3.345e-192
XYZ459H	contig_7	8664	10128	1464	renamed_GCF_000008685.2	lp28-4	7182	8538	1464	92.6	6.151e-290
XYZ459H	contig_7	13507	14062	555	renamed_GCF_000008685.2	lp28-4	11923	12478	555	100.0	3.559e-126
XYZ459H	contig_7	14848	15421	573	renamed_GCF_000008685.2	lp28-4	13264	13837	573	100.0	2.579e-124
XYZ459H	contig_7	20764	20098	666	renamed_GCF_000008685.2	lp28-4	19183	18517	666	99.5	1.537e-145
XYZ459H	contig_8	4085	3479	606	renamed_GCF_000008685.2	lp54	24497	25103	606	99.0	7.269e-127
XYZ459H	contig_8	7492	6952	540	renamed_GCF_000008685.2	lp54	21086	21626	540	99.4	1.96e-113
XYZ459H	contig_8	7861	7666	195	renamed_GCF_000008685.2	lp54	20717	20912	195	100.0	2.214e-39
XYZ459H	contig_10	1852	2170	318	renamed_GCF_000008685.2	cp26	4481	4757	318	100.0	7.253e-55
XYZ459H	contig_10	14331	14970	639	renamed_GCF_000008685.2	cp26	16902	17535	639	77.9	7.618e-98
XYZ459H	contig_10	18240	16884	1356	renamed_GCF_000008685.2	cp26	20786	19430	1356	98.8	9.723e-293
XYZ459H	contig_10	18818	18311	507	renamed_GCF_000008685.2	cp26	21364	20857	507	99.4	6.947e-111
XYZ459H	contig_12	16233	16002	231	renamed_GCF_000008685.2	lp17	16119	15888	231	98.6	8.774e-47
XYZ459H	contig_13	1052	1400	348	renamed_GCF_000008685.2	cp32-8	15421	15769	348	100.0	8.822e-74
XYZ459H	contig_14	7003	7570	567	renamed_GCF_000008685.2	cp32-1	28834	29401	567	92.0	6.679e-113
XYZ459H	contig_14	8984	10208	1224	renamed_GCF_000008685.2	cp32-6	65	1289	1224	99.7	1.034e-269
XYZ459H	contig_15	673	1090	417	renamed_GCF_000008685.2	cp32-9	17301	17730	417	88.4	6.672e-80
XYZ459H	contig_1	767795	766460	1335	renamed_GCF_000008685.2	chromosome	768064	766732	1335	98.1	9.244e-290
XYZ459H	contig_1	770867	769274	1593	renamed_GCF_000008685.2	chromosome	771139	769546	1593	99.4	0.0
XYZ459H	contig_1	784784	786482	1698	renamed_GCF_000008685.2	chromosome	785056	786754	1698	99.2	0.0
XYZ459H	contig_1	789030	789648	618	renamed_GCF_000008685.2	chromosome	789302	789938	618	99.5	3.406e-137
XYZ459H	contig_1	791497	790516	981	renamed_GCF_000008685.2	chromosome	791787	790806	981	100.0	5.759e-218
XYZ459H	contig_1	792060	793335	1275	renamed_GCF_000008685.2	chromosome	792350	793625	1275	98.8	8.317e-281
XYZ459H	contig_1	808175	807686	489	renamed_GCF_000008685.2	chromosome	808464	807975	489	100.0	6.125e-101
XYZ459H	contig_1	810206	809411	795	renamed_GCF_000008685.2	chromosome	810495	809700	795	100.0	1.877e-173
XYZ459H	contig_4	2801	1910	891	renamed_GCF_000008685.2	lp54	51176	50285	891	98.9	4.455e-197
XYZ459H	contig_4	4330	5128	798	renamed_GCF_000008685.2	lp54	52705	53503	798	99.6	3.008e-177
XYZ459H	contig_4	7272	6498	774	renamed_GCF_000008685.2	lp54	51705	52479	774	100.0	9.219e-161
XYZ459H	contig_4	8900	9125	225	renamed_GCF_000008685.2	lp54	50077	49852	225	100.0	1.962e-45
XYZ459H	contig_4	19743	20988	1245	renamed_GCF_000008685.2	lp54	39405	38160	1245	99.2	1.307e-270
XYZ459H	contig_4	22890	22614	276	renamed_GCF_000008685.2	lp54	36255	36534	276	98.9	1.485e-56
XYZ459H	contig_5	23158	24037	879	renamed_GCF_000008685.2	cp32-7	12831	13710	879	97.2	4.212e-187
XYZ459H	contig_5	24657	25473	816	renamed_GCF_000008685.2	cp32-4	14276	15092	816	88.5	2.571e-156
XYZ459H	contig_6	3813	3411	402	renamed_GCF_000008685.2	lp28-2	25979	26390	402	88.0	3.163e-77
XYZ459H	contig_6	5682	6057	375	renamed_GCF_000008685.2	lp28-2	24108	23721	375	89.0	9.084e-70
XYZ459H	contig_6	6745	7120	375	renamed_GCF_000008685.2	lp28-2	23033	22658	375	95.9	5.555e-75
XYZ459H	contig_6	7468	10159	2691	renamed_GCF_000008685.2	lp28-2	22259	19619	2691	98.5	0.0
XYZ459H	contig_6	10951	11731	780	renamed_GCF_000008685.2	lp28-2	18827	18029	780	93.5	2.368e-168
XYZ459H	contig_6	12076	13267	1191	renamed_GCF_000008685.2	lp28-2	17684	16493	1191	99.2	7.436e-268
XYZ459H	contig_6	14330	14876	546	renamed_GCF_000008685.2	lp28-2	15431	14885	546	96.1	5.802e-111
XYZ459H	contig_7	3995	4811	816	renamed_GCF_000008685.2	lp28-4	2535	3351	816	100.0	8.08e-178
XYZ459H	contig_7	5383	5776	393	renamed_GCF_000008685.2	lp36	6040	5287	393	60.3	1.555e-42
XYZ459H	contig_7	6588	6807	219	renamed_GCF_000008685.2	lp28-4	5127	5346	219	100.0	1.443e-47
XYZ459H	contig_7	23142	22512	630	renamed_GCF_000008685.2	lp28-4	21562	20770	630	99.0	1.217e-133
XYZ459H	contig_7	24511	23674	837	renamed_GCF_000008685.2	lp28-4	22931	22094	837	98.9	7.731e-182
XYZ459H	contig_7	25605	24738	867	renamed_GCF_000008685.2	lp28-4	25089	24222	867	96.1	1.236e-181
XYZ459H	contig_8	18334	17443	891	renamed_GCF_000008685.2	lp54	10287	11178	891	98.6	1.129e-186
XYZ459H	contig_8	19165	18343	822	renamed_GCF_000008685.2	lp54	9456	10278	822	99.6	1.415e-172
XYZ459H	contig_8	20356	20176	180	renamed_GCF_000008685.2	lp54	8265	8445	180	100.0	1.452e-33
XYZ459H	contig_9	3533	3917	384	renamed_GCF_000008685.2	cp32-6	5403	5787	384	80.8	6.327e-67
XYZ459H	contig_11	9833	10919	1086	renamed_GCF_000008685.2	lp25	14530	13402	1086	95.2	3.036e-234
XYZ459H	contig_12	1441	1873	432	renamed_GCF_000008685.2	lp17	1409	1766	432	92.3	1.005e-69
XYZ459H	contig_12	3709	3931	222	renamed_GCF_000008685.2	lp17	3651	3819	222	100.0	6.565e-33
XYZ459H	contig_12	6575	5996	579	renamed_GCF_000008685.2	lp17	6452	5873	579	99.4	1.16e-125
XYZ459H	contig_12	7904	8231	327	renamed_GCF_000008685.2	lp17	7784	8111	327	99.0	2.291e-68
XYZ459H	contig_13	2690	2207	483	renamed_GCF_000008685.2	cp32-6	17075	16592	483	70.0	9.951e-70
XYZ459H	contig_16	459	1560	1101	renamed_GCF_000008685.2	cp32-3	19604	20705	1101	97.5	2.815e-246
XYZ459H	contig_17	390	1074	684	renamed_GCF_000008685.2	lp56	13754	14438	684	96.0	2.242e-144
XYZ459H	contig_17	2045	2600	555	renamed_GCF_000008685.2	cp32-6	11929	12484	555	99.4	1.543e-118
XYZ459H	contig_1	18285	17772	513	renamed_GCF_000008685.2	chromosome	18304	17791	513	100.0	1.701e-110
XYZ459H	contig_1	22085	21041	1044	renamed_GCF_000008685.2	chromosome	22101	21057	1044	100.0	6.693e-227
XYZ459H	contig_1	22723	22129	594	renamed_GCF_000008685.2	chromosome	22739	22145	594	99.4	7.271e-125
XYZ459H	contig_1	22802	23942	1140	renamed_GCF_000008685.2	chromosome	22818	23958	1140	97.6	4.164e-257
XYZ459H	contig_1	24680	23948	732	renamed_GCF_000008685.2	chromosome	24696	23964	732	100.0	2.844e-158
XYZ459H	contig_1	25736	26375	639	renamed_GCF_000008685.2	chromosome	25752	26391	639	100.0	1.211e-143
XYZ459H	contig_1	27849	27417	432	renamed_GCF_000008685.2	chromosome	27865	27433	432	98.6	1.441e-90
XYZ459H	contig_1	29456	28475	981	renamed_GCF_000008685.2	chromosome	29472	28491	981	100.0	8.047e-223
XYZ459H	contig_1	31013	31472	459	renamed_GCF_000008685.2	chromosome	31026	31479	459	99.3	5.582e-97
XYZ459H	contig_1	34030	32149	1881	renamed_GCF_000008685.2	chromosome	34037	32156	1881	99.6	0.0
XYZ459H	contig_1	36604	35851	753	renamed_GCF_000008685.2	chromosome	36609	35856	753	98.0	1.62e-159
XYZ459H	contig_1	39633	38130	1503	renamed_GCF_000008685.2	chromosome	39638	38135	1503	100.0	0.0
XYZ459H	contig_1	41427	40755	672	renamed_GCF_000008685.2	chromosome	41432	40760	672	100.0	1.856e-144
XYZ459H	contig_1	42876	42474	402	renamed_GCF_000008685.2	chromosome	42881	42479	402	100.0	2.405e-88
XYZ459H	contig_1	45440	45986	546	renamed_GCF_000008685.2	chromosome	45445	45991	546	98.8	3.601e-116
XYZ459H	contig_1	47161	47836	675	renamed_GCF_000008685.2	chromosome	47166	47841	675	99.5	1.946e-144
XYZ459H	contig_1	49254	48597	657	renamed_GCF_000008685.2	chromosome	49259	48602	657	99.0	2.348e-139
XYZ459H	contig_1	49335	50007	672	renamed_GCF_000008685.2	chromosome	49340	50012	672	100.0	9.591e-152
XYZ459H	contig_1	71191	72601	1410	renamed_GCF_000008685.2	chromosome	71200	72610	1410	99.3	6.232e-307
XYZ459H	contig_1	79342	78991	351	renamed_GCF_000008685.2	chromosome	79322	79001	351	100.0	3.732e-67
XYZ459H	contig_1	80968	81394	426	renamed_GCF_000008685.2	chromosome	80982	81408	426	98.5	2.913e-90
XYZ459H	contig_1	83907	82956	951	renamed_GCF_000008685.2	chromosome	83920	82969	951	99.3	8.301e-209
XYZ459H	contig_1	86842	85858	984	renamed_GCF_000008685.2	chromosome	86854	85879	984	99.0	6.035e-218
XYZ459H	contig_1	91103	89798	1305	renamed_GCF_000008685.2	chromosome	91115	89810	1305	100.0	2.863e-289
XYZ459H	contig_1	93411	92865	546	renamed_GCF_000008685.2	chromosome	93423	92877	546	97.2	7.28e-117
XYZ459H	contig_1	124132	122476	1656	renamed_GCF_000008685.2	chromosome	124146	122490	1656	99.0	0.0
XYZ459H	contig_1	125533	124783	750	renamed_GCF_000008685.2	chromosome	125547	124797	750	98.7	3.127e-160
XYZ459H	contig_1	127399	126301	1098	renamed_GCF_000008685.2	chromosome	127413	126315	1098	99.4	6.759e-236
XYZ459H	contig_1	131100	130155	945	renamed_GCF_000008685.2	chromosome	131114	130169	945	100.0	6.888e-210
XYZ459H	contig_1	133828	132457	1371	renamed_GCF_000008685.2	chromosome	133842	132471	1371	100.0	2.422e-302
XYZ459H	contig_1	137752	135859	1893	renamed_GCF_000008685.2	chromosome	137766	135873	1893	99.6	0.0
XYZ459H	contig_1	146361	145461	900	renamed_GCF_000008685.2	chromosome	146370	145470	900	100.0	6.779e-194
XYZ459H	contig_1	510711	511500	789	renamed_GCF_000008685.2	chromosome	510835	511624	789	99.2	8.439e-173
XYZ459H	contig_1	513015	512268	747	renamed_GCF_000008685.2	chromosome	513139	512392	747	100.0	7.284e-159
XYZ459H	contig_1	513101	514403	1302	renamed_GCF_000008685.2	chromosome	513225	514527	1302	99.7	7.994e-286
XYZ459H	contig_1	514399	515659	1260	renamed_GCF_000008685.2	chromosome	514523	515783	1260	99.2	2.965e-281
XYZ459H	contig_1	516364	522865	6501	renamed_GCF_000008685.2	chromosome	516492	522993	6501	99.4	0.0
XYZ459H	contig_1	535576	537400	1824	renamed_GCF_000008685.2	chromosome	535703	537527	1824	99.0	0.0
XYZ459H	contig_1	537392	538181	789	renamed_GCF_000008685.2	chromosome	537543	538308	789	99.2	6.654e-167
XYZ459H	contig_1	539148	538200	948	renamed_GCF_000008685.2	chromosome	539275	538327	948	99.6	1.106e-213
XYZ459H	contig_1	561289	560869	420	renamed_GCF_000008685.2	chromosome	561554	561116	420	93.7	5.226e-83
XYZ459H	contig_1	561678	561297	381	renamed_GCF_000008685.2	chromosome	561943	561562	381	99.2	5.027e-77
XYZ459H	contig_1	561919	563902	1983	renamed_GCF_000008685.2	chromosome	562184	564167	1983	99.5	0.0
XYZ459H	contig_1	565696	567559	1863	renamed_GCF_000008685.2	chromosome	565954	567823	1863	99.1	0.0
XYZ459H	contig_1	567545	568013	468	renamed_GCF_000008685.2	chromosome	567809	568277	468	100.0	1.969e-101
XYZ459H	contig_1	568005	568875	870	renamed_GCF_000008685.2	chromosome	568269	569139	870	100.0	1.737e-195
XYZ459H	contig_1	661266	659394	1872	renamed_GCF_000008685.2	chromosome	661515	659643	1872	99.1	0.0
XYZ459H	contig_1	661356	662280	924	renamed_GCF_000008685.2	chromosome	661605	662529	924	99.3	2.542e-200
XYZ459H	contig_1	662668	662353	315	renamed_GCF_000008685.2	chromosome	662917	662602	315	99.0	2.806e-64
XYZ459H	contig_1	701557	702007	450	renamed_GCF_000008685.2	chromosome	701824	702274	450	98.6	5.324e-96
XYZ459H	contig_1	702699	702015	684	renamed_GCF_000008685.2	chromosome	702951	702282	684	100.0	4.537e-145
XYZ459H	contig_1	702741	703701	960	renamed_GCF_000008685.2	chromosome	703008	703968	960	100.0	6.008e-214
XYZ459H	contig_1	704681	705233	552	renamed_GCF_000008685.2	chromosome	704948	705500	552	98.9	6.015e-120
XYZ459H	contig_1	717471	718398	927	renamed_GCF_000008685.2	chromosome	717742	718669	927	100.0	3.519e-197
XYZ459H	contig_1	718555	720817	2262	renamed_GCF_000008685.2	chromosome	718826	721088	2262	99.8	0.0
XYZ459H	contig_1	723859	722791	1068	renamed_GCF_000008685.2	chromosome	724130	723062	1068	99.1	8.292e-246
XYZ459H	contig_1	725159	726224	1065	renamed_GCF_000008685.2	chromosome	725430	726495	1065	94.6	9.28e-227
XYZ459H	contig_1	727465	728404	939	renamed_GCF_000008685.2	chromosome	727736	728675	939	99.3	8.285e-207
XYZ459H	contig_1	729341	730235	894	renamed_GCF_000008685.2	chromosome	729612	730506	894	98.3	1.652e-191
XYZ459H	contig_1	774096	771297	2799	renamed_GCF_000008685.2	chromosome	774368	771569	2799	99.4	0.0
XYZ459H	contig_1	776407	775393	1014	renamed_GCF_000008685.2	chromosome	776679	775665	1014	99.4	1.78e-219
XYZ459H	contig_1	778485	781113	2628	renamed_GCF_000008685.2	chromosome	778757	781385	2628	98.9	0.0
XYZ459H	contig_1	782557	781879	678	renamed_GCF_000008685.2	chromosome	782829	782151	678	99.5	1.055e-151
XYZ459H	contig_1	783117	784749	1632	renamed_GCF_000008685.2	chromosome	783389	785021	1632	99.8	0.0
XYZ459H	contig_1	798726	797766	960	renamed_GCF_000008685.2	chromosome	799016	798056	960	99.6	2.967e-213
XYZ459H	contig_1	800185	800782	597	renamed_GCF_000008685.2	chromosome	800475	801072	597	99.4	1.402e-126
XYZ459H	contig_1	802509	801651	858	renamed_GCF_000008685.2	chromosome	802798	801940	858	100.0	3.462e-177
XYZ459H	contig_1	806634	805485	1149	renamed_GCF_000008685.2	chromosome	806923	805774	1149	99.7	5.42e-247
XYZ459H	contig_1	838987	841576	2589	renamed_GCF_000008685.2	chromosome	839243	841832	2589	99.7	0.0
XYZ459H	contig_1	842295	842733	438	renamed_GCF_000008685.2	chromosome	842500	842989	438	99.3	1.307e-92
XYZ459H	contig_1	844197	846816	2619	renamed_GCF_000008685.2	chromosome	844453	847102	2619	98.4	0.0
XYZ459H	contig_1	847204	848053	849	renamed_GCF_000008685.2	chromosome	847490	848339	849	98.5	1.721e-183
XYZ459H	contig_1	848532	850701	2169	renamed_GCF_000008685.2	chromosome	848836	850987	2169	99.5	0.0
XYZ459H	contig_1	852202	853492	1290	renamed_GCF_000008685.2	chromosome	852488	853778	1290	100.0	6.634e-286
XYZ459H	contig_1	854590	855718	1128	renamed_GCF_000008685.2	chromosome	854868	855996	1128	98.9	3.452e-257
XYZ459H	contig_1	855710	857231	1521	renamed_GCF_000008685.2	chromosome	855988	857509	1521	99.8	0.0
XYZ459H	contig_1	860161	861496	1335	renamed_GCF_000008685.2	chromosome	860439	861774	1335	99.5	4.161e-290
XYZ459H	contig_2	7263	6567	696	renamed_GCF_000008685.2	lp36	8859	8163	696	94.8	2.974e-143
XYZ459H	contig_2	11181	10821	360	renamed_GCF_000008685.2	lp36	12601	13237	360	85.7	4.313e-67
XYZ459H	contig_3	3965	143	3822	renamed_GCF_000008685.2	lp28-3	7728	3891	3822	87.5	0.0
XYZ459H	contig_3	13783	13114	669	renamed_GCF_000008685.2	lp28-3	10516	9847	669	100.0	5.739e-140
XYZ459H	contig_4	28439	27368	1071	renamed_GCF_000008685.2	lp54	30709	31780	1071	99.7	4.869e-235
XYZ459H	contig_4	29751	29376	375	renamed_GCF_000008685.2	lp54	29383	29758	375	100.0	1.685e-79
XYZ459H	contig_5	861	1617	756	renamed_GCF_000008685.2	cp32-9	20816	21572	756	99.6	4.781e-165
XYZ459H	contig_5	12026	12719	693	renamed_GCF_000008685.2	lp56	35114	35807	693	98.2	1.402e-142
XYZ459H	contig_5	13297	14062	765	renamed_GCF_000008685.2	cp32-6	2576	3344	765	97.2	1.015e-166
XYZ459H	contig_5	14688	15648	960	renamed_GCF_000008685.2	cp32-6	3969	4929	960	99.6	2.967e-213
XYZ459H	contig_5	16531	17098	567	renamed_GCF_000008685.2	lp56	9623	10190	567	97.3	1.275e-122
XYZ459H	contig_5	18205	18634	429	renamed_GCF_000008685.2	lp56	11296	11725	429	99.2	1.246e-91
XYZ459H	contig_5	26091	26427	336	renamed_GCF_000008685.2	cp32-8	15758	16094	336	100.0	5.348e-69
XYZ459H	contig_7	16938	18117	1179	renamed_GCF_000008685.2	lp28-4	15351	16530	1179	98.9	5.976e-251
XYZ459H	contig_8	4803	4167	636	renamed_GCF_000008685.2	lp54	23776	24415	636	98.1	1.337e-133
XYZ459H	contig_8	5305	6895	1590	renamed_GCF_000008685.2	lp54	23273	21683	1590	99.6	0.0
XYZ459H	contig_8	9864	8511	1353	renamed_GCF_000008685.2	lp54	18724	20077	1353	99.7	3.386e-304
XYZ459H	contig_8	11329	11893	564	renamed_GCF_000008685.2	lp54	17259	16695	564	98.3	5.792e-114
XYZ459H	contig_8	12012	12597	585	renamed_GCF_000008685.2	lp54	16576	16000	585	75.4	1.134e-84
XYZ459H	contig_8	21413	20378	1035	renamed_GCF_000008685.2	lp54	7208	8243	1035	100.0	8.138e-232
XYZ459H	contig_8	22976	22103	873	renamed_GCF_000008685.2	lp54	5645	6518	873	100.0	2.408e-192
XYZ459H	contig_10	1496	1844	348	renamed_GCF_000008685.2	cp26	4083	4431	348	100.0	1.075e-71
XYZ459H	contig_10	2181	3279	1098	renamed_GCF_000008685.2	cp26	4768	5866	1098	99.1	5.441e-247
XYZ459H	contig_10	16775	15419	1356	renamed_GCF_000008685.2	cp26	19321	17965	1356	98.6	2.367e-291
XYZ459H	contig_10	19278	18792	486	renamed_GCF_000008685.2	cp26	21833	21338	486	100.0	3.279e-107
XYZ459H	contig_10	19351	20047	696	renamed_GCF_000008685.2	cp26	21897	22593	696	99.1	3.423e-150
XYZ459H	contig_10	20708	21953	1245	renamed_GCF_000008685.2	cp26	23254	24499	1245	99.7	5.213e-281
XYZ459H	contig_10	23997	24276	279	renamed_GCF_000008685.2	cp26	45	324	279	97.8	2.569e-59
XYZ459H	contig_11	12242	12824	582	renamed_GCF_000008685.2	lp25	12079	11497	582	97.9	2.704e-125
XYZ459H	contig_11	14134	14755	621	renamed_GCF_000008685.2	lp25	10187	9566	621	95.1	5.218e-133
XYZ459H	contig_15	2144	1127	1017	renamed_GCF_000008685.2	cp32-1	18728	17714	1017	98.5	9.758e-227
XYZ459H	contig_15	3644	4211	567	renamed_GCF_000008685.2	lp56	23975	24542	567	98.9	7.201e-129
XYZ459H	contig_15	4186	4942	756	renamed_GCF_000008685.2	cp32-4	20608	21364	756	99.2	4.353e-166
XYZ459H	contig_15	4992	5538	546	renamed_GCF_000008685.2	cp32-4	21414	21960	546	97.7	3.962e-115
XYZ459H	contig_15	7893	8319	426	renamed_GCF_000008685.2	cp32-3	25068	25494	426	97.8	8.877e-95
XYZ459H	contig_15	9101	8324	777	renamed_GCF_000008685.2	cp32-7	25720	24943	777	100.0	1.414e-173
XYZ459H	contig_15	9531	10224	693	renamed_GCF_000008685.2	cp32-7	26151	26841	693	93.9	4.131e-139
XYZ459H	contig_1	111029	109661	1368	renamed_GCF_000008685.2	chromosome	111042	109674	1368	100.0	1.976e-295
XYZ459H	contig_1	111554	111032	522	renamed_GCF_000008685.2	chromosome	111567	111045	522	100.0	1.783e-111
XYZ459H	contig_1	111861	111570	291	renamed_GCF_000008685.2	chromosome	111875	111584	291	100.0	1.894e-64
XYZ459H	contig_1	112324	111874	450	renamed_GCF_000008685.2	chromosome	112338	111888	450	99.3	9.762e-98
XYZ459H	contig_1	158619	159336	717	renamed_GCF_000008685.2	chromosome	158627	159344	717	100.0	1.01e-158
XYZ459H	contig_1	159359	160034	675	renamed_GCF_000008685.2	chromosome	159367	160042	675	100.0	1.946e-144
XYZ459H	contig_1	160081	161200	1119	renamed_GCF_000008685.2	chromosome	160089	161208	1119	100.0	2.349e-251
XYZ459H	contig_1	162793	161191	1602	renamed_GCF_000008685.2	chromosome	162801	161199	1602	100.0	0.0
XYZ459H	contig_1	162869	163037	168	renamed_GCF_000008685.2	chromosome	162877	163045	168	100.0	5.294e-34
XYZ459H	contig_1	164812	163063	1749	renamed_GCF_000008685.2	chromosome	164820	163071	1749	99.3	0.0
XYZ459H	contig_1	186940	187186	246	renamed_GCF_000008685.2	chromosome	186948	187194	246	100.0	9.168e-49
XYZ459H	contig_1	187823	187169	654	renamed_GCF_000008685.2	chromosome	187831	187177	654	100.0	1.397e-144
XYZ459H	contig_1	188229	187815	414	renamed_GCF_000008685.2	chromosome	188237	187823	414	100.0	2.918e-88
XYZ459H	contig_1	188486	188225	261	renamed_GCF_000008685.2	chromosome	188494	188233	261	98.8	1.572e-53
XYZ459H	contig_1	211306	212074	768	renamed_GCF_000008685.2	chromosome	211300	212068	768	100.0	8.822e-169
XYZ459H	contig_1	215270	217103	1833	renamed_GCF_000008685.2	chromosome	215426	217259	1833	99.3	0.0
XYZ459H	contig_1	217124	218156	1032	renamed_GCF_000008685.2	chromosome	217277	218312	1032	98.2	2.833e-217
XYZ459H	contig_1	218922	218268	654	renamed_GCF_000008685.2	chromosome	219078	218424	654	99.0	5.201e-147
XYZ459H	contig_1	219478	218899	579	renamed_GCF_000008685.2	chromosome	219634	219055	579	100.0	8.388e-121
XYZ459H	contig_1	229061	230069	1008	renamed_GCF_000008685.2	chromosome	229216	230224	1008	99.7	2.728e-222
XYZ459H	contig_1	231336	230058	1278	renamed_GCF_000008685.2	chromosome	231491	230213	1278	99.7	4.58e-288
XYZ459H	contig_1	231465	232167	702	renamed_GCF_000008685.2	chromosome	231620	232322	702	99.1	2.837e-153
XYZ459H	contig_1	232182	235098	2916	renamed_GCF_000008685.2	chromosome	232337	235253	2916	99.4	0.0
XYZ459H	contig_1	235379	235133	246	renamed_GCF_000008685.2	chromosome	235534	235288	246	98.7	3.025e-52
XYZ459H	contig_1	236987	235439	1548	renamed_GCF_000008685.2	chromosome	237142	235594	1548	99.8	0.0
XYZ459H	contig_1	237474	237066	408	renamed_GCF_000008685.2	chromosome	237629	237221	408	100.0	2.649e-88
XYZ459H	contig_1	237801	237474	327	renamed_GCF_000008685.2	chromosome	237956	237629	327	100.0	8.435e-71
XYZ459H	contig_1	238071	237813	258	renamed_GCF_000008685.2	chromosome	238226	237968	258	100.0	9.113e-51
XYZ459H	contig_1	238973	238145	828	renamed_GCF_000008685.2	chromosome	239128	238300	828	99.6	2.079e-186
XYZ459H	contig_1	266909	267119	210	renamed_GCF_000008685.2	chromosome	267065	267275	210	100.0	4.647e-42
XYZ459H	contig_1	270317	269516	801	renamed_GCF_000008685.2	chromosome	270473	269672	801	99.6	3.29e-168
XYZ459H	contig_1	272524	270331	2193	renamed_GCF_000008685.2	chromosome	272641	270487	2193	99.8	0.0
XYZ459H	contig_1	273491	272477	1014	renamed_GCF_000008685.2	chromosome	273647	272633	1014	99.4	1.348e-222
XYZ459H	contig_1	273697	275080	1383	renamed_GCF_000008685.2	chromosome	273856	275236	1383	99.7	2.662e-303
XYZ459H	contig_1	276340	275086	1254	renamed_GCF_000008685.2	chromosome	276496	275242	1254	100.0	4.99e-283
XYZ459H	contig_1	276401	276908	507	renamed_GCF_000008685.2	chromosome	276671	277064	507	100.0	6.298e-87
XYZ459H	contig_1	278403	276933	1470	renamed_GCF_000008685.2	chromosome	278559	277089	1470	99.7	4.387e-321
XYZ459H	contig_1	278902	278380	522	renamed_GCF_000008685.2	chromosome	279058	278536	522	99.4	8.822e-111
XYZ459H	contig_1	296889	296271	618	renamed_GCF_000008685.2	chromosome	297045	296427	618	99.0	2.705e-131
XYZ459H	contig_1	297313	296881	432	renamed_GCF_000008685.2	chromosome	297469	297037	432	97.9	1.187e-92
XYZ459H	contig_1	298620	297309	1311	renamed_GCF_000008685.2	chromosome	298776	297465	1311	100.0	6.981e-289
XYZ459H	contig_1	299559	298638	921	renamed_GCF_000008685.2	chromosome	299715	298794	921	99.3	1.132e-191
XYZ459H	contig_1	309623	308381	1242	renamed_GCF_000008685.2	chromosome	309780	308538	1242	99.7	3.039e-269
XYZ459H	contig_1	310366	309622	744	renamed_GCF_000008685.2	chromosome	310523	309779	744	100.0	5.245e-162
XYZ459H	contig_1	311496	310401	1095	renamed_GCF_000008685.2	chromosome	311617	310558	1095	99.4	1.229e-228
XYZ459H	contig_1	312558	311502	1056	renamed_GCF_000008685.2	chromosome	312715	311659	1056	100.0	1.239e-230
XYZ459H	contig_1	313987	312595	1392	renamed_GCF_000008685.2	chromosome	314123	312728	1392	99.3	6.205e-304
XYZ459H	contig_1	314291	314009	282	renamed_GCF_000008685.2	chromosome	314427	314145	282	98.9	1.34e-58
XYZ459H	contig_1	368761	369904	1143	renamed_GCF_000008685.2	chromosome	368884	370027	1143	97.8	2.289e-238
XYZ459H	contig_1	369903	370890	987	renamed_GCF_000008685.2	chromosome	370026	371013	987	99.3	3.978e-223
XYZ459H	contig_1	370910	372923	2013	renamed_GCF_000008685.2	chromosome	371033	373046	2013	99.5	0.0
XYZ459H	contig_1	373016	373397	381	renamed_GCF_000008685.2	chromosome	373139	373520	381	100.0	1.683e-80
XYZ459H	contig_1	385325	386039	714	renamed_GCF_000008685.2	chromosome	385448	386162	714	99.5	1.693e-152
XYZ459H	contig_1	386035	387214	1179	renamed_GCF_000008685.2	chromosome	386158	387337	1179	99.7	9.776e-263
XYZ459H	contig_1	387210	387684	474	renamed_GCF_000008685.2	chromosome	387333	387807	474	100.0	1.339e-106
XYZ459H	contig_1	388357	387694	663	renamed_GCF_000008685.2	chromosome	388480	387817	663	99.5	1.104e-148
XYZ459H	contig_1	388803	388383	420	renamed_GCF_000008685.2	chromosome	388926	388506	420	100.0	9.787e-93
XYZ459H	contig_1	390218	388853	1365	renamed_GCF_000008685.2	chromosome	390341	388976	1365	99.1	7.949e-288
XYZ459H	contig_1	415673	414206	1467	renamed_GCF_000008685.2	chromosome	415793	414326	1467	99.3	0.0
XYZ459H	contig_1	416403	415725	678	renamed_GCF_000008685.2	chromosome	416478	415845	678	99.0	1.108e-142
XYZ459H	contig_1	416568	416985	417	renamed_GCF_000008685.2	chromosome	416688	417105	417	99.2	6.183e-89
XYZ459H	contig_1	416981	417593	612	renamed_GCF_000008685.2	chromosome	417101	417713	612	100.0	4.975e-132
XYZ459H	contig_1	427868	428504	636	renamed_GCF_000008685.2	chromosome	427986	428622	636	99.5	1.686e-139
XYZ459H	contig_1	428527	429556	1029	renamed_GCF_000008685.2	chromosome	428645	429674	1029	99.1	4.661e-237
XYZ459H	contig_1	430492	429574	918	renamed_GCF_000008685.2	chromosome	430616	429692	918	98.6	5.143e-200
XYZ459H	contig_1	434985	430500	4485	renamed_GCF_000008685.2	chromosome	435103	430618	4485	98.3	0.0
XYZ459H	contig_1	442435	441595	840	renamed_GCF_000008685.2	chromosome	442552	441712	840	98.5	3.646e-182
XYZ459H	contig_1	443128	442567	561	renamed_GCF_000008685.2	chromosome	443248	442687	561	98.9	1.054e-123
XYZ459H	contig_1	469267	467161	2106	renamed_GCF_000008685.2	chromosome	469387	467281	2106	99.7	0.0
XYZ459H	contig_1	469545	469269	276	renamed_GCF_000008685.2	chromosome	469665	469389	276	98.9	8.162e-55
XYZ459H	contig_1	469851	469557	294	renamed_GCF_000008685.2	chromosome	469971	469677	294	100.0	2.2e-63
XYZ459H	contig_1	471100	469840	1260	renamed_GCF_000008685.2	chromosome	471220	469960	1260	99.5	6.182e-273
XYZ459H	contig_1	489608	490430	822	renamed_GCF_000008685.2	chromosome	489732	490554	822	99.6	6.11e-182
XYZ459H	contig_1	490519	491803	1284	renamed_GCF_000008685.2	chromosome	490643	491927	1284	99.7	1.048e-279
XYZ459H	contig_1	492463	493828	1365	renamed_GCF_000008685.2	chromosome	492587	493952	1365	100.0	1.721e-296
XYZ459H	contig_1	494418	494025	393	renamed_GCF_000008685.2	chromosome	494539	494149	393	99.2	2.252e-79
XYZ459H	contig_1	494908	496093	1185	renamed_GCF_000008685.2	chromosome	495032	496217	1185	100.0	4.832e-263
XYZ459H	contig_1	496143	496455	312	renamed_GCF_000008685.2	chromosome	496267	496579	312	100.0	2.953e-63
XYZ459H	contig_1	505429	506734	1305	renamed_GCF_000008685.2	chromosome	505553	506858	1305	99.7	2.039e-284
XYZ459H	contig_1	506746	506860	114	renamed_GCF_000008685.2	chromosome	506864	506984	114	100.0	7.638e-22
XYZ459H	contig_1	506877	507255	378	renamed_GCF_000008685.2	chromosome	507001	507379	378	100.0	8.763e-79
XYZ459H	contig_1	507281	507674	393	renamed_GCF_000008685.2	chromosome	507405	507798	393	100.0	3.073e-84
XYZ459H	contig_1	524425	526126	1701	renamed_GCF_000008685.2	chromosome	524553	526254	1701	99.4	0.0
XYZ459H	contig_1	529069	527974	1095	renamed_GCF_000008685.2	chromosome	529198	528103	1095	99.7	8.741e-250
XYZ459H	contig_1	530976	529068	1908	renamed_GCF_000008685.2	chromosome	531105	529197	1908	99.8	0.0
XYZ459H	contig_1	553017	553668	651	renamed_GCF_000008685.2	chromosome	553138	553789	651	98.1	8.744e-141
XYZ459H	contig_1	553870	555091	1221	renamed_GCF_000008685.2	chromosome	553991	555212	1221	100.0	5.34e-268
XYZ459H	contig_1	555094	556459	1365	renamed_GCF_000008685.2	chromosome	555215	556580	1365	98.8	3.723e-305
XYZ459H	contig_1	557176	556441	735	renamed_GCF_000008685.2	chromosome	557423	556562	735	83.5	3.118e-149
XYZ459H	contig_1	569013	569274	261	renamed_GCF_000008685.2	chromosome	569277	569538	261	100.0	9.575e-51
XYZ459H	contig_1	569294	571016	1722	renamed_GCF_000008685.2	chromosome	569558	571280	1722	99.6	0.0
XYZ459H	contig_1	571018	571588	570	renamed_GCF_000008685.2	chromosome	571282	571852	570	100.0	1.471e-121
XYZ459H	contig_1	573476	571625	1851	renamed_GCF_000008685.2	chromosome	573740	571889	1851	100.0	0.0
XYZ459H	contig_1	573588	574983	1395	renamed_GCF_000008685.2	chromosome	573852	575247	1395	98.4	3.423e-311
XYZ459H	contig_1	575552	575009	543	renamed_GCF_000008685.2	chromosome	575816	575273	543	98.8	7.636e-116
XYZ459H	contig_1	586778	587630	852	renamed_GCF_000008685.2	chromosome	587030	587882	852	100.0	3.506e-193
XYZ459H	contig_1	587813	589415	1602	renamed_GCF_000008685.2	chromosome	588065	589667	1602	100.0	0.0
XYZ459H	contig_1	589956	589431	525	renamed_GCF_000008685.2	chromosome	590208	589683	525	97.1	6.712e-106
XYZ459H	contig_1	590095	590683	588	renamed_GCF_000008685.2	chromosome	590347	590935	588	98.9	4.522e-129
XYZ459H	contig_1	590945	592115	1170	renamed_GCF_000008685.2	chromosome	591187	592357	1170	99.2	2.34e-251
XYZ459H	contig_1	592245	595689	3444	renamed_GCF_000008685.2	chromosome	592445	595931	3444	99.4	0.0
XYZ459H	contig_1	595700	596279	579	renamed_GCF_000008685.2	chromosome	595942	596521	579	98.9	1.865e-120
XYZ459H	contig_1	596288	598349	2061	renamed_GCF_000008685.2	chromosome	596530	598591	2061	99.8	0.0
XYZ459H	contig_1	599134	598345	789	renamed_GCF_000008685.2	chromosome	599376	598587	789	98.4	2.867e-176
XYZ459H	contig_1	611805	613743	1938	renamed_GCF_000008685.2	chromosome	612047	613985	1938	99.6	0.0
XYZ459H	contig_1	615529	613771	1758	renamed_GCF_000008685.2	chromosome	615771	614013	1758	99.3	0.0
XYZ459H	contig_1	616148	615521	627	renamed_GCF_000008685.2	chromosome	616390	615763	627	99.5	2.836e-132
XYZ459H	contig_1	618317	616169	2148	renamed_GCF_000008685.2	chromosome	618559	616411	2148	99.8	0.0
XYZ459H	contig_1	618585	620793	2208	renamed_GCF_000008685.2	chromosome	618827	621035	2208	99.8	0.0
XYZ459H	contig_1	621711	620802	909	renamed_GCF_000008685.2	chromosome	621953	621044	909	99.3	3.709e-202
XYZ459H	contig_1	621762	623205	1443	renamed_GCF_000008685.2	chromosome	622004	623447	1443	99.7	0.0
XYZ459H	contig_1	623208	624765	1557	renamed_GCF_000008685.2	chromosome	623450	625007	1557	98.4	0.0
XYZ459H	contig_1	624764	626018	1254	renamed_GCF_000008685.2	chromosome	625006	626260	1254	100.0	1.925e-276
XYZ459H	contig_1	626043	626796	753	renamed_GCF_000008685.2	chromosome	626285	627038	753	100.0	9.23e-166
XYZ459H	contig_1	642045	642198	153	renamed_GCF_000008685.2	chromosome	642288	642441	153	98.0	2.814e-30
XYZ459H	contig_1	642883	642256	627	renamed_GCF_000008685.2	chromosome	643126	642499	627	99.5	1.942e-136
XYZ459H	contig_1	644401	643051	1350	renamed_GCF_000008685.2	chromosome	644650	643294	1350	99.3	2.302e-299
XYZ459H	contig_1	644522	644891	369	renamed_GCF_000008685.2	chromosome	644771	645140	369	100.0	1.529e-79
XYZ459H	contig_1	645352	644887	465	renamed_GCF_000008685.2	chromosome	645601	645136	465	99.3	2.067e-100
XYZ459H	contig_1	645469	646432	963	renamed_GCF_000008685.2	chromosome	645718	646681	963	99.6	1.275e-214
XYZ459H	contig_1	648077	646409	1668	renamed_GCF_000008685.2	chromosome	648254	646658	1668	99.6	0.0
XYZ459H	contig_1	648303	648858	555	renamed_GCF_000008685.2	chromosome	648552	649107	555	100.0	3.12e-119
XYZ459H	contig_1	650138	648920	1218	renamed_GCF_000008685.2	chromosome	650387	649169	1218	99.7	1.361e-265
XYZ459H	contig_1	653541	650163	3378	renamed_GCF_000008685.2	chromosome	653790	650412	3378	99.0	0.0
XYZ459H	contig_1	683165	684710	1545	renamed_GCF_000008685.2	chromosome	683422	684967	1545	99.8	0.0
XYZ459H	contig_1	685723	684739	984	renamed_GCF_000008685.2	chromosome	685980	684996	984	100.0	1.708e-223
XYZ459H	contig_1	686250	685719	531	renamed_GCF_000008685.2	chromosome	686507	685976	531	100.0	1.053e-118
XYZ459H	contig_1	688232	689870	1638	renamed_GCF_000008685.2	chromosome	688489	690127	1638	100.0	0.0
XYZ459H	contig_1	689935	690232	297	renamed_GCF_000008685.2	chromosome	690192	690489	297	100.0	1.037e-63
XYZ459H	contig_1	690245	690542	297	renamed_GCF_000008685.2	chromosome	690481	690799	297	98.9	6.955e-60
XYZ459H	contig_1	690626	692387	1761	renamed_GCF_000008685.2	chromosome	690884	692645	1761	99.4	0.0
XYZ459H	contig_1	692370	693270	900	renamed_GCF_000008685.2	chromosome	692628	693528	900	99.6	4.423e-190
XYZ459H	contig_1	693295	694438	1143	renamed_GCF_000008685.2	chromosome	693553	694696	1143	99.7	8.841e-258
XYZ459H	contig_1	695265	694434	831	renamed_GCF_000008685.2	chromosome	695523	694692	831	99.6	1.298e-183
XYZ459H	contig_1	695363	696497	1134	renamed_GCF_000008685.2	chromosome	695630	696764	1134	98.9	8.424e-257
XYZ459H	contig_1	697170	696483	687	renamed_GCF_000008685.2	chromosome	697437	696750	687	100.0	2.97e-150
XYZ459H	contig_1	697318	698065	747	renamed_GCF_000008685.2	chromosome	697585	698332	747	100.0	1.547e-167
XYZ459H	contig_1	706401	708996	2595	renamed_GCF_000008685.2	chromosome	706672	709267	2595	99.5	0.0
XYZ459H	contig_1	709002	710403	1401	renamed_GCF_000008685.2	chromosome	709273	710674	1401	99.5	4.513e-309
XYZ459H	contig_1	710414	710900	486	renamed_GCF_000008685.2	chromosome	710685	711171	486	100.0	5.304e-102
XYZ459H	contig_1	711936	711420	516	renamed_GCF_000008685.2	chromosome	712207	711691	516	98.8	1.784e-110
XYZ459H	contig_1	712979	711932	1047	renamed_GCF_000008685.2	chromosome	713250	712203	1047	100.0	1.709e-225
XYZ459H	contig_1	713836	712972	864	renamed_GCF_000008685.2	chromosome	714107	713243	864	100.0	1.134e-190
XYZ459H	contig_1	769198	767806	1392	renamed_GCF_000008685.2	chromosome	769470	768078	1392	100.0	1.696e-292
XYZ459H	contig_1	771291	770889	402	renamed_GCF_000008685.2	chromosome	771563	771161	402	100.0	3.917e-83
XYZ459H	contig_1	786587	788672	2085	renamed_GCF_000008685.2	chromosome	786859	788962	2085	98.8	0.0
XYZ459H	contig_1	790517	789656	861	renamed_GCF_000008685.2	chromosome	790807	789946	861	99.6	3.489e-186
XYZ459H	contig_1	791962	791503	459	renamed_GCF_000008685.2	chromosome	792252	791793	459	100.0	5.068e-98
XYZ459H	contig_1	794565	793551	1014	renamed_GCF_000008685.2	chromosome	794855	793841	1014	97.9	1.229e-223
XYZ459H	contig_1	807677	806630	1047	renamed_GCF_000008685.2	chromosome	807966	806919	1047	99.7	1.181e-229
XYZ459H	contig_1	809263	808171	1092	renamed_GCF_000008685.2	chromosome	809552	808460	1092	99.7	8.623e-241
XYZ459H	contig_1	811221	810180	1041	renamed_GCF_000008685.2	chromosome	811510	810469	1041	100.0	2.778e-236
XYZ459H	contig_1	812950	812149	801	renamed_GCF_000008685.2	chromosome	813239	812438	801	100.0	9.279e-174
XYZ459H	contig_4	23195	22919	276	renamed_GCF_000008685.2	lp54	35953	36229	276	100.0	3.31e-56
XYZ459H	contig_4	24764	24200	564	renamed_GCF_000008685.2	lp54	34384	34948	564	99.4	3.599e-119
XYZ459H	contig_6	5307	3837	1470	renamed_GCF_000008685.2	lp28-2	24488	25955	1470	92.4	4.595e-303
XYZ459H	contig_6	6053	6746	693	renamed_GCF_000008685.2	lp28-2	23725	23032	693	99.5	9.17e-156
XYZ459H	contig_6	7119	7506	387	renamed_GCF_000008685.2	lp28-2	22659	22272	387	96.0	6.848e-83
XYZ459H	contig_6	10159	10942	783	renamed_GCF_000008685.2	lp28-2	19619	18836	783	92.3	3.794e-172
XYZ459H	contig_6	11741	12080	339	renamed_GCF_000008685.2	lp28-2	18019	17680	339	100.0	5.085e-70
XYZ459H	contig_6	13278	14304	1026	renamed_GCF_000008685.2	lp28-2	16482	15456	1026	98.8	4.608e-228
XYZ459H	contig_6	14876	15386	510	renamed_GCF_000008685.2	lp28-2	14885	14375	510	97.0	1.069e-106
XYZ459H	contig_6	16267	16606	339	renamed_GCF_000008685.2	lp28-2	13495	13156	339	100.0	3.422e-74
XYZ459H	contig_8	20180	19754	426	renamed_GCF_000008685.2	lp54	8441	8867	426	100.0	3.21e-89
XYZ459H	contig_10	4089	5127	1038	renamed_GCF_000008685.2	cp26	6676	7714	1038	99.4	4.211e-231
XYZ459H	contig_10	7516	8065	549	renamed_GCF_000008685.2	cp26	10103	10652	549	98.9	3.433e-117
XYZ459H	contig_10	9414	11007	1593	renamed_GCF_000008685.2	cp26	12013	13606	1593	98.4	0.0
XYZ459H	contig_10	14099	12560	1539	renamed_GCF_000008685.2	cp26	16667	15131	1539	98.0	0.0
XYZ459H	contig_10	26138	24788	1350	renamed_GCF_000008685.2	cp26	2186	836	1350	99.7	8.624e-302
XYZ459H	contig_11	1640	2372	732	renamed_GCF_000008685.2	lp25	22677	21945	732	100.0	5.239e-160
XYZ459H	contig_11	8731	9268	537	renamed_GCF_000008685.2	lp25	15545	15041	537	99.4	7.638e-115
XYZ459H	contig_11	10928	11492	564	renamed_GCF_000008685.2	lp25	13393	12829	564	99.4	2.235e-124
XYZ459H	contig_13	11675	12194	519	renamed_GCF_000008685.2	cp32-8	26381	26903	519	75.6	8.35e-86
XYZ459H	contig_14	3	753	750	renamed_GCF_000008685.2	cp32-7	20765	21515	750	100.0	1.281e-161
XYZ459H	contig_14	1325	1898	573	renamed_GCF_000008685.2	cp32-7	22087	22660	573	100.0	7.629e-121
XYZ459H	contig_14	4959	4182	777	renamed_GCF_000008685.2	cp32-8	25951	25174	777	94.1	1.477e-164
XYZ459H	contig_15	10275	11379	1104	renamed_GCF_000008685.2	cp32-7	26892	27984	1104	95.8	5.802e-230
XYZ459H	contig_16	2945	3470	525	renamed_GCF_000008685.2	cp32-6	21519	22098	525	65.2	7.009e-72
XYZ459H	contig_16	7065	6270	795	renamed_GCF_000008685.2	cp32-4	25435	24640	795	99.2	1.418e-176
XYZ459H	contig_1	1773	744	1029	renamed_GCF_000008685.2	chromosome	1796	767	1029	99.7	2.384e-227
XYZ459H	contig_1	7375	6286	1089	renamed_GCF_000008685.2	chromosome	7397	6308	1089	99.7	1.828e-240
XYZ459H	contig_1	8407	9178	771	renamed_GCF_000008685.2	chromosome	8426	9197	771	100.0	1.781e-161
XYZ459H	contig_1	11401	12142	741	renamed_GCF_000008685.2	chromosome	11420	12161	741	99.5	9.218e-164
XYZ459H	contig_1	12134	12734	600	renamed_GCF_000008685.2	chromosome	12153	12753	600	98.9	1.006e-130
XYZ459H	contig_1	15326	14705	621	renamed_GCF_000008685.2	chromosome	15345	14724	621	100.0	3.249e-138
XYZ459H	contig_1	15825	16785	960	renamed_GCF_000008685.2	chromosome	15994	16804	960	98.8	5.872e-171
XYZ459H	contig_1	25607	24680	927	renamed_GCF_000008685.2	chromosome	25623	24696	927	97.7	1.738e-196
XYZ459H	contig_1	26382	27432	1050	renamed_GCF_000008685.2	chromosome	26398	27448	1050	98.8	2.084e-232
XYZ459H	contig_1	50469	50106	363	renamed_GCF_000008685.2	chromosome	50474	50111	363	100.0	4.578e-75
XYZ459H	contig_1	52429	51247	1182	renamed_GCF_000008685.2	chromosome	52434	51252	1182	99.4	1.623e-257
XYZ459H	contig_1	55499	53528	1971	renamed_GCF_000008685.2	chromosome	55504	53533	1971	99.8	0.0
XYZ459H	contig_1	56743	56275	468	renamed_GCF_000008685.2	chromosome	56748	56280	468	100.0	3.979e-102
XYZ459H	contig_1	57253	57970	717	renamed_GCF_000008685.2	chromosome	57258	57975	717	98.7	3.592e-153
XYZ459H	contig_1	59031	58023	1008	renamed_GCF_000008685.2	chromosome	58982	58028	1008	99.6	2.659e-205
XYZ459H	contig_1	61251	60561	690	renamed_GCF_000008685.2	chromosome	61257	60567	690	98.6	3.759e-148
XYZ459H	contig_1	64031	65270	1239	renamed_GCF_000008685.2	chromosome	64037	65276	1239	99.7	2.817e-278
XYZ459H	contig_1	67241	69560	2319	renamed_GCF_000008685.2	chromosome	67247	69569	2319	99.6	0.0
XYZ459H	contig_1	94020	93420	600	renamed_GCF_000008685.2	chromosome	94032	93432	600	98.9	1.617e-125
XYZ459H	contig_1	96941	94598	2343	renamed_GCF_000008685.2	chromosome	96953	94610	2343	99.1	0.0
XYZ459H	contig_1	98768	97850	918	renamed_GCF_000008685.2	chromosome	98648	97862	918	99.6	5.205e-174
XYZ459H	contig_1	100214	100736	522	renamed_GCF_000008685.2	chromosome	100227	100749	522	98.2	7.285e-113
XYZ459H	contig_1	102936	101511	1425	renamed_GCF_000008685.2	chromosome	102949	101524	1425	99.7	1.105e-311
XYZ459H	contig_1	114590	112895	1695	renamed_GCF_000008685.2	chromosome	114603	112908	1695	100.0	0.0
XYZ459H	contig_1	116793	115491	1302	renamed_GCF_000008685.2	chromosome	116806	115504	1302	98.3	5.194e-282
XYZ459H	contig_1	118357	117664	693	renamed_GCF_000008685.2	chromosome	118370	117677	693	99.1	1.216e-152
XYZ459H	contig_1	119790	118950	840	renamed_GCF_000008685.2	chromosome	119803	118963	840	98.5	1.176e-177
XYZ459H	contig_1	145449	144576	873	renamed_GCF_000008685.2	chromosome	145458	144585	873	100.0	2.787e-199
XYZ459H	contig_1	147486	146367	1119	renamed_GCF_000008685.2	chromosome	147495	146376	1119	99.7	8.28e-246
XYZ459H	contig_1	148650	147639	1011	renamed_GCF_000008685.2	chromosome	148659	147648	1011	99.7	2.697e-214
XYZ459H	contig_1	150964	152170	1206	renamed_GCF_000008685.2	chromosome	150973	152179	1206	99.7	1.095e-274
XYZ459H	contig_1	153677	153065	612	renamed_GCF_000008685.2	chromosome	153686	153074	612	100.0	4.712e-141
XYZ459H	contig_1	156453	157590	1137	renamed_GCF_000008685.2	chromosome	156461	157598	1137	100.0	1.164e-253
XYZ459H	contig_1	158049	158466	417	renamed_GCF_000008685.2	chromosome	158075	158474	417	100.0	2.72e-81
XYZ459H	contig_1	171242	171476	234	renamed_GCF_000008685.2	chromosome	171262	171484	234	98.6	1.134e-44
XYZ459H	contig_1	174108	173520	588	renamed_GCF_000008685.2	chromosome	174116	173528	588	98.4	4.112e-130
XYZ459H	contig_1	204143	205079	936	renamed_GCF_000008685.2	chromosome	204136	205072	936	100.0	4.7e-204
XYZ459H	contig_1	205079	206051	972	renamed_GCF_000008685.2	chromosome	205174	206044	972	99.6	3.289e-188
XYZ459H	contig_1	245224	244621	603	renamed_GCF_000008685.2	chromosome	245382	244776	603	99.5	7.936e-134
XYZ459H	contig_1	246440	247946	1506	renamed_GCF_000008685.2	chromosome	246596	248102	1506	99.8	0.0
XYZ459H	contig_1	250514	250019	495	renamed_GCF_000008685.2	chromosome	250670	250175	495	100.0	5.051e-104
XYZ459H	contig_1	252081	251055	1026	renamed_GCF_000008685.2	chromosome	252237	251211	1026	99.7	2.737e-225
XYZ459H	contig_1	253002	254775	1773	renamed_GCF_000008685.2	chromosome	253158	254931	1773	99.3	0.0
XYZ459H	contig_1	283709	282542	1167	renamed_GCF_000008685.2	chromosome	283865	282698	1167	100.0	1.172e-258
XYZ459H	contig_1	286933	285814	1119	renamed_GCF_000008685.2	chromosome	287089	285970	1119	98.9	1.197e-241
XYZ459H	contig_1	321215	321902	687	renamed_GCF_000008685.2	chromosome	321351	322038	687	100.0	1.336e-150
XYZ459H	contig_1	322710	321903	807	renamed_GCF_000008685.2	chromosome	322846	322039	807	99.6	2.064e-174
XYZ459H	contig_1	323643	322710	933	renamed_GCF_000008685.2	chromosome	323779	322846	933	98.7	1.093e-202
XYZ459H	contig_1	325100	323639	1461	renamed_GCF_000008685.2	chromosome	325236	323775	1461	99.7	0.0
XYZ459H	contig_1	326152	325099	1053	renamed_GCF_000008685.2	chromosome	326288	325235	1053	99.7	1.991e-233
XYZ459H	contig_1	327591	326562	1029	renamed_GCF_000008685.2	chromosome	327757	326698	1029	99.4	1.646e-231
XYZ459H	contig_1	327895	329032	1137	renamed_GCF_000008685.2	chromosome	328031	329165	1137	99.7	1.4e-251
XYZ459H	contig_1	329128	329488	360	renamed_GCF_000008685.2	chromosome	329261	329621	360	100.0	1.609e-77
XYZ459H	contig_1	330619	329509	1110	renamed_GCF_000008685.2	chromosome	330752	329642	1110	99.4	5.455e-249
XYZ459H	contig_1	333474	330669	2805	renamed_GCF_000008685.2	chromosome	333598	330802	2805	99.6	0.0
XYZ459H	contig_1	346716	346305	411	renamed_GCF_000008685.2	chromosome	346841	346430	411	100.0	6.821e-87
XYZ459H	contig_1	347176	346735	441	renamed_GCF_000008685.2	chromosome	347301	346860	441	100.0	1.706e-98
XYZ459H	contig_1	348035	347225	810	renamed_GCF_000008685.2	chromosome	348160	347350	810	99.6	4.196e-184
XYZ459H	contig_1	349485	348027	1458	renamed_GCF_000008685.2	chromosome	349610	348152	1458	99.7	0.0
XYZ459H	contig_1	350920	349474	1446	renamed_GCF_000008685.2	chromosome	351045	349599	1446	98.7	1.963e-317
XYZ459H	contig_1	351206	350930	276	renamed_GCF_000008685.2	chromosome	351331	351055	276	95.6	4.486e-53
XYZ459H	contig_1	353315	351215	2100	renamed_GCF_000008685.2	chromosome	353437	351340	2100	98.7	0.0
XYZ459H	contig_1	354514	353314	1200	renamed_GCF_000008685.2	chromosome	354636	353439	1200	98.9	1.486e-261
XYZ459H	contig_1	355176	354525	651	renamed_GCF_000008685.2	chromosome	355298	354647	651	100.0	1.769e-141
XYZ459H	contig_1	355368	356787	1419	renamed_GCF_000008685.2	chromosome	355490	356909	1419	99.1	8.386e-314
XYZ459H	contig_1	379207	376915	2292	renamed_GCF_000008685.2	chromosome	379258	377038	2292	98.5	0.0
XYZ459H	contig_1	380435	379217	1218	renamed_GCF_000008685.2	chromosome	380558	379340	1218	99.5	2.093e-269
XYZ459H	contig_1	381769	380431	1338	renamed_GCF_000008685.2	chromosome	381892	380554	1338	99.5	6.95e-311
XYZ459H	contig_1	383259	381786	1473	renamed_GCF_000008685.2	chromosome	383382	381909	1473	99.7	0.0
XYZ459H	contig_1	384039	383271	768	renamed_GCF_000008685.2	chromosome	384162	383394	768	99.6	9.689e-168
XYZ459H	contig_1	384163	385303	1140	renamed_GCF_000008685.2	chromosome	384286	385426	1140	99.4	1.764e-249
XYZ459H	contig_1	396384	395358	1026	renamed_GCF_000008685.2	chromosome	396506	395480	1026	99.7	3.294e-223
XYZ459H	contig_1	396955	396481	474	renamed_GCF_000008685.2	chromosome	397077	396603	474	100.0	4.822e-101
XYZ459H	contig_1	397354	396979	375	renamed_GCF_000008685.2	chromosome	397476	397101	375	100.0	1.385e-81
XYZ459H	contig_1	401555	397421	4134	renamed_GCF_000008685.2	chromosome	401677	397543	4134	99.8	0.0
XYZ459H	contig_1	422937	423717	780	renamed_GCF_000008685.2	chromosome	423054	423834	780	100.0	3.296e-173
XYZ459H	contig_1	424328	423704	624	renamed_GCF_000008685.2	chromosome	424442	423821	624	99.5	4.527e-135
XYZ459H	contig_1	424575	425433	858	renamed_GCF_000008685.2	chromosome	424693	425551	858	99.6	7.8e-194
XYZ459H	contig_1	425465	426593	1128	renamed_GCF_000008685.2	chromosome	425583	426711	1128	100.0	1.044e-244
XYZ459H	contig_1	426617	427832	1215	renamed_GCF_000008685.2	chromosome	426735	427950	1215	99.5	3.802e-262
XYZ459H	contig_1	448585	449191	606	renamed_GCF_000008685.2	chromosome	448707	449310	606	99.5	2.46e-130
XYZ459H	contig_1	449299	450052	753	renamed_GCF_000008685.2	chromosome	449418	450171	753	100.0	3.278e-160
XYZ459H	contig_1	451802	451019	783	renamed_GCF_000008685.2	chromosome	451921	451138	783	100.0	1.017e-169
XYZ459H	contig_1	474492	475482	990	renamed_GCF_000008685.2	chromosome	474612	475602	990	99.3	4.321e-214
XYZ459H	contig_1	475485	476091	606	renamed_GCF_000008685.2	chromosome	475605	476211	606	99.5	2.237e-131
XYZ459H	contig_1	477953	476141	1812	renamed_GCF_000008685.2	chromosome	478005	476262	1812	99.4	0.0
XYZ459H	contig_1	479584	480895	1311	renamed_GCF_000008685.2	chromosome	479708	481019	1311	99.5	1.811e-295
XYZ459H	contig_1	481933	481219	714	renamed_GCF_000008685.2	chromosome	482057	481343	714	99.5	4.333e-159
XYZ459H	contig_1	482475	484158	1683	renamed_GCF_000008685.2	chromosome	482599	484282	1683	99.6	0.0
XYZ459H	contig_1	484162	484462	300	renamed_GCF_000008685.2	chromosome	484286	484586	300	100.0	5.976e-62
XYZ459H	contig_1	484638	485142	504	renamed_GCF_000008685.2	chromosome	484756	485266	504	100.0	1.216e-112
XYZ459H	contig_1	485425	485953	528	renamed_GCF_000008685.2	chromosome	485549	486077	528	99.4	4.968e-118
XYZ459H	contig_1	730912	731449	537	renamed_GCF_000008685.2	chromosome	731183	731720	537	100.0	1.936e-121
XYZ459H	contig_1	733807	735016	1209	renamed_GCF_000008685.2	chromosome	734080	735289	1209	100.0	8.188e-270
XYZ459H	contig_1	736425	736686	261	renamed_GCF_000008685.2	chromosome	736698	736959	261	100.0	3.165e-54
XYZ459H	contig_1	736686	736935	249	renamed_GCF_000008685.2	chromosome	736959	737208	249	100.0	2.148e-48
XYZ459H	contig_1	738132	738498	366	renamed_GCF_000008685.2	chromosome	738405	738771	366	100.0	9.695e-76
XYZ459H	contig_1	747850	749746	1896	renamed_GCF_000008685.2	chromosome	748122	750018	1896	100.0	0.0
XYZ459H	contig_1	750918	751887	969	renamed_GCF_000008685.2	chromosome	751190	752159	969	100.0	4.772e-218
XYZ459H	contig_1	752950	753796	846	renamed_GCF_000008685.2	chromosome	753291	754068	846	99.6	1.473e-167
XYZ459H	contig_1	754277	756077	1800	renamed_GCF_000008685.2	chromosome	754636	756349	1800	99.6	0.0
XYZ459H	contig_1	759313	759943	630	renamed_GCF_000008685.2	chromosome	759585	760215	630	99.0	4.119e-137
XYZ459H	contig_1	816038	815240	798	renamed_GCF_000008685.2	chromosome	816299	815501	798	100.0	1.968e-173
XYZ459H	contig_1	817139	817700	561	renamed_GCF_000008685.2	chromosome	817395	817956	561	100.0	3.237e-128
XYZ459H	contig_1	818348	818660	312	renamed_GCF_000008685.2	chromosome	818604	818916	312	100.0	1.086e-65
XYZ459H	contig_1	818985	819231	246	renamed_GCF_000008685.2	chromosome	819241	819487	246	100.0	8.275e-50
XYZ459H	contig_1	819285	820272	987	renamed_GCF_000008685.2	chromosome	819541	820528	987	100.0	5.255e-220
XYZ459H	contig_1	820928	822113	1185	renamed_GCF_000008685.2	chromosome	821184	822369	1185	99.7	2.615e-261
XYZ459H	contig_1	823006	823555	549	renamed_GCF_000008685.2	chromosome	823262	823811	549	98.9	8.399e-116
XYZ459H	contig_1	824125	825448	1323	renamed_GCF_000008685.2	chromosome	824381	825704	1323	100.0	8.966e-297
XYZ459H	contig_1	825444	827364	1920	renamed_GCF_000008685.2	chromosome	825700	827620	1920	100.0	0.0
XYZ459H	contig_1	828961	830065	1104	renamed_GCF_000008685.2	chromosome	829217	830321	1104	99.7	4.967e-249
XYZ459H	contig_1	859833	858660	1173	renamed_GCF_000008685.2	chromosome	860111	858938	1173	99.4	1.411e-257
XYZ459H	contig_1	862421	863369	948	renamed_GCF_000008685.2	chromosome	862698	863646	948	100.0	4.292e-207
XYZ459H	contig_1	864784	865642	858	renamed_GCF_000008685.2	chromosome	865052	865919	858	99.6	3.329e-186
XYZ459H	contig_1	866403	867324	921	renamed_GCF_000008685.2	chromosome	866680	867601	921	99.0	7.526e-205
XYZ459H	contig_1	867916	868462	546	renamed_GCF_000008685.2	chromosome	868194	868740	546	99.4	4.105e-123
XYZ459H	contig_1	890043	892896	2853	renamed_GCF_000008685.2	chromosome	890321	893174	2853	99.7	0.0
XYZ459H	contig_1	896849	896300	549	renamed_GCF_000008685.2	chromosome	897127	896578	549	99.4	5.734e-120
XYZ459H	contig_1	899042	897425	1617	renamed_GCF_000008685.2	chromosome	899320	897703	1617	98.8	0.0
XYZ459H	contig_1	900519	901503	984	renamed_GCF_000008685.2	chromosome	900798	901782	984	99.0	1.341e-217
XYZ459H	contig_3	20675	21242	567	renamed_GCF_000008685.2	lp28-3	17407	17974	567	99.4	9.584e-126
XYZ459H	contig_3	22065	22695	630	renamed_GCF_000008685.2	lp28-3	18797	19427	630	100.0	1.007e-135
XYZ459H	contig_3	25946	26219	273	renamed_GCF_000008685.2	lp28-3	22677	22953	273	100.0	7.02e-56
XYZ459H	contig_4	14604	15453	849	renamed_GCF_000008685.2	lp54	44533	43684	849	100.0	7.054e-185
XYZ459H	contig_4	16882	16675	207	renamed_GCF_000008685.2	lp54	42266	42473	207	100.0	9.856e-42
XYZ459H	contig_4	18103	18937	834	renamed_GCF_000008685.2	lp54	41045	40211	834	99.6	1.639e-181
XYZ459H	contig_5	17078	18191	1113	renamed_GCF_000008685.2	cp32-6	6710	7823	1113	98.3	2.209e-242
XYZ459H	contig_5	25754	26102	348	renamed_GCF_000008685.2	cp32-9	15518	15866	348	100.0	8.822e-74
XYZ459H	contig_5	26877	27378	501	renamed_GCF_000008685.2	cp32-4	16496	16997	501	99.3	5.556e-104
XYZ459H	contig_5	28900	27949	951	renamed_GCF_000008685.2	cp32-3	19228	18286	951	86.1	1.105e-179
XYZ459H	contig_6	1761	960	801	renamed_GCF_000008685.2	lp28-2	28030	28831	801	100.0	3.29e-168
XYZ459H	contig_6	3140	2711	429	renamed_GCF_000008685.2	lp28-2	26569	27085	429	94.3	6.173e-91
XYZ459H	contig_6	23026	22474	552	renamed_GCF_000008685.2	lp28-2	6736	7288	552	98.9	1.338e-119
XYZ459H	contig_6	23850	23082	768	renamed_GCF_000008685.2	lp28-2	5910	6678	768	98.4	2.852e-164
XYZ459H	contig_8	10461	9867	594	renamed_GCF_000008685.2	lp54	18127	18721	594	99.4	7.271e-125
XYZ459H	contig_8	13228	12796	432	renamed_GCF_000008685.2	lp54	15369	15801	432	97.2	9.777e-95
XYZ459H	contig_8	22101	21474	627	renamed_GCF_000008685.2	lp54	6520	7147	627	99.0	1.16e-133
XYZ459H	contig_8	23308	22972	336	renamed_GCF_000008685.2	lp54	5313	5649	336	100.0	1.784e-72
XYZ459H	contig_8	24365	25619	1254	renamed_GCF_000008685.2	lp54	4256	3002	1254	100.0	3.245e-279
XYZ459H	contig_8	27162	26652	510	renamed_GCF_000008685.2	lp54	1460	1970	510	100.0	8.829e-109
XYZ459H	contig_9	135	690	555	renamed_GCF_000008685.2	cp32-1	2010	2568	555	89.7	8.091e-109
XYZ459H	contig_9	7097	8387	1290	renamed_GCF_000008685.2	cp32-3	8967	10242	1290	62.2	8.688e-149
XYZ459H	contig_10	20608	20056	552	renamed_GCF_000008685.2	cp26	23154	22602	552	100.0	6.015e-120
XYZ459H	contig_10	22278	23907	1629	renamed_GCF_000008685.2	cp26	24824	26453	1629	99.8	0.0
XYZ459H	contig_11	11467	12226	759	renamed_GCF_000008685.2	lp25	12854	12095	759	99.6	1.114e-164
XYZ459H	contig_11	13612	14122	510	renamed_GCF_000008685.2	lp25	10694	10199	510	98.1	3.969e-109
XYZ459H	contig_12	1039	1423	384	renamed_GCF_000008685.2	lp28-4	173	608	384	66.6	3.726e-48
XYZ459H	contig_12	11765	11102	663	renamed_GCF_000008685.2	lp17	11646	10983	663	100.0	1.005e-149
XYZ459H	contig_12	13455	14196	741	renamed_GCF_000008685.2	lp17	13338	14079	741	100.0	7.64e-166
XYZ459H	contig_1	710939	711380	441	renamed_GCF_000008685.2	chromosome	711210	711651	441	100.0	1.245e-93
XYZ459H	contig_1	714495	713832	663	renamed_GCF_000008685.2	chromosome	714766	714103	663	99.0	3.258e-145
XYZ459H	contig_1	716348	717500	1152	renamed_GCF_000008685.2	chromosome	716619	717771	1152	100.0	1.261e-246
XYZ459H	contig_1	739411	739903	492	renamed_GCF_000008685.2	chromosome	739684	740176	492	100.0	4.374e-105
XYZ459H	contig_1	740172	740415	243	renamed_GCF_000008685.2	chromosome	740445	740688	243	100.0	1.755e-49
XYZ459H	contig_1	742355	741122	1233	renamed_GCF_000008685.2	chromosome	742628	741395	1233	99.2	9.028e-273
XYZ459H	contig_1	744248	744572	324	renamed_GCF_000008685.2	chromosome	744521	744845	324	99.0	2.941e-65
XYZ459H	contig_1	764098	765070	972	renamed_GCF_000008685.2	chromosome	764370	765342	972	99.6	1.468e-214
XYZ459H	contig_1	812099	811217	882	renamed_GCF_000008685.2	chromosome	812388	811506	882	97.6	8.145e-189
XYZ459H	contig_1	813445	813100	345	renamed_GCF_000008685.2	chromosome	813706	813385	345	92.0	6.146e-61
XYZ459H	contig_1	815041	814606	435	renamed_GCF_000008685.2	chromosome	815302	814867	435	100.0	4.611e-95
XYZ459H	contig_1	872305	869833	2472	renamed_GCF_000008685.2	chromosome	872583	870111	2472	99.8	0.0
XYZ459H	contig_1	874928	876170	1242	renamed_GCF_000008685.2	chromosome	875206	876448	1242	98.0	7.882e-276
XYZ459H	contig_1	879036	879972	936	renamed_GCF_000008685.2	chromosome	879314	880250	936	100.0	3.242e-208
XYZ459H	contig_1	883935	880806	3129	renamed_GCF_000008685.2	chromosome	884213	881084	3129	99.9	0.0
XYZ459H	contig_1	887901	886191	1710	renamed_GCF_000008685.2	chromosome	888179	886469	1710	99.4	0.0
XYZ459H	contig_4	24161	23315	846	renamed_GCF_000008685.2	lp54	34987	35833	846	99.2	1.362e-185
XYZ459H	contig_4	26407	26188	219	renamed_GCF_000008685.2	lp54	32741	32960	219	100.0	7.958e-46
XYZ459H	contig_5	2228	2801	573	renamed_GCF_000008685.2	cp32-9	22183	22723	573	92.6	2.17e-109
XYZ459H	contig_5	6309	6858	549	renamed_GCF_000008685.2	cp32-9	26209	26770	549	73.6	4.732e-80
XYZ459H	contig_5	8086	8626	540	renamed_GCF_000008685.2	cp32-8	28250	28790	540	98.3	8.011e-115
XYZ459H	contig_5	10786	12010	1224	renamed_GCF_000008685.2	cp32-4	65	1289	1224	99.7	1.034e-269
XYZ459H	contig_6	15421	16255	834	renamed_GCF_000008685.2	lp28-2	14341	13507	834	98.1	3.319e-182
XYZ459H	contig_6	16621	17014	393	renamed_GCF_000008685.2	lp28-2	13141	12748	393	100.0	6.841e-84
XYZ459H	contig_6	17010	17454	444	renamed_GCF_000008685.2	lp28-2	12752	12308	444	100.0	8.866e-98
XYZ459H	contig_6	17443	18262	819	renamed_GCF_000008685.2	lp28-2	12319	11500	819	98.5	2.879e-181
XYZ459H	contig_6	18271	18700	429	renamed_GCF_000008685.2	lp28-2	11491	11062	429	97.8	8.26e-88
XYZ459H	contig_7	1669	2113	444	renamed_GCF_000008685.2	lp28-3	1044	1368	444	82.6	6.903e-51
XYZ459H	contig_7	29247	28353	894	renamed_GCF_000008685.2	lp36	187	1081	894	98.6	8.951e-190
XYZ459H	contig_8	1203	594	609	renamed_GCF_000008685.2	lp54	27389	27998	609	100.0	2.346e-131
XYZ459H	contig_8	3130	1888	1242	renamed_GCF_000008685.2	lp54	25467	26694	1242	99.7	3.651e-267
XYZ459H	contig_8	14260	13714	546	renamed_GCF_000008685.2	lp54	14337	14883	546	100.0	1.338e-118
XYZ459H	contig_8	15043	14290	753	renamed_GCF_000008685.2	lp54	13554	14307	753	100.0	4.561e-165
XYZ459H	contig_8	15603	15018	585	renamed_GCF_000008685.2	lp54	12994	13579	585	100.0	1.763e-130
XYZ459H	contig_9	17630	18413	783	renamed_GCF_000008685.2	cp32-8	20739	21480	783	80.8	2.002e-136
XYZ459H	contig_10	5248	6178	930	renamed_GCF_000008685.2	cp26	7835	8765	930	98.7	4.695e-203
XYZ459H	contig_10	6687	7449	762	renamed_GCF_000008685.2	cp26	9274	10036	762	98.8	5.77e-164
XYZ459H	contig_10	8831	8333	498	renamed_GCF_000008685.2	cp26	11417	10919	498	99.3	3.972e-107
XYZ459H	contig_10	12536	11321	1215	renamed_GCF_000008685.2	cp26	15107	13892	1215	98.7	3.163e-264
XYZ459H	contig_10	24703	24259	444	renamed_GCF_000008685.2	cp26	751	307	444	99.3	7.305e-100
XYZ459H	contig_13	7106	7649	543	renamed_GCF_000008685.2	cp32-1	21560	22118	543	64.0	6.304e-76
XYZ459H	contig_13	11245	10468	777	renamed_GCF_000008685.2	lp56	29506	28729	777	100.0	6.363e-174
XYZ459H	contig_13	12221	13328	1107	renamed_GCF_000008685.2	cp32-1	26795	27932	1107	86.3	2.961e-203
XYZ459H	contig_14	792	1314	522	renamed_GCF_000008685.2	cp32-7	21521	22076	522	100.0	1.473e-113
XYZ459H	contig_14	3750	4176	426	renamed_GCF_000008685.2	cp32-7	24512	24938	426	99.2	3.989e-95
XYZ459H	contig_14	5389	6148	759	renamed_GCF_000008685.2	cp32-6	26256	27015	759	52.6	5.353e-68
XYZ459H	contig_17	3842	4448	606	renamed_GCF_000008685.2	cp32-8	13708	14314	606	97.5	1.616e-126
XYZ459H	contig_17	5897	6233	336	renamed_GCF_000008685.2	cp32-9	15855	16191	336	100.0	5.348e-69
XYZ459H	contig_17	7230	7818	588	renamed_GCF_000008685.2	cp32-7	16551	17139	588	97.9	1.778e-122