QUERY_ID	QUERY_NAME	QUERY_START	QUERY_END	QUERY_LENGTH	REF_ID	REF_NAME	REF_START	REF_END	REF_LENGTH	IDENTITY	EVALUE
URI120H	contig_1	2330	1145	1185	renamed_GCF_000008685.2	chromosome	908406	909591	1185	100.0	8.142e-266
URI120H	contig_1	8903	7478	1425	renamed_GCF_000008685.2	chromosome	901833	903258	1425	100.0	1.211e-310
URI120H	contig_1	9938	8954	984	renamed_GCF_000008685.2	chromosome	900798	901782	984	100.0	5.014e-220
URI120H	contig_1	11238	10005	1233	renamed_GCF_000008685.2	chromosome	899498	900731	1233	100.0	1.522e-275
URI120H	contig_1	11416	13033	1617	renamed_GCF_000008685.2	chromosome	899320	897703	1617	100.0	0.0
URI120H	contig_1	13041	13641	600	renamed_GCF_000008685.2	chromosome	897695	897095	600	100.0	6.881e-135
URI120H	contig_1	13609	14158	549	renamed_GCF_000008685.2	chromosome	897127	896578	549	100.0	1.159e-120
URI120H	contig_1	17608	14167	3441	renamed_GCF_000008685.2	chromosome	893128	896569	3441	100.0	0.0
URI120H	contig_1	20415	17562	2853	renamed_GCF_000008685.2	chromosome	890321	893174	2853	100.0	0.0
URI120H	contig_1	22557	24267	1710	renamed_GCF_000008685.2	chromosome	888179	886469	1710	100.0	0.0
URI120H	contig_1	24289	26509	2220	renamed_GCF_000008685.2	chromosome	886447	884227	2220	100.0	0.0
URI120H	contig_1	26523	29652	3129	renamed_GCF_000008685.2	chromosome	884213	881084	3129	100.0	0.0
URI120H	contig_1	29645	30470	825	renamed_GCF_000008685.2	chromosome	881091	880266	825	100.0	2.882e-182
URI120H	contig_1	31422	30486	936	renamed_GCF_000008685.2	chromosome	879314	880250	936	100.0	3.242e-208
URI120H	contig_1	34308	31455	2853	renamed_GCF_000008685.2	chromosome	876491	879281	2853	99.8	0.0
URI120H	contig_1	35530	34288	1242	renamed_GCF_000008685.2	chromosome	875206	876448	1242	100.0	1.008e-281
URI120H	contig_1	35604	38151	2547	renamed_GCF_000008685.2	chromosome	875132	872585	2547	100.0	0.0
URI120H	contig_1	38153	40625	2472	renamed_GCF_000008685.2	chromosome	872583	870111	2472	100.0	0.0
URI120H	contig_1	40713	41229	516	renamed_GCF_000008685.2	chromosome	870023	869507	516	100.0	1.621e-111
URI120H	contig_1	41221	42004	783	renamed_GCF_000008685.2	chromosome	869380	868732	783	99.5	1.931e-145
URI120H	contig_1	42542	41996	546	renamed_GCF_000008685.2	chromosome	868194	868740	546	100.0	1.846e-123
URI120H	contig_1	42622	42994	372	renamed_GCF_000008685.2	chromosome	868114	867742	372	100.0	7.954e-79
URI120H	contig_1	44056	43135	921	renamed_GCF_000008685.2	chromosome	866680	867601	921	100.0	3.086e-206
URI120H	contig_1	44243	44042	201	renamed_GCF_000008685.2	chromosome	866493	866694	201	100.0	2.206e-40
URI120H	contig_1	44821	44278	543	renamed_GCF_000008685.2	chromosome	865915	866458	543	100.0	2.343e-120
URI120H	contig_1	45684	44817	867	renamed_GCF_000008685.2	chromosome	865052	865919	867	100.0	6.442e-189
URI120H	contig_1	47101	45694	1407	renamed_GCF_000008685.2	chromosome	863635	865042	1407	100.0	1.287e-315
URI120H	contig_1	48038	47090	948	renamed_GCF_000008685.2	chromosome	862698	863646	948	100.0	4.292e-207
URI120H	contig_1	87928	87634	294	renamed_GCF_000008685.2	chromosome	822809	823103	294	100.0	1.207e-61
URI120H	contig_1	89553	88368	1185	renamed_GCF_000008685.2	chromosome	821184	822369	1185	100.0	1.177e-261
URI120H	contig_1	90131	89549	582	renamed_GCF_000008685.2	chromosome	820606	821188	582	100.0	9.143e-129
URI120H	contig_1	91496	91250	246	renamed_GCF_000008685.2	chromosome	819241	819487	246	100.0	8.275e-50
URI120H	contig_1	91816	91495	321	renamed_GCF_000008685.2	chromosome	819035	819242	321	98.5	2.552e-42
URI120H	contig_1	92720	92189	531	renamed_GCF_000008685.2	chromosome	818017	818548	531	100.0	1.403e-115
URI120H	contig_1	93342	92781	561	renamed_GCF_000008685.2	chromosome	817395	817956	561	100.0	3.237e-128
URI120H	contig_1	94438	95236	798	renamed_GCF_000008685.2	chromosome	816299	815501	798	100.0	1.968e-173
URI120H	contig_1	95435	95870	435	renamed_GCF_000008685.2	chromosome	815302	814867	435	100.0	4.611e-95
URI120H	contig_1	97031	97361	330	renamed_GCF_000008685.2	chromosome	813706	813385	330	97.2	1.608e-64
URI120H	contig_1	125691	123993	1698	renamed_GCF_000008685.2	chromosome	785056	786754	1698	100.0	0.0
URI120H	contig_1	127358	125726	1632	renamed_GCF_000008685.2	chromosome	783389	785021	1632	100.0	0.0
URI120H	contig_1	127918	128596	678	renamed_GCF_000008685.2	chromosome	782829	782151	678	100.0	4.744e-152
URI120H	contig_1	132983	131993	990	renamed_GCF_000008685.2	chromosome	777764	778754	990	100.0	1.559e-225
URI120H	contig_1	133963	133174	789	renamed_GCF_000008685.2	chromosome	776784	777573	789	100.0	8.439e-173
URI120H	contig_1	134068	135082	1014	renamed_GCF_000008685.2	chromosome	776679	775665	1014	100.0	1.623e-220
URI120H	contig_1	136071	135285	786	renamed_GCF_000008685.2	chromosome	774676	775462	786	100.0	1.17e-168
URI120H	contig_1	136379	139178	2799	renamed_GCF_000008685.2	chromosome	774368	771569	2799	100.0	0.0
URI120H	contig_1	139184	139586	402	renamed_GCF_000008685.2	chromosome	771563	771161	402	100.0	3.917e-83
URI120H	contig_1	141277	142669	1392	renamed_GCF_000008685.2	chromosome	769470	768078	1392	100.0	1.696e-292
URI120H	contig_1	142683	144015	1332	renamed_GCF_000008685.2	chromosome	768064	766732	1332	100.0	1.239e-294
URI120H	contig_1	145375	144031	1344	renamed_GCF_000008685.2	chromosome	765372	766716	1344	100.0	2.685e-305
URI120H	contig_1	146377	145405	972	renamed_GCF_000008685.2	chromosome	764370	765342	972	100.0	2.973e-215
URI120H	contig_1	162625	160729	1896	renamed_GCF_000008685.2	chromosome	748122	750018	1896	100.0	0.0
URI120H	contig_1	165447	164415	1032	renamed_GCF_000008685.2	chromosome	745301	746333	1032	100.0	2.498e-227
URI120H	contig_1	168005	166232	1773	renamed_GCF_000008685.2	chromosome	742743	744516	1773	100.0	0.0
URI120H	contig_1	168120	169353	1233	renamed_GCF_000008685.2	chromosome	742628	741395	1233	100.0	3.707e-274
URI120H	contig_1	170303	170060	243	renamed_GCF_000008685.2	chromosome	740445	740688	243	100.0	1.755e-49
URI120H	contig_1	171064	170572	492	renamed_GCF_000008685.2	chromosome	739684	740176	492	100.0	4.374e-105
URI120H	contig_1	171605	171065	540	renamed_GCF_000008685.2	chromosome	739143	739683	540	100.0	2.458e-119
URI120H	contig_1	172343	171977	366	renamed_GCF_000008685.2	chromosome	738405	738771	366	100.0	9.695e-76
URI120H	contig_1	173537	173036	501	renamed_GCF_000008685.2	chromosome	737211	737712	501	100.0	9.268e-107
URI120H	contig_1	173789	173540	249	renamed_GCF_000008685.2	chromosome	736959	737208	249	100.0	2.148e-48
URI120H	contig_1	174050	173789	261	renamed_GCF_000008685.2	chromosome	736698	736959	261	100.0	3.165e-54
URI120H	contig_1	175397	174062	1335	renamed_GCF_000008685.2	chromosome	735351	736686	1335	100.0	6.003e-286
URI120H	contig_1	198541	199057	516	renamed_GCF_000008685.2	chromosome	712207	711691	516	100.0	1.621e-111
URI120H	contig_1	200063	199577	486	renamed_GCF_000008685.2	chromosome	710685	711171	486	100.0	5.304e-102
URI120H	contig_1	201475	200074	1401	renamed_GCF_000008685.2	chromosome	709273	710674	1401	100.0	3.758e-311
URI120H	contig_1	205169	204143	1026	renamed_GCF_000008685.2	chromosome	705579	706605	1026	100.0	2.737e-225
URI120H	contig_1	205800	205248	552	renamed_GCF_000008685.2	chromosome	704948	705500	552	100.0	2.458e-121
URI120H	contig_1	207740	206780	960	renamed_GCF_000008685.2	chromosome	703008	703968	960	100.0	6.008e-214
URI120H	contig_1	208924	208474	450	renamed_GCF_000008685.2	chromosome	701824	702274	450	100.0	9.762e-98
URI120H	contig_1	209354	208943	411	renamed_GCF_000008685.2	chromosome	701394	701805	411	100.0	2.78e-88
URI120H	contig_1	209824	210697	873	renamed_GCF_000008685.2	chromosome	700924	700051	873	100.0	5.874e-191
URI120H	contig_1	222259	220621	1638	renamed_GCF_000008685.2	chromosome	688489	690127	1638	100.0	0.0
URI120H	contig_1	224241	224772	531	renamed_GCF_000008685.2	chromosome	686507	685976	531	100.0	1.053e-118
URI120H	contig_1	224768	225752	984	renamed_GCF_000008685.2	chromosome	685980	684996	984	100.0	1.708e-223
URI120H	contig_1	227326	225781	1545	renamed_GCF_000008685.2	chromosome	683422	684967	1545	100.0	0.0
URI120H	contig_1	228224	229064	840	renamed_GCF_000008685.2	chromosome	682524	681684	840	100.0	1.641e-182
URI120H	contig_1	229142	230186	1044	renamed_GCF_000008685.2	chromosome	681606	680562	1044	100.0	8.539e-233
URI120H	contig_1	230998	231790	792	renamed_GCF_000008685.2	chromosome	679750	678958	792	100.0	1.55e-166
URI120H	contig_1	231810	232857	1047	renamed_GCF_000008685.2	chromosome	678938	677891	1047	100.0	5.633e-238
URI120H	contig_1	235714	234370	1344	renamed_GCF_000008685.2	chromosome	675034	676378	1344	100.0	3.635e-293
URI120H	contig_1	237407	235970	1437	renamed_GCF_000008685.2	chromosome	673341	674778	1437	100.0	0.0
URI120H	contig_1	242230	245740	3510	renamed_GCF_000008685.2	chromosome	668517	665007	3510	100.0	0.0
URI120H	contig_1	247830	248145	315	renamed_GCF_000008685.2	chromosome	662917	662602	315	100.0	5.657e-65
URI120H	contig_1	249142	248218	924	renamed_GCF_000008685.2	chromosome	661605	662529	924	100.0	4.691e-202
URI120H	contig_1	265976	265607	369	renamed_GCF_000008685.2	chromosome	644771	645140	369	100.0	1.529e-79
URI120H	contig_1	267621	268248	627	renamed_GCF_000008685.2	chromosome	643126	642499	627	100.0	8.735e-137
URI120H	contig_1	268459	268306	153	renamed_GCF_000008685.2	chromosome	642288	642441	153	100.0	5.64e-31
URI120H	contig_1	272168	270875	1293	renamed_GCF_000008685.2	chromosome	638579	639872	1293	100.0	3.129e-286
URI120H	contig_1	272785	272191	594	renamed_GCF_000008685.2	chromosome	637971	638556	594	100.0	1.47e-125
URI120H	contig_1	276166	274735	1431	renamed_GCF_000008685.2	chromosome	634580	636011	1431	100.0	1.295e-319
URI120H	contig_1	278262	276282	1980	renamed_GCF_000008685.2	chromosome	632484	634464	1980	100.0	0.0
URI120H	contig_1	279978	278760	1218	renamed_GCF_000008685.2	chromosome	630795	631986	1218	99.7	8.847e-262
URI120H	contig_1	281798	283655	1857	renamed_GCF_000008685.2	chromosome	628948	627091	1857	100.0	0.0
URI120H	contig_1	284461	283708	753	renamed_GCF_000008685.2	chromosome	626285	627038	753	100.0	9.23e-166
URI120H	contig_1	287296	285739	1557	renamed_GCF_000008685.2	chromosome	623450	625007	1557	100.0	0.0
URI120H	contig_1	288793	289702	909	renamed_GCF_000008685.2	chromosome	621953	621044	909	100.0	1.521e-203
URI120H	contig_1	303763	305968	2205	renamed_GCF_000008685.2	chromosome	606983	604778	2205	100.0	0.0
URI120H	contig_1	308373	307017	1356	renamed_GCF_000008685.2	chromosome	602373	603729	1356	100.0	2.305e-300
URI120H	contig_1	311252	309902	1350	renamed_GCF_000008685.2	chromosome	599494	600844	1350	100.0	3.989e-293
URI120H	contig_1	311370	312159	789	renamed_GCF_000008685.2	chromosome	599376	598587	789	100.0	1.07e-178
URI120H	contig_1	314804	314225	579	renamed_GCF_000008685.2	chromosome	595942	596521	579	100.0	3.772e-121
URI120H	contig_1	318259	314815	3444	renamed_GCF_000008685.2	chromosome	592445	595931	3444	100.0	0.0
URI120H	contig_1	320399	319811	588	renamed_GCF_000008685.2	chromosome	590347	590935	588	100.0	4.112e-130
URI120H	contig_1	322681	321079	1602	renamed_GCF_000008685.2	chromosome	588065	589667	1602	100.0	0.0
URI120H	contig_1	323716	322864	852	renamed_GCF_000008685.2	chromosome	587030	587882	852	100.0	3.506e-193
URI120H	contig_1	325655	324590	1065	renamed_GCF_000008685.2	chromosome	585079	586156	1065	99.7	1.659e-237
URI120H	contig_1	325866	326556	690	renamed_GCF_000008685.2	chromosome	584880	584190	690	100.0	9.609e-155
URI120H	contig_1	327289	326914	375	renamed_GCF_000008685.2	chromosome	583457	583832	375	100.0	8.349e-79
URI120H	contig_1	330261	329103	1158	renamed_GCF_000008685.2	chromosome	580485	581643	1158	100.0	7.971e-253
URI120H	contig_1	341469	341208	261	renamed_GCF_000008685.2	chromosome	569277	569538	261	100.0	9.575e-51
URI120H	contig_1	342937	342469	468	renamed_GCF_000008685.2	chromosome	567809	568277	468	100.0	1.969e-101
URI120H	contig_1	375145	375568	423	renamed_GCF_000008685.2	chromosome	535600	535177	423	100.0	5.606e-91
URI120H	contig_1	376445	375590	855	renamed_GCF_000008685.2	chromosome	534300	535155	855	100.0	8.967e-192
URI120H	contig_1	379054	379618	564	renamed_GCF_000008685.2	chromosome	531692	531128	564	100.0	2.704e-122
URI120H	contig_1	381548	382643	1095	renamed_GCF_000008685.2	chromosome	529198	528103	1095	100.0	3.934e-250
URI120H	contig_1	386192	384491	1701	renamed_GCF_000008685.2	chromosome	524553	526254	1701	100.0	0.0
URI120H	contig_1	403336	402943	393	renamed_GCF_000008685.2	chromosome	507405	507798	393	100.0	3.073e-84
URI120H	contig_1	403740	403362	378	renamed_GCF_000008685.2	chromosome	507001	507379	378	100.0	8.763e-79
URI120H	contig_1	405188	403883	1305	renamed_GCF_000008685.2	chromosome	505553	506858	1305	100.0	4.133e-285
URI120H	contig_1	405638	405200	438	renamed_GCF_000008685.2	chromosome	505103	505541	438	100.0	1.186e-93
URI120H	contig_1	421759	421246	513	renamed_GCF_000008685.2	chromosome	488982	489495	513	100.0	1.545e-111
URI120H	contig_1	422516	421769	747	renamed_GCF_000008685.2	chromosome	488225	488972	747	100.0	3.778e-166
URI120H	contig_1	423207	422517	690	renamed_GCF_000008685.2	chromosome	487534	488224	690	100.0	9.609e-155
URI120H	contig_1	424025	423203	822	renamed_GCF_000008685.2	chromosome	486746	487538	822	100.0	1.872e-169
URI120H	contig_1	424668	423972	696	renamed_GCF_000008685.2	chromosome	486073	486769	696	100.0	2.835e-152
URI120H	contig_1	425985	425475	510	renamed_GCF_000008685.2	chromosome	484756	485266	510	100.0	1.216e-113
URI120H	contig_1	426455	426155	300	renamed_GCF_000008685.2	chromosome	484286	484586	300	100.0	5.976e-62
URI120H	contig_1	439521	440781	1260	renamed_GCF_000008685.2	chromosome	471220	469960	1260	100.0	2.539e-274
URI120H	contig_1	441076	441352	276	renamed_GCF_000008685.2	chromosome	469665	469389	276	100.0	1.644e-55
URI120H	contig_1	441354	443460	2106	renamed_GCF_000008685.2	chromosome	469387	467281	2106	100.0	0.0
URI120H	contig_1	467493	468054	561	renamed_GCF_000008685.2	chromosome	443248	442687	561	100.0	1.054e-123
URI120H	contig_1	475639	480124	4485	renamed_GCF_000008685.2	chromosome	435103	430618	4485	100.0	0.0
URI120H	contig_1	480126	481050	924	renamed_GCF_000008685.2	chromosome	430616	429692	924	100.0	4.275e-203
URI120H	contig_1	493021	492409	612	renamed_GCF_000008685.2	chromosome	417723	418335	612	99.5	1.531e-136
URI120H	contig_1	493643	493031	612	renamed_GCF_000008685.2	chromosome	417101	417713	612	100.0	4.975e-132
URI120H	contig_1	494221	494899	678	renamed_GCF_000008685.2	chromosome	416478	415845	678	99.5	1.008e-143
URI120H	contig_1	494951	496418	1467	renamed_GCF_000008685.2	chromosome	415793	414326	1467	100.0	0.0
URI120H	contig_1	497632	496429	1203	renamed_GCF_000008685.2	chromosome	413112	414315	1203	100.0	6.394e-263
URI120H	contig_1	497744	499289	1545	renamed_GCF_000008685.2	chromosome	413006	411455	1545	99.8	0.0
URI120H	contig_1	500297	501329	1032	renamed_GCF_000008685.2	chromosome	410447	409415	1032	100.0	9.895e-238
URI120H	contig_1	524586	523407	1179	renamed_GCF_000008685.2	chromosome	386158	387337	1179	100.0	1.981e-263
URI120H	contig_1	525296	524582	714	renamed_GCF_000008685.2	chromosome	385448	386162	714	100.0	3.427e-153
URI120H	contig_1	526458	525318	1140	renamed_GCF_000008685.2	chromosome	384286	385426	1140	100.0	7.242e-251
URI120H	contig_1	526582	527350	768	renamed_GCF_000008685.2	chromosome	384162	383394	768	100.0	1.961e-168
URI120H	contig_1	527362	528835	1473	renamed_GCF_000008685.2	chromosome	383382	381909	1473	100.0	0.0
URI120H	contig_1	528852	530190	1338	renamed_GCF_000008685.2	chromosome	381892	380554	1338	100.0	1.408e-311
URI120H	contig_1	530186	531404	1218	renamed_GCF_000008685.2	chromosome	380558	379340	1218	100.0	1.741e-271
URI120H	contig_1	531414	533706	2292	renamed_GCF_000008685.2	chromosome	379258	377038	2292	99.8	0.0
URI120H	contig_1	533725	534784	1059	renamed_GCF_000008685.2	chromosome	377019	375960	1059	100.0	5.328e-232
URI120H	contig_1	535084	534805	279	renamed_GCF_000008685.2	chromosome	375660	375939	279	100.0	3.143e-57
URI120H	contig_1	617537	618320	783	renamed_GCF_000008685.2	chromosome	293208	292425	783	100.0	6.057e-167
URI120H	contig_1	618319	619102	783	renamed_GCF_000008685.2	chromosome	292426	291643	783	100.0	1.874e-171
URI120H	contig_1	619150	619687	537	renamed_GCF_000008685.2	chromosome	291595	291058	537	100.0	7.638e-115
URI120H	contig_1	619724	620783	1059	renamed_GCF_000008685.2	chromosome	291021	289962	1059	100.0	3.164e-229
URI120H	contig_1	620828	621170	342	renamed_GCF_000008685.2	chromosome	289917	289575	342	100.0	1.077e-70
URI120H	contig_1	621162	621789	627	renamed_GCF_000008685.2	chromosome	289583	288956	627	100.0	2.836e-132
URI120H	contig_1	621799	622564	765	renamed_GCF_000008685.2	chromosome	288946	288181	765	100.0	2.478e-165
URI120H	contig_1	622572	622836	264	renamed_GCF_000008685.2	chromosome	288173	287909	264	100.0	2.025e-51
URI120H	contig_1	622868	623657	789	renamed_GCF_000008685.2	chromosome	287877	287088	789	100.0	1.783e-164
URI120H	contig_1	623656	624775	1119	renamed_GCF_000008685.2	chromosome	287089	285970	1119	100.0	9.957e-244
URI120H	contig_1	636892	635509	1383	renamed_GCF_000008685.2	chromosome	273856	275236	1383	99.7	2.662e-303
URI120H	contig_1	637098	638112	1014	renamed_GCF_000008685.2	chromosome	273647	272633	1014	100.0	5.532e-224
URI120H	contig_1	638065	640258	2193	renamed_GCF_000008685.2	chromosome	272641	270487	2193	100.0	0.0
URI120H	contig_1	640272	641073	801	renamed_GCF_000008685.2	chromosome	270473	269672	801	100.0	6.66e-169
URI120H	contig_1	643680	643470	210	renamed_GCF_000008685.2	chromosome	267065	267275	210	100.0	4.647e-42
URI120H	contig_1	644639	643694	945	renamed_GCF_000008685.2	chromosome	266106	267051	945	100.0	6.277e-211
URI120H	contig_1	646758	644631	2127	renamed_GCF_000008685.2	chromosome	263987	266114	2127	100.0	0.0
URI120H	contig_1	647033	649454	2421	renamed_GCF_000008685.2	chromosome	263712	261291	2421	100.0	0.0
URI120H	contig_1	664956	664191	765	renamed_GCF_000008685.2	chromosome	245789	246554	765	100.0	7.663e-170
URI120H	contig_1	665366	665969	603	renamed_GCF_000008685.2	chromosome	245382	244776	603	99.5	7.936e-134
URI120H	contig_1	666032	666803	771	renamed_GCF_000008685.2	chromosome	244713	243942	771	100.0	4.161e-169
URI120H	contig_1	668308	666742	1566	renamed_GCF_000008685.2	chromosome	242437	244003	1566	100.0	0.0
URI120H	contig_1	668456	670463	2007	renamed_GCF_000008685.2	chromosome	242289	240282	2007	100.0	0.0
URI120H	contig_1	670495	671602	1107	renamed_GCF_000008685.2	chromosome	240250	239143	1107	100.0	3.718e-244
URI120H	contig_1	671617	672445	828	renamed_GCF_000008685.2	chromosome	239128	238300	828	100.0	9.354e-187
URI120H	contig_1	672519	672777	258	renamed_GCF_000008685.2	chromosome	238226	237968	258	100.0	9.113e-51
URI120H	contig_1	672789	673116	327	renamed_GCF_000008685.2	chromosome	237956	237629	327	100.0	8.435e-71
URI120H	contig_1	673116	673524	408	renamed_GCF_000008685.2	chromosome	237629	237221	408	100.0	2.649e-88
URI120H	contig_1	684135	685920	1785	renamed_GCF_000008685.2	chromosome	226610	224825	1785	100.0	0.0
URI120H	contig_1	685960	686782	822	renamed_GCF_000008685.2	chromosome	224785	223963	822	100.0	3.638e-179
URI120H	contig_1	687567	686784	783	renamed_GCF_000008685.2	chromosome	223178	223961	783	100.0	3.455e-173
URI120H	contig_1	689112	687567	1545	renamed_GCF_000008685.2	chromosome	221741	223178	1545	99.7	1.424e-311
URI120H	contig_1	690017	689108	909	renamed_GCF_000008685.2	chromosome	220728	221637	909	100.0	9.393e-192
URI120H	contig_1	690946	690106	840	renamed_GCF_000008685.2	chromosome	219799	220639	840	100.0	1.641e-182
URI120H	contig_1	691111	691690	579	renamed_GCF_000008685.2	chromosome	219634	219055	579	100.0	8.388e-121
URI120H	contig_1	691667	692321	654	renamed_GCF_000008685.2	chromosome	219078	218424	654	100.0	1.052e-147
URI120H	contig_1	693465	692433	1032	renamed_GCF_000008685.2	chromosome	217277	218312	1032	100.0	9.666e-221
URI120H	contig_1	695319	693486	1833	renamed_GCF_000008685.2	chromosome	215426	217259	1833	100.0	0.0
URI120H	contig_1	709695	710781	1086	renamed_GCF_000008685.2	chromosome	201050	199964	1086	100.0	2.679e-244
URI120H	contig_1	715053	713049	2004	renamed_GCF_000008685.2	chromosome	195692	197696	2004	100.0	0.0
URI120H	contig_1	715870	715009	861	renamed_GCF_000008685.2	chromosome	194875	195736	861	99.6	3.179e-187
URI120H	contig_1	717282	718422	1140	renamed_GCF_000008685.2	chromosome	193463	192323	1140	100.0	4.164e-257
URI120H	contig_1	718418	719228	810	renamed_GCF_000008685.2	chromosome	192327	191517	810	100.0	2.276e-182
URI120H	contig_1	720027	719286	741	renamed_GCF_000008685.2	chromosome	190718	191459	741	100.0	7.281e-158
URI120H	contig_1	720682	720028	654	renamed_GCF_000008685.2	chromosome	190186	190717	654	100.0	6.314e-111
URI120H	contig_1	720886	721447	561	renamed_GCF_000008685.2	chromosome	189859	189298	561	100.0	1.275e-121
URI120H	contig_1	751378	750703	675	renamed_GCF_000008685.2	chromosome	159367	160042	675	100.0	1.946e-144
URI120H	contig_1	752118	751401	717	renamed_GCF_000008685.2	chromosome	158627	159344	717	100.0	1.01e-158
URI120H	contig_1	752688	752271	417	renamed_GCF_000008685.2	chromosome	158075	158474	417	100.0	2.72e-81
URI120H	contig_1	753119	752684	435	renamed_GCF_000008685.2	chromosome	157626	158061	435	100.0	6.167e-92
URI120H	contig_1	754284	753147	1137	renamed_GCF_000008685.2	chromosome	156461	157598	1137	100.0	1.164e-253
URI120H	contig_1	754345	757045	2700	renamed_GCF_000008685.2	chromosome	156400	153700	2700	100.0	0.0
URI120H	contig_1	757059	757671	612	renamed_GCF_000008685.2	chromosome	153686	153074	612	100.0	4.712e-141
URI120H	contig_1	758540	757733	807	renamed_GCF_000008685.2	chromosome	152205	153012	807	100.0	9.769e-183
URI120H	contig_1	759772	758566	1206	renamed_GCF_000008685.2	chromosome	150973	152179	1206	100.0	4.93e-275
URI120H	contig_1	788256	788868	612	renamed_GCF_000008685.2	chromosome	122491	121879	612	100.0	3.269e-128
URI120H	contig_1	788924	789647	723	renamed_GCF_000008685.2	chromosome	121823	121100	723	100.0	1.695e-162
URI120H	contig_1	789665	789944	279	renamed_GCF_000008685.2	chromosome	121082	120803	279	100.0	1.411e-57
URI120H	contig_1	790158	790941	783	renamed_GCF_000008685.2	chromosome	120589	119806	783	100.0	5.024e-169
URI120H	contig_1	790944	791784	840	renamed_GCF_000008685.2	chromosome	119803	118963	840	100.0	4.393e-180
URI120H	contig_1	791818	792373	555	renamed_GCF_000008685.2	chromosome	118929	118374	555	100.0	1.543e-118
URI120H	contig_1	792377	793070	693	renamed_GCF_000008685.2	chromosome	118370	117677	693	100.0	4.532e-155
URI120H	contig_1	793941	795243	1302	renamed_GCF_000008685.2	chromosome	116806	115504	1302	100.0	1.776e-285
URI120H	contig_1	795941	795239	702	renamed_GCF_000008685.2	chromosome	114806	115508	702	100.0	2.35e-155
URI120H	contig_1	816715	817315	600	renamed_GCF_000008685.2	chromosome	94032	93432	600	100.0	1.47e-126
URI120H	contig_1	817324	817870	546	renamed_GCF_000008685.2	chromosome	93423	92877	546	100.0	2.704e-119
URI120H	contig_1	819632	820937	1305	renamed_GCF_000008685.2	chromosome	91115	89810	1305	100.0	2.863e-289
URI120H	contig_1	820939	821548	609	renamed_GCF_000008685.2	chromosome	89808	89199	609	100.0	1.275e-129
URI120H	contig_1	823387	823822	435	renamed_GCF_000008685.2	chromosome	87360	86925	435	100.0	2.772e-92
URI120H	contig_1	823893	824868	975	renamed_GCF_000008685.2	chromosome	86854	85879	975	100.0	4.354e-220
URI120H	contig_1	825027	826707	1680	renamed_GCF_000008685.2	chromosome	85720	84040	1680	100.0	0.0
URI120H	contig_1	826827	827778	951	renamed_GCF_000008685.2	chromosome	83920	82969	951	99.6	3.736e-209
URI120H	contig_1	859495	860257	762	renamed_GCF_000008685.2	chromosome	51251	50489	762	100.0	1.168e-164
URI120H	contig_1	860272	860635	363	renamed_GCF_000008685.2	chromosome	50474	50111	363	100.0	4.578e-75
URI120H	contig_1	861406	860734	672	renamed_GCF_000008685.2	chromosome	49340	50012	672	100.0	9.591e-152
URI120H	contig_1	861487	862144	657	renamed_GCF_000008685.2	chromosome	49259	48602	657	100.0	2.137e-140
URI120H	contig_1	862842	862140	702	renamed_GCF_000008685.2	chromosome	47916	48606	702	100.0	4.54e-148
URI120H	contig_1	863580	862905	675	renamed_GCF_000008685.2	chromosome	47166	47841	675	100.0	3.937e-145
URI120H	contig_1	864367	864736	369	renamed_GCF_000008685.2	chromosome	46379	46010	369	100.0	3.085e-80
URI120H	contig_1	865301	864755	546	renamed_GCF_000008685.2	chromosome	45445	45991	546	100.0	3.273e-117
URI120H	contig_1	865392	867840	2448	renamed_GCF_000008685.2	chromosome	45354	42906	2448	100.0	0.0
URI120H	contig_1	867865	868267	402	renamed_GCF_000008685.2	chromosome	42881	42479	402	100.0	2.405e-88
URI120H	contig_1	881204	879731	1473	renamed_GCF_000008685.2	chromosome	29542	31015	1473	99.7	0.0
URI120H	contig_1	881274	882255	981	renamed_GCF_000008685.2	chromosome	29472	28491	981	100.0	8.047e-223
URI120H	contig_1	882256	882892	636	renamed_GCF_000008685.2	chromosome	28490	27854	636	100.0	8.334e-139
URI120H	contig_1	882881	883313	432	renamed_GCF_000008685.2	chromosome	27865	27433	432	100.0	2.641e-92
URI120H	contig_1	884348	883298	1050	renamed_GCF_000008685.2	chromosome	26398	27448	1050	100.0	7.794e-235
URI120H	contig_1	884994	884355	639	renamed_GCF_000008685.2	chromosome	25752	26391	639	100.0	1.211e-143
URI120H	contig_1	885123	886050	927	renamed_GCF_000008685.2	chromosome	25623	24696	927	100.0	1.199e-200
URI120H	contig_1	886050	886782	732	renamed_GCF_000008685.2	chromosome	24696	23964	732	100.0	2.844e-158
URI120H	contig_1	887928	886788	1140	renamed_GCF_000008685.2	chromosome	22818	23958	1140	100.0	2.624e-262
URI120H	contig_1	888007	888601	594	renamed_GCF_000008685.2	chromosome	22739	22145	594	100.0	3.27e-125
URI120H	contig_1	888645	889689	1044	renamed_GCF_000008685.2	chromosome	22101	21057	1044	100.0	6.693e-227
URI120H	contig_1	892442	892955	513	renamed_GCF_000008685.2	chromosome	18304	17791	513	100.0	1.701e-110
URI120H	contig_1	894752	893942	810	renamed_GCF_000008685.2	chromosome	15994	16804	810	100.0	1.068e-173
URI120H	contig_1	895024	895402	378	renamed_GCF_000008685.2	chromosome	15716	15344	378	100.0	1.768e-79
URI120H	contig_1	895401	896022	621	renamed_GCF_000008685.2	chromosome	15345	14724	621	100.0	3.249e-138
URI120H	contig_1	898001	896018	1983	renamed_GCF_000008685.2	chromosome	12745	14728	1983	100.0	0.0
URI120H	contig_1	898593	897993	600	renamed_GCF_000008685.2	chromosome	12153	12753	600	100.0	4.114e-132
URI120H	contig_1	908951	909980	1029	renamed_GCF_000008685.2	chromosome	1796	767	1029	99.7	2.384e-227
URI120H	contig_1	910634	910070	564	renamed_GCF_000008685.2	chromosome	104	677	564	100.0	4.108e-126
URI120H	contig_2	950	152	798	renamed_GCF_000008685.2	lp54	52705	53503	798	100.0	3.008e-177
URI120H	contig_2	1950	1176	774	renamed_GCF_000008685.2	lp54	51705	52479	774	100.0	9.219e-161
URI120H	contig_2	2479	3370	891	renamed_GCF_000008685.2	lp54	51176	50285	891	100.0	3.698e-199
URI120H	contig_2	3560	3803	243	renamed_GCF_000008685.2	lp54	50077	49852	243	98.6	5.904e-45
URI120H	contig_2	5388	6180	792	renamed_GCF_000008685.2	lp54	48267	47475	792	100.0	4.37e-172
URI120H	contig_2	6427	7183	756	renamed_GCF_000008685.2	lp54	47228	46472	756	100.0	2.151e-165
URI120H	contig_2	7708	8938	1230	renamed_GCF_000008685.2	lp54	45947	44711	1230	98.7	1.97e-263
URI120H	contig_2	24277	23902	375	renamed_GCF_000008685.2	lp54	29383	29758	375	100.0	1.685e-79
URI120H	contig_2	24726	24273	453	renamed_GCF_000008685.2	lp54	28934	29387	453	100.0	2.51e-96
URI120H	contig_2	25647	24729	918	renamed_GCF_000008685.2	lp54	28013	28931	918	100.0	2.109e-201
URI120H	contig_2	26271	25662	609	renamed_GCF_000008685.2	lp54	27389	27998	609	100.0	2.346e-131
URI120H	contig_2	28208	26966	1242	renamed_GCF_000008685.2	lp54	25467	26694	1242	100.0	1.5e-268
URI120H	contig_2	29163	28557	606	renamed_GCF_000008685.2	lp54	24497	25103	606	100.0	6.612e-128
URI120H	contig_2	29884	29245	639	renamed_GCF_000008685.2	lp54	23776	24415	639	100.0	9.606e-138
URI120H	contig_2	30387	31977	1590	renamed_GCF_000008685.2	lp54	23273	21683	1590	100.0	0.0
URI120H	contig_2	32574	32034	540	renamed_GCF_000008685.2	lp54	21086	21626	540	100.0	8.011e-115
URI120H	contig_2	43373	42482	891	renamed_GCF_000008685.2	lp54	10287	11178	891	100.0	1.898e-189
URI120H	contig_2	44204	43382	822	renamed_GCF_000008685.2	lp54	9456	10278	822	100.0	5.801e-174
URI120H	contig_2	45219	44793	426	renamed_GCF_000008685.2	lp54	8441	8867	426	100.0	3.21e-89
URI120H	contig_2	45395	45215	180	renamed_GCF_000008685.2	lp54	8265	8445	180	100.0	1.452e-33
URI120H	contig_2	46452	45417	1035	renamed_GCF_000008685.2	lp54	7208	8243	1035	100.0	8.138e-232
URI120H	contig_2	47140	46513	627	renamed_GCF_000008685.2	lp54	6520	7147	627	100.0	4.747e-135
URI120H	contig_2	48015	47142	873	renamed_GCF_000008685.2	lp54	5645	6518	873	100.0	2.408e-192
URI120H	contig_2	48347	48011	336	renamed_GCF_000008685.2	lp54	5313	5649	336	100.0	1.784e-72
URI120H	contig_2	48520	48994	474	renamed_GCF_000008685.2	lp54	5140	4666	474	100.0	5.31e-100
URI120H	contig_2	49404	50658	1254	renamed_GCF_000008685.2	lp54	4256	3002	1254	100.0	3.245e-279
URI120H	contig_2	50767	51616	849	renamed_GCF_000008685.2	lp54	2893	2044	849	100.0	5.332e-188
URI120H	contig_2	52200	51690	510	renamed_GCF_000008685.2	lp54	1460	1970	510	100.0	8.829e-109
URI120H	contig_3	7665	10926	3261	renamed_GCF_000008685.2	lp56	43696	40435	3261	100.0	0.0
URI120H	contig_3	21408	20385	1023	renamed_GCF_000008685.2	lp56	29936	30974	1023	98.5	6.367e-224
URI120H	contig_3	21838	22615	777	renamed_GCF_000008685.2	lp56	29506	28729	777	97.6	2.057e-169
URI120H	contig_3	24424	23098	1326	renamed_GCF_000008685.2	cp32-7	23134	24460	1326	99.7	3.211e-300
URI120H	contig_3	25455	24918	537	renamed_GCF_000008685.2	lp56	25889	26426	537	100.0	1.544e-115
URI120H	contig_3	26827	26071	756	renamed_GCF_000008685.2	lp56	24517	25273	756	100.0	1.063e-164
URI120H	contig_3	27369	26802	567	renamed_GCF_000008685.2	lp56	23975	24542	567	100.0	1.456e-129
URI120H	contig_3	28476	27378	1098	renamed_GCF_000008685.2	lp56	22868	23966	1098	98.3	1.326e-245
URI120H	contig_3	28865	29810	945	renamed_GCF_000008685.2	cp32-3	19228	18286	945	97.1	4.095e-207
URI120H	contig_3	30498	29886	612	renamed_GCF_000008685.2	lp56	20843	21455	612	100.0	1.152e-139
URI120H	contig_3	32030	31694	336	renamed_GCF_000008685.2	lp56	19256	19592	336	100.0	5.348e-69
URI120H	contig_3	32367	32019	348	renamed_GCF_000008685.2	cp32-1	15421	15769	348	100.0	3.962e-74
URI120H	contig_3	32574	32370	204	renamed_GCF_000008685.2	cp32-1	15214	15418	204	100.0	2.578e-39
URI120H	contig_3	33464	32648	816	renamed_GCF_000008685.2	lp56	17822	18638	816	99.6	1.49e-179
URI120H	contig_3	34079	33473	606	renamed_GCF_000008685.2	cp32-8	13708	14314	606	100.0	5.47e-130
URI120H	contig_3	34964	34088	876	renamed_GCF_000008685.2	cp32-6	12842	13718	876	100.0	5.609e-192
URI120H	contig_3	35293	34960	333	renamed_GCF_000008685.2	cp32-8	12494	12827	333	100.0	8.424e-72
URI120H	contig_3	35877	35322	555	renamed_GCF_000008685.2	lp56	15409	15964	555	100.0	3.12e-119
URI120H	contig_3	42875	42419	456	renamed_GCF_000008685.2	cp32-6	4948	5404	456	99.3	5.32e-97
URI120H	contig_3	43854	42894	960	renamed_GCF_000008685.2	cp32-4	3972	4932	960	100.0	6.008e-214
URI120H	contig_3	44451	43875	576	renamed_GCF_000008685.2	lp56	6835	7411	576	98.9	2.236e-126
URI120H	contig_3	44947	45484	537	renamed_GCF_000008685.2	lp56	6339	5802	537	100.0	1.599e-123
URI120H	contig_3	45456	46218	762	renamed_GCF_000008685.2	lp56	5830	5068	762	100.0	1.784e-168
URI120H	contig_3	46300	47038	738	renamed_GCF_000008685.2	lp56	4986	4248	738	100.0	1.779e-164
URI120H	contig_3	47664	47178	486	renamed_GCF_000008685.2	lp56	3622	4108	486	100.0	4.376e-104
URI120H	contig_3	48543	47790	753	renamed_GCF_000008685.2	lp56	2743	3496	753	100.0	1.868e-166
URI120H	contig_4	4507	5413	906	renamed_GCF_000008685.2	lp38	4575	5496	906	99.6	4.034e-192
URI120H	contig_4	6005	6779	774	renamed_GCF_000008685.2	lp38	6088	6862	774	100.0	2.049e-160
URI120H	contig_4	9062	8786	276	renamed_GCF_000008685.2	lp38	9155	8876	276	98.9	6.666e-57
URI120H	contig_4	11043	10455	588	renamed_GCF_000008685.2	lp38	11105	10517	588	100.0	1.006e-128
URI120H	contig_4	11827	11089	738	renamed_GCF_000008685.2	lp38	11889	11151	738	100.0	8.004e-165
URI120H	contig_4	12390	11799	591	renamed_GCF_000008685.2	lp38	12452	11861	591	100.0	1.604e-132
URI120H	contig_4	13378	12382	996	renamed_GCF_000008685.2	lp38	13440	12444	996	100.0	8.455e-225
URI120H	contig_4	16456	17266	810	renamed_GCF_000008685.2	lp38	16519	17329	810	100.0	3.013e-179
URI120H	contig_4	17324	18107	783	renamed_GCF_000008685.2	lp38	17387	18170	783	100.0	3.455e-173
URI120H	contig_4	18150	19191	1041	renamed_GCF_000008685.2	lp38	18213	19254	1041	100.0	2.778e-236
URI120H	contig_4	19249	19945	696	renamed_GCF_000008685.2	lp38	19312	20008	696	100.0	6.303e-152
URI120H	contig_4	19937	21167	1230	renamed_GCF_000008685.2	lp38	20000	21230	1230	100.0	1.496e-266
URI120H	contig_4	21159	21885	726	renamed_GCF_000008685.2	lp38	21222	21948	726	100.0	1.164e-158
URI120H	contig_4	21907	22945	1038	renamed_GCF_000008685.2	lp38	22042	23008	1038	99.6	1.164e-219
URI120H	contig_4	23302	24025	723	renamed_GCF_000008685.2	lp38	23365	24088	723	100.0	6.027e-157
URI120H	contig_4	26344	25273	1071	renamed_GCF_000008685.2	lp38	26407	25336	1071	100.0	4.439e-236
URI120H	contig_4	27989	26930	1059	renamed_GCF_000008685.2	lp38	28053	26994	1059	100.0	1.184e-231
URI120H	contig_4	30707	29840	867	renamed_GCF_000008685.2	lp28-4	25089	24222	867	99.6	5.869e-190
URI120H	contig_4	31158	32076	918	renamed_GCF_000008685.2	lp38	31219	32140	918	99.6	1.1e-208
URI120H	contig_4	32433	33156	723	renamed_GCF_000008685.2	lp38	32497	33220	723	100.0	6.027e-157
URI120H	contig_4	34604	34307	297	renamed_GCF_000008685.2	lp38	34668	34371	297	100.0	2.824e-61
URI120H	contig_4	35527	34840	687	renamed_GCF_000008685.2	lp38	35591	34904	687	100.0	9.164e-155
URI120H	contig_4	36184	35569	615	renamed_GCF_000008685.2	lp38	36248	35633	615	100.0	2.836e-130
URI120H	contig_5	10436	10259	177	renamed_GCF_000008685.2	lp36	24066	24243	177	100.0	7.659e-32
URI120H	contig_5	12209	12035	174	renamed_GCF_000008685.2	lp36	22293	22467	174	100.0	8.56e-38
URI120H	contig_5	12591	12369	222	renamed_GCF_000008685.2	lp36	21911	22133	222	100.0	1.866e-45
URI120H	contig_5	14114	13049	1065	renamed_GCF_000008685.2	lp36	20388	21453	1065	100.0	2.633e-232
URI120H	contig_5	17123	16919	204	renamed_GCF_000008685.2	lp36	17379	17583	204	100.0	8.441e-43
URI120H	contig_5	18228	17616	612	renamed_GCF_000008685.2	lp36	16274	16886	612	100.0	9.153e-134
URI120H	contig_5	18742	19669	927	renamed_GCF_000008685.2	lp36	15760	14833	927	100.0	2.815e-208
URI120H	contig_5	19661	20201	540	renamed_GCF_000008685.2	lp36	14841	14301	540	100.0	2.234e-120
URI120H	contig_5	20176	20926	750	renamed_GCF_000008685.2	lp36	14326	13576	750	100.0	1.062e-163
URI120H	contig_5	21901	21265	636	renamed_GCF_000008685.2	lp36	12601	13237	636	100.0	3.41e-140
URI120H	contig_5	24202	22555	1647	renamed_GCF_000008685.2	lp36	10300	11947	1647	100.0	0.0
URI120H	contig_5	25130	24503	627	renamed_GCF_000008685.2	lp36	9372	9999	627	100.0	1.942e-136
URI120H	contig_5	25643	26339	696	renamed_GCF_000008685.2	lp36	8859	8163	696	100.0	1.275e-152
URI120H	contig_5	28137	27852	285	renamed_GCF_000008685.2	lp36	6365	6650	285	100.0	1.151e-60
URI120H	contig_5	28462	29215	753	renamed_GCF_000008685.2	lp36	6040	5287	753	100.0	7.287e-160
URI120H	contig_5	34315	33421	894	renamed_GCF_000008685.2	lp36	187	1081	894	100.0	7.433e-192
URI120H	contig_6	535	1228	693	renamed_GCF_000008685.2	cp32-1	1305	1998	693	100.0	2.582e-144
URI120H	contig_6	1240	1798	558	renamed_GCF_000008685.2	cp32-7	2009	2567	558	100.0	1.105e-122
URI120H	contig_6	4626	5010	384	renamed_GCF_000008685.2	cp32-6	5403	5787	384	100.0	2.931e-83
URI120H	contig_6	4997	5387	390	renamed_GCF_000008685.2	cp32-6	5774	6164	390	100.0	1.451e-83
URI120H	contig_6	5933	7046	1113	renamed_GCF_000008685.2	cp32-7	6702	7815	1113	100.0	3.095e-247
URI120H	contig_6	7060	7489	429	renamed_GCF_000008685.2	cp32-6	7837	8266	429	100.0	5.601e-92
URI120H	contig_6	7956	8193	237	renamed_GCF_000008685.2	cp32-7	8725	8962	237	100.0	7.893e-49
URI120H	contig_6	8200	9535	1335	renamed_GCF_000008685.2	cp32-7	8969	10304	1335	100.0	9.244e-290
URI120H	contig_6	9547	10189	642	renamed_GCF_000008685.2	cp32-7	10316	10958	642	99.5	4.53e-138
URI120H	contig_6	15783	16470	687	renamed_GCF_000008685.2	lp56	20042	20738	687	79.2	3.243e-115
URI120H	contig_6	18069	17055	1014	renamed_GCF_000008685.2	cp32-1	18728	17714	1014	99.7	7.051e-230
URI120H	contig_6	19568	20135	567	renamed_GCF_000008685.2	cp32-1	20223	20790	567	100.0	2.944e-130
URI120H	contig_6	20110	20851	741	renamed_GCF_000008685.2	cp32-1	20765	21506	741	100.0	1.112e-161
URI120H	contig_6	20905	21463	558	renamed_GCF_000008685.2	cp32-1	21560	22118	558	100.0	2.975e-120
URI120H	contig_6	21475	22108	633	renamed_GCF_000008685.2	cp32-1	22130	22763	633	100.0	1.275e-133
URI120H	contig_6	22578	23904	1326	renamed_GCF_000008685.2	cp32-1	23230	24556	1326	99.7	3.52e-299
URI120H	contig_6	23956	24382	426	renamed_GCF_000008685.2	cp32-1	24608	25034	426	100.0	1.627e-96
URI120H	contig_6	25164	24387	777	renamed_GCF_000008685.2	cp32-1	25816	25039	777	99.6	6.363e-174
URI120H	contig_6	25594	26116	522	renamed_GCF_000008685.2	cp32-8	26381	26903	522	100.0	1.338e-114
URI120H	contig_6	26143	27280	1137	renamed_GCF_000008685.2	cp32-1	26795	27932	1137	100.0	3.741e-249
URI120H	contig_6	27463	28003	540	renamed_GCF_000008685.2	cp32-8	28250	28790	540	100.0	1.472e-116
URI120H	contig_7	10333	9640	693	renamed_GCF_000008685.2	cp32-8	1305	1998	693	100.0	2.582e-144
URI120H	contig_7	11573	10349	1224	renamed_GCF_000008685.2	cp32-6	65	1289	1224	100.0	2.096e-270
URI120H	contig_7	15564	14472	1092	renamed_GCF_000008685.2	cp32-7	26892	27984	1092	64.3	1.945e-143
URI120H	contig_7	17817	17391	426	renamed_GCF_000008685.2	cp32-7	24512	24938	426	99.2	1.793e-95
URI120H	contig_7	25289	24842	447	renamed_GCF_000008685.2	cp32-1	17231	17678	447	93.2	1.663e-91
URI120H	contig_7	25949	25394	555	renamed_GCF_000008685.2	cp32-8	16544	17099	555	100.0	3.776e-117
URI120H	contig_7	26407	26053	354	renamed_GCF_000008685.2	cp32-6	16102	16456	354	100.0	1.459e-77
URI120H	contig_7	26735	26399	336	renamed_GCF_000008685.2	cp32-8	15758	16094	336	100.0	5.348e-69
URI120H	contig_8	3546	3117	429	renamed_GCF_000008685.2	cp32-1	7827	8256	429	100.0	5.601e-92
URI120H	contig_8	5980	5596	384	renamed_GCF_000008685.2	cp32-7	5395	5779	384	100.0	2.931e-83
URI120H	contig_8	9366	8808	558	renamed_GCF_000008685.2	cp32-3	2010	2568	558	100.0	1.105e-122
URI120H	contig_8	10071	9378	693	renamed_GCF_000008685.2	cp32-3	1305	1998	693	100.0	2.582e-144
URI120H	contig_8	11311	10087	1224	renamed_GCF_000008685.2	cp32-1	65	1289	1224	100.0	2.096e-270
URI120H	contig_8	17555	17129	426	renamed_GCF_000008685.2	cp32-8	24743	25169	426	99.2	1.793e-95
URI120H	contig_8	23006	21908	1098	renamed_GCF_000008685.2	cp32-8	19090	20188	1098	98.6	1.209e-246
URI120H	contig_8	26340	26004	336	renamed_GCF_000008685.2	cp32-9	15855	16191	336	100.0	5.348e-69
URI120H	contig_8	26677	26329	348	renamed_GCF_000008685.2	cp32-8	15421	15769	348	100.0	8.822e-74
URI120H	contig_8	26884	26680	204	renamed_GCF_000008685.2	cp32-7	15221	15425	204	100.0	2.578e-39
URI120H	contig_8	29274	28395	879	renamed_GCF_000008685.2	cp32-7	12831	13710	879	100.0	2.903e-191
URI120H	contig_8	29603	29270	333	renamed_GCF_000008685.2	cp32-7	12502	12835	333	100.0	1.876e-71
URI120H	contig_9	2991	2535	456	renamed_GCF_000008685.2	cp32-7	8273	8729	456	100.0	8.859e-100
URI120H	contig_9	3435	3006	429	renamed_GCF_000008685.2	cp32-7	7829	8258	429	100.0	5.601e-92
URI120H	contig_9	5112	4542	570	renamed_GCF_000008685.2	cp32-6	6160	6730	570	98.4	5.468e-124
URI120H	contig_9	7303	6343	960	renamed_GCF_000008685.2	cp32-1	3962	4922	960	100.0	6.593e-213
URI120H	contig_9	11200	9976	1224	renamed_GCF_000008685.2	cp32-8	65	1289	1224	100.0	2.096e-270
URI120H	contig_9	13181	12614	567	renamed_GCF_000008685.2	cp32-1	28834	29401	567	92.5	1.485e-112
URI120H	contig_9	21144	20361	783	renamed_GCF_000008685.2	cp32-8	20739	21480	783	79.2	1.084e-134
URI120H	contig_9	21686	21119	567	renamed_GCF_000008685.2	cp32-4	20066	20633	567	100.0	2.944e-130
URI120H	contig_9	25337	24782	555	renamed_GCF_000008685.2	cp32-3	17088	17697	555	90.5	1.229e-112
URI120H	contig_9	25795	25441	354	renamed_GCF_000008685.2	cp32-3	16083	16437	354	100.0	1.459e-77
URI120H	contig_9	26123	25787	336	renamed_GCF_000008685.2	cp32-4	15710	16046	336	100.0	5.348e-69
URI120H	contig_9	26460	26112	348	renamed_GCF_000008685.2	lp56	18919	19267	348	100.0	3.962e-74
URI120H	contig_9	26667	26463	204	renamed_GCF_000008685.2	lp56	18712	18916	204	100.0	2.578e-39
URI120H	contig_9	28172	27566	606	renamed_GCF_000008685.2	cp32-7	13715	14321	606	100.0	1.216e-129
URI120H	contig_10	5147	4814	333	renamed_GCF_000008685.2	cp32-9	12592	12925	333	100.0	1.876e-71
URI120H	contig_10	6699	5748	951	renamed_GCF_000008685.2	cp32-6	10961	11912	951	99.3	2.14e-215
URI120H	contig_10	8595	7320	1275	renamed_GCF_000008685.2	cp32-9	8985	10260	1275	99.5	6.494e-275
URI120H	contig_10	8839	8602	237	renamed_GCF_000008685.2	cp32-9	8741	8978	237	100.0	1.76e-48
URI120H	contig_10	9735	9306	429	renamed_GCF_000008685.2	cp32-4	7837	8266	429	100.0	5.601e-92
URI120H	contig_10	11409	10842	567	renamed_GCF_000008685.2	cp32-9	6169	6736	567	99.4	4.74e-125
URI120H	contig_10	11795	11405	390	renamed_GCF_000008685.2	cp32-9	5783	6173	390	100.0	3.229e-83
URI120H	contig_10	12166	11782	384	renamed_GCF_000008685.2	cp32-9	5412	5796	384	100.0	2.931e-83
URI120H	contig_10	12621	12165	456	renamed_GCF_000008685.2	cp32-9	4957	5413	456	100.0	4.83e-98
URI120H	contig_10	14993	14225	768	renamed_GCF_000008685.2	cp32-9	2582	3350	768	99.6	3.291e-171
URI120H	contig_10	15563	14996	567	renamed_GCF_000008685.2	cp32-9	2012	2579	567	100.0	4.74e-125
URI120H	contig_10	16267	15574	693	renamed_GCF_000008685.2	cp32-9	1308	2001	693	100.0	5.226e-145
URI120H	contig_11	15488	16034	546	renamed_GCF_000008685.2	cp32-4	21414	21960	546	100.0	3.273e-117
URI120H	contig_11	16904	18230	1326	renamed_GCF_000008685.2	cp32-4	22830	24156	1326	100.0	6.506e-301
URI120H	contig_11	18283	18709	426	renamed_GCF_000008685.2	cp32-4	24209	24635	426	100.0	8.056e-96
URI120H	contig_11	19509	18714	795	renamed_GCF_000008685.2	cp32-4	25435	24640	795	100.0	5.809e-178
URI120H	contig_11	20078	20894	816	renamed_GCF_000008685.2	cp32-4	26004	26820	816	100.0	2.075e-184
URI120H	contig_11	20926	21601	675	renamed_GCF_000008685.2	cp32-4	26852	27527	675	100.0	3.937e-145
URI120H	contig_11	21749	22277	528	renamed_GCF_000008685.2	cp32-4	27675	28203	528	100.0	1.105e-117
URI120H	contig_11	22457	23024	567	renamed_GCF_000008685.2	cp32-4	28383	28950	567	100.0	1.275e-122
URI120H	contig_12	770	452	318	renamed_GCF_000008685.2	cp32-3	16585	16903	318	100.0	2.414e-66
URI120H	contig_12	1600	1264	336	renamed_GCF_000008685.2	cp32-3	15755	16091	336	100.0	5.348e-69
URI120H	contig_12	1937	1589	348	renamed_GCF_000008685.2	cp32-3	15418	15766	348	100.0	3.962e-74
URI120H	contig_12	2144	1940	204	renamed_GCF_000008685.2	cp32-3	15211	15415	204	100.0	2.578e-39
URI120H	contig_12	3647	3041	606	renamed_GCF_000008685.2	cp32-4	13661	14267	606	100.0	5.47e-130
URI120H	contig_12	4532	3656	876	renamed_GCF_000008685.2	cp32-3	12823	13699	876	100.0	5.609e-192
URI120H	contig_12	4861	4528	333	renamed_GCF_000008685.2	cp32-3	12494	12827	333	100.0	8.424e-72
URI120H	contig_12	5436	4890	546	renamed_GCF_000008685.2	cp32-8	11919	12465	546	100.0	7.28e-117
URI120H	contig_13	4680	4347	333	renamed_GCF_000008685.2	cp32-4	12447	12780	333	100.0	8.424e-72
URI120H	contig_13	5255	4709	546	renamed_GCF_000008685.2	cp32-7	11927	12473	546	100.0	8.009e-116
URI120H	contig_13	6221	5279	942	renamed_GCF_000008685.2	cp32-7	10961	11903	942	99.0	2.957e-210
URI120H	contig_13	9353	8924	429	renamed_GCF_000008685.2	cp32-8	7827	8256	429	100.0	5.601e-92
URI120H	contig_13	27955	26854	1101	renamed_GCF_000008685.2	cp32-6	19068	20169	1101	98.9	5.702e-247
URI120H	contig_14	60	825	765	renamed_GCF_000008685.2	lp28-2	29618	28853	765	100.0	1.703e-169
URI120H	contig_14	1648	847	801	renamed_GCF_000008685.2	lp28-2	28030	28831	801	100.0	3.29e-168
URI120H	contig_14	2566	1738	828	renamed_GCF_000008685.2	lp28-2	27112	27940	828	100.0	3.316e-181
URI120H	contig_14	3022	2593	429	renamed_GCF_000008685.2	lp28-2	26569	27085	429	100.0	3.799e-96
URI120H	contig_14	3699	3288	411	renamed_GCF_000008685.2	lp28-2	25979	26390	411	100.0	2.076e-91
URI120H	contig_14	5190	3723	1467	renamed_GCF_000008685.2	lp28-2	24488	25955	1467	100.0	0.0
URI120H	contig_15	20864	24701	3837	renamed_GCF_000008685.2	lp28-3	7728	3891	3837	100.0	0.0
URI120H	contig_15	25621	26332	711	renamed_GCF_000008685.2	lp28-3	2970	2259	711	100.0	1.615e-152
URI120H	contig_16	117	1473	1356	renamed_GCF_000008685.2	cp26	20786	19430	1356	100.0	1.798e-294
URI120H	contig_16	1582	2938	1356	renamed_GCF_000008685.2	cp26	19321	17965	1356	100.0	1.971e-293
URI120H	contig_16	4001	3368	633	renamed_GCF_000008685.2	cp26	16902	17535	633	100.0	1.275e-133
URI120H	contig_16	4236	5772	1536	renamed_GCF_000008685.2	cp26	16667	15131	1536	100.0	0.0
URI120H	contig_16	5796	7011	1215	renamed_GCF_000008685.2	cp26	15107	13892	1215	100.0	5.333e-267
URI120H	contig_16	8890	7297	1593	renamed_GCF_000008685.2	cp26	12013	13606	1593	100.0	0.0
URI120H	contig_16	9486	9984	498	renamed_GCF_000008685.2	cp26	11417	10919	498	100.0	3.608e-108
URI120H	contig_17	11243	10802	441	renamed_GCF_000008685.2	cp9	1281	1839	441	98.6	4.183e-97
URI120H	contig_17	12486	11370	1116	renamed_GCF_000008685.2	cp9	162	1272	1116	88.3	1.916e-218
URI120H	contig_17	12854	13766	912	renamed_GCF_000008685.2	cp9	2803	3712	912	99.3	1.323e-205
URI120H	contig_17	14438	13907	531	renamed_GCF_000008685.2	cp9	4377	3852	531	66.4	4.169e-70
URI120H	contig_17	14845	14560	285	renamed_GCF_000008685.2	cp9	4788	4503	285	96.8	3.136e-58
URI120H	contig_17	24518	23729	789	renamed_GCF_000008685.2	lp21	2867	3656	789	99.6	6.373e-176
URI120H	contig_17	25867	24757	1110	renamed_GCF_000008685.2	lp21	1485	2628	1110	98.9	8.376e-253
URI120H	contig_19	14537	13772	765	renamed_GCF_000008685.2	lp28-1	13793	13028	765	100.0	1.871e-168
URI120H	contig_19	15073	14512	561	renamed_GCF_000008685.2	lp28-1	14329	13768	561	100.0	4.308e-125
URI120H	contig_19	16195	15094	1101	renamed_GCF_000008685.2	lp28-1	15451	14350	1101	100.0	2.133e-249
URI120H	contig_19	18550	18295	255	renamed_GCF_000008685.2	lp28-1	17805	17550	255	100.0	1.423e-53
URI120H	contig_21	15461	14777	684	renamed_GCF_000008685.2	lp17	5055	5739	684	100.0	2.578e-151
URI120H	contig_21	16919	16697	222	renamed_GCF_000008685.2	lp17	3651	3819	222	100.0	6.565e-33
URI120H	contig_21	19107	18750	357	renamed_GCF_000008685.2	lp17	1409	1766	357	100.0	1.532e-77
URI120H	contig_21	20187	19713	474	renamed_GCF_000008685.2	lp17	329	803	474	100.0	1.788e-103
URI120H	contig_22	5551	4600	951	renamed_GCF_000008685.2	lp28-1	26996	28073	951	81.29	3.234e-86
URI120H	contig_23	1064	491	573	renamed_GCF_000008685.2	cp32-7	22087	22660	573	100.0	7.629e-121
URI120H	contig_23	1597	1075	522	renamed_GCF_000008685.2	cp32-7	21521	22076	522	100.0	1.473e-113
URI120H	contig_23	2386	1636	750	renamed_GCF_000008685.2	cp32-7	20765	21515	750	100.0	2.593e-162
URI120H	contig_1	102780	103827	1047	renamed_GCF_000008685.2	chromosome	807966	806919	1047	100.0	5.315e-230
URI120H	contig_1	103823	104972	1149	renamed_GCF_000008685.2	chromosome	806923	805774	1149	100.0	1.098e-247
URI120H	contig_1	107579	107909	330	renamed_GCF_000008685.2	chromosome	803167	802837	330	100.0	2.178e-69
URI120H	contig_1	107948	108806	858	renamed_GCF_000008685.2	chromosome	802798	801940	858	100.0	3.462e-177
URI120H	contig_1	109737	108969	768	renamed_GCF_000008685.2	chromosome	801118	801778	768	99.5	4.938e-141
URI120H	contig_1	110272	109675	597	renamed_GCF_000008685.2	chromosome	800475	801072	597	100.0	2.836e-127
URI120H	contig_1	159557	158588	969	renamed_GCF_000008685.2	chromosome	751190	752159	969	100.0	4.772e-218
URI120H	contig_1	160717	159958	759	renamed_GCF_000008685.2	chromosome	750030	750789	759	100.0	2.255e-165
URI120H	contig_1	179649	180117	468	renamed_GCF_000008685.2	chromosome	731099	730631	468	100.0	1.969e-101
URI120H	contig_1	181136	180242	894	renamed_GCF_000008685.2	chromosome	729612	730506	894	100.0	2.531e-195
URI120H	contig_1	182083	181129	954	renamed_GCF_000008685.2	chromosome	728665	729619	954	100.0	1.334e-212
URI120H	contig_1	183012	182073	939	renamed_GCF_000008685.2	chromosome	727736	728675	939	100.0	1.678e-207
URI120H	contig_1	184291	182995	1296	renamed_GCF_000008685.2	chromosome	726457	727753	1296	100.0	7.283e-286
URI120H	contig_1	185318	184253	1065	renamed_GCF_000008685.2	chromosome	725430	726495	1065	100.0	4.042e-236
URI120H	contig_1	186525	185301	1224	renamed_GCF_000008685.2	chromosome	724223	725447	1224	100.0	3.222e-274
URI120H	contig_1	186618	187686	1068	renamed_GCF_000008685.2	chromosome	724130	723062	1068	100.0	3.402e-247
URI120H	contig_1	220246	219949	297	renamed_GCF_000008685.2	chromosome	690481	690799	297	98.9	6.955e-60
URI120H	contig_1	220556	220259	297	renamed_GCF_000008685.2	chromosome	690192	690489	297	100.0	1.037e-63
URI120H	contig_1	249232	251104	1872	renamed_GCF_000008685.2	chromosome	661515	659643	1872	100.0	0.0
URI120H	contig_1	251850	251124	726	renamed_GCF_000008685.2	chromosome	658897	659623	726	100.0	3.429e-155
URI120H	contig_1	255939	253845	2094	renamed_GCF_000008685.2	chromosome	654862	656902	2094	99.8	0.0
URI120H	contig_1	256861	255898	963	renamed_GCF_000008685.2	chromosome	653886	654849	963	100.0	5.23e-216
URI120H	contig_1	256957	260335	3378	renamed_GCF_000008685.2	chromosome	653790	650412	3378	100.0	0.0
URI120H	contig_1	260360	261578	1218	renamed_GCF_000008685.2	chromosome	650387	649169	1218	100.0	2.758e-266
URI120H	contig_1	262195	261640	555	renamed_GCF_000008685.2	chromosome	648552	649107	555	100.0	3.12e-119
URI120H	contig_1	303609	302811	798	renamed_GCF_000008685.2	chromosome	607137	607935	798	100.0	9.72e-173
URI120H	contig_1	332470	330325	2145	renamed_GCF_000008685.2	chromosome	578276	580421	2145	100.0	0.0
URI120H	contig_1	332797	332485	312	renamed_GCF_000008685.2	chromosome	577949	578261	312	100.0	5.387e-65
URI120H	contig_1	333352	332809	543	renamed_GCF_000008685.2	chromosome	577394	577937	543	100.0	3.121e-117
URI120H	contig_1	333559	334165	606	renamed_GCF_000008685.2	chromosome	577187	576581	606	100.0	4.975e-131
URI120H	contig_1	334220	334766	546	renamed_GCF_000008685.2	chromosome	576499	575980	546	100.0	1.781e-115
URI120H	contig_1	334930	335473	543	renamed_GCF_000008685.2	chromosome	575816	575273	543	100.0	3.121e-117
URI120H	contig_1	336894	335499	1395	renamed_GCF_000008685.2	chromosome	573852	575247	1395	100.0	2.85e-313
URI120H	contig_1	337006	338857	1851	renamed_GCF_000008685.2	chromosome	573740	571889	1851	100.0	0.0
URI120H	contig_1	371470	372418	948	renamed_GCF_000008685.2	chromosome	539275	538327	948	100.0	1.008e-214
URI120H	contig_1	373226	372437	789	renamed_GCF_000008685.2	chromosome	537543	538308	789	99.6	2.994e-167
URI120H	contig_1	394253	387752	6501	renamed_GCF_000008685.2	chromosome	516492	522993	6501	100.0	0.0
URI120H	contig_1	396218	394958	1260	renamed_GCF_000008685.2	chromosome	514523	515783	1260	100.0	5.48e-283
URI120H	contig_1	397516	396214	1302	renamed_GCF_000008685.2	chromosome	513225	514527	1302	100.0	1.62e-286
URI120H	contig_1	397602	398349	747	renamed_GCF_000008685.2	chromosome	513139	512392	747	100.0	7.284e-159
URI120H	contig_1	399906	399117	789	renamed_GCF_000008685.2	chromosome	510835	511624	789	100.0	3.149e-175
URI120H	contig_1	401428	399895	1533	renamed_GCF_000008685.2	chromosome	509313	510846	1533	100.0	0.0
URI120H	contig_1	401872	401500	372	renamed_GCF_000008685.2	chromosome	508869	509241	372	100.0	8.775e-78
URI120H	contig_1	407791	407392	399	renamed_GCF_000008685.2	chromosome	502950	503349	399	100.0	3.071e-85
URI120H	contig_1	407986	407800	186	renamed_GCF_000008685.2	chromosome	502755	502941	186	100.0	7.664e-41
URI120H	contig_1	408551	408002	549	renamed_GCF_000008685.2	chromosome	502190	502739	549	100.0	1.698e-116
URI120H	contig_1	408862	408556	306	renamed_GCF_000008685.2	chromosome	501879	502185	306	100.0	2.959e-62
URI120H	contig_1	409527	409272	255	renamed_GCF_000008685.2	chromosome	501214	501469	255	100.0	1.745e-51
URI120H	contig_1	409730	409529	201	renamed_GCF_000008685.2	chromosome	501014	501212	201	98.4	1.098e-39
URI120H	contig_1	410149	409732	417	renamed_GCF_000008685.2	chromosome	500592	501009	417	100.0	2.778e-89
URI120H	contig_1	411035	410153	882	renamed_GCF_000008685.2	chromosome	499706	500588	882	100.0	1.248e-192
URI120H	contig_1	540718	539731	987	renamed_GCF_000008685.2	chromosome	370026	371013	987	100.0	7.343e-225
URI120H	contig_1	541860	540717	1143	renamed_GCF_000008685.2	chromosome	368884	370027	1143	100.0	3.212e-243
URI120H	contig_1	543784	544516	732	renamed_GCF_000008685.2	chromosome	366960	366228	732	100.0	5.239e-160
URI120H	contig_1	557304	559404	2100	renamed_GCF_000008685.2	chromosome	353437	351340	2100	100.0	0.0
URI120H	contig_1	559413	559689	276	renamed_GCF_000008685.2	chromosome	351331	351055	276	100.0	8.162e-55
URI120H	contig_1	561134	562592	1458	renamed_GCF_000008685.2	chromosome	349610	348152	1458	100.0	0.0
URI120H	contig_1	562584	563394	810	renamed_GCF_000008685.2	chromosome	348160	347350	810	100.0	1.888e-184
URI120H	contig_1	563903	564314	411	renamed_GCF_000008685.2	chromosome	346841	346430	411	100.0	6.821e-87
URI120H	contig_1	582713	581579	1134	renamed_GCF_000008685.2	chromosome	328031	329165	1134	100.0	5.485e-253
URI120H	contig_1	584456	585509	1053	renamed_GCF_000008685.2	chromosome	326288	325235	1053	100.0	4.032e-234
URI120H	contig_1	585508	586969	1461	renamed_GCF_000008685.2	chromosome	325236	323775	1461	100.0	0.0
URI120H	contig_1	587898	588705	807	renamed_GCF_000008685.2	chromosome	322846	322039	807	99.6	2.064e-174
URI120H	contig_1	589393	588706	687	renamed_GCF_000008685.2	chromosome	321351	322038	687	100.0	1.336e-150
URI120H	contig_1	590486	591065	579	renamed_GCF_000008685.2	chromosome	320249	319679	579	99.4	6.936e-123
URI120H	contig_1	591108	591639	531	renamed_GCF_000008685.2	chromosome	319636	319105	531	100.0	1.699e-113
URI120H	contig_1	592739	593498	759	renamed_GCF_000008685.2	chromosome	318005	317246	759	100.0	1.223e-163
URI120H	contig_1	593528	594605	1077	renamed_GCF_000008685.2	chromosome	317216	316139	1077	100.0	1.824e-238
URI120H	contig_1	595430	596321	891	renamed_GCF_000008685.2	chromosome	315314	314423	891	100.0	4.455e-197
URI120H	contig_1	611030	611951	921	renamed_GCF_000008685.2	chromosome	299715	298794	921	100.0	4.644e-193
URI120H	contig_1	613276	613708	432	renamed_GCF_000008685.2	chromosome	297469	297037	432	100.0	1.974e-95
URI120H	contig_1	613700	614318	618	renamed_GCF_000008685.2	chromosome	297045	296427	618	100.0	5.47e-132
URI120H	contig_1	614325	615504	1179	renamed_GCF_000008685.2	chromosome	296420	295241	1179	100.0	1.072e-261
URI120H	contig_1	615965	617294	1329	renamed_GCF_000008685.2	chromosome	294780	293451	1329	100.0	2.397e-295
URI120H	contig_1	617316	617541	225	renamed_GCF_000008685.2	chromosome	293429	293204	225	100.0	8.8e-46
URI120H	contig_1	739648	740026	378	renamed_GCF_000008685.2	chromosome	171097	170719	378	100.0	1.603e-80
URI120H	contig_1	741207	740037	1170	renamed_GCF_000008685.2	chromosome	169562	170708	1170	99.7	6.062e-258
URI120H	contig_1	741346	742867	1521	renamed_GCF_000008685.2	chromosome	169399	167878	1521	100.0	0.0
URI120H	contig_1	742986	744831	1845	renamed_GCF_000008685.2	chromosome	167759	165914	1845	100.0	0.0
URI120H	contig_1	805316	806984	1668	renamed_GCF_000008685.2	chromosome	105299	103763	1668	100.0	0.0
URI120H	contig_1	807798	809223	1425	renamed_GCF_000008685.2	chromosome	102949	101524	1425	100.0	1.009e-312
URI120H	contig_1	809408	810002	594	renamed_GCF_000008685.2	chromosome	101339	100745	594	100.0	6.255e-135
URI120H	contig_1	811931	810542	1389	renamed_GCF_000008685.2	chromosome	98816	100205	1389	100.0	9.726e-316
URI120H	contig_1	812099	812885	786	renamed_GCF_000008685.2	chromosome	98648	97862	786	100.0	2.735e-176
URI120H	contig_1	813794	816137	2343	renamed_GCF_000008685.2	chromosome	96953	94610	2343	100.0	0.0
URI120H	contig_1	839546	838136	1410	renamed_GCF_000008685.2	chromosome	71200	72610	1410	100.0	2.56e-308
URI120H	contig_1	840574	839527	1047	renamed_GCF_000008685.2	chromosome	70141	71219	1047	100.0	1.295e-228
URI120H	contig_1	843499	841177	2322	renamed_GCF_000008685.2	chromosome	67247	69569	2322	100.0	0.0
URI120H	contig_2	18673	17827	846	renamed_GCF_000008685.2	lp54	34987	35833	846	100.0	5.585e-187
URI120H	contig_2	19276	18712	564	renamed_GCF_000008685.2	lp54	34384	34948	564	100.0	7.276e-120
URI120H	contig_2	20919	20700	219	renamed_GCF_000008685.2	lp54	32741	32960	219	100.0	7.958e-46
URI120H	contig_2	21881	21458	423	renamed_GCF_000008685.2	lp54	31779	32202	423	100.0	5.086e-92
URI120H	contig_2	22951	21880	1071	renamed_GCF_000008685.2	lp54	30709	31780	1071	100.0	2.191e-235
URI120H	contig_2	32943	32748	195	renamed_GCF_000008685.2	lp54	20717	20912	195	100.0	2.214e-39
URI120H	contig_2	35533	34939	594	renamed_GCF_000008685.2	lp54	18127	18721	594	100.0	1.47e-125
URI120H	contig_2	36401	36965	564	renamed_GCF_000008685.2	lp54	17259	16695	564	100.0	1.065e-115
URI120H	contig_2	37084	37660	576	renamed_GCF_000008685.2	lp54	16576	16000	576	100.0	1.337e-123
URI120H	contig_3	37532	36848	684	renamed_GCF_000008685.2	cp32-3	10264	10948	684	100.0	6.297e-150
URI120H	contig_3	39094	38857	237	renamed_GCF_000008685.2	cp32-4	8733	8970	237	100.0	1.76e-48
URI120H	contig_3	42420	42036	384	renamed_GCF_000008685.2	cp32-4	5406	5790	384	100.0	2.931e-83
URI120H	contig_5	423	1422	999	renamed_GCF_000008685.2	lp36	34079	33080	999	100.0	2.04e-215
URI120H	contig_5	1680	2676	996	renamed_GCF_000008685.2	lp36	32822	31826	996	100.0	2.481e-221
URI120H	contig_5	2917	3784	867	renamed_GCF_000008685.2	lp36	31585	30718	867	100.0	3.181e-188
URI120H	contig_5	7699	7918	219	renamed_GCF_000008685.2	lp36	26803	26584	219	100.0	9.792e-44
URI120H	contig_5	8144	8690	546	renamed_GCF_000008685.2	lp36	26358	25812	546	100.0	8.009e-116
URI120H	contig_7	28170	27354	816	renamed_GCF_000008685.2	cp32-8	14323	15139	816	100.0	1.636e-178
URI120H	contig_10	27407	26651	756	renamed_GCF_000008685.2	cp32-9	20816	21572	756	100.0	2.151e-165
URI120H	contig_10	29057	27959	1098	renamed_GCF_000008685.2	cp32-9	19163	20264	1098	99.4	1.005e-248
URI120H	contig_11	237	804	567	renamed_GCF_000008685.2	cp32-4	6163	6730	567	100.0	1.054e-124
URI120H	contig_11	9240	9444	204	renamed_GCF_000008685.2	cp32-8	15214	15418	204	100.0	2.578e-39
URI120H	contig_11	9784	10120	336	renamed_GCF_000008685.2	cp32-6	15774	16110	336	100.0	5.348e-69
URI120H	contig_11	10570	11071	501	renamed_GCF_000008685.2	cp32-4	16496	16997	501	100.0	5.048e-105
URI120H	contig_11	12657	11646	1011	renamed_GCF_000008685.2	cp32-4	18583	17572	1011	100.0	1.362e-230
URI120H	contig_12	6404	5453	951	renamed_GCF_000008685.2	cp32-3	10951	11902	951	100.0	4.333e-216
URI120H	contig_12	8388	7113	1275	renamed_GCF_000008685.2	cp32-3	8967	10242	1275	100.0	2.667e-276
URI120H	contig_12	9084	8628	456	renamed_GCF_000008685.2	cp32-6	8281	8737	456	100.0	1.971e-99
URI120H	contig_12	9528	9099	429	renamed_GCF_000008685.2	cp32-3	7827	8256	429	100.0	5.601e-92
URI120H	contig_12	10655	9542	1113	renamed_GCF_000008685.2	cp32-1	6700	7813	1113	100.0	6.876e-247
URI120H	contig_12	11588	11198	390	renamed_GCF_000008685.2	cp32-4	5777	6167	390	100.0	3.229e-83
URI120H	contig_12	27975	26874	1101	renamed_GCF_000008685.2	cp32-3	19604	20705	1101	99.7	8.753e-251
URI120H	contig_13	1091	737	354	renamed_GCF_000008685.2	cp32-7	16093	16447	354	100.0	1.459e-77
URI120H	contig_14	22942	22390	552	renamed_GCF_000008685.2	lp28-2	6736	7288	552	100.0	2.704e-120
URI120H	contig_15	7123	6373	750	renamed_GCF_000008685.2	lp28-3	21469	22219	750	100.0	6.33e-161
URI120H	contig_15	9795	9165	630	renamed_GCF_000008685.2	lp28-3	18797	19427	630	100.0	1.007e-135
URI120H	contig_15	11185	10618	567	renamed_GCF_000008685.2	lp28-3	17407	17974	567	100.0	1.938e-126
URI120H	contig_15	12074	11177	897	renamed_GCF_000008685.2	lp28-3	16518	17415	897	100.0	1.518e-201
URI120H	contig_16	10800	10251	549	renamed_GCF_000008685.2	cp26	10103	10652	549	100.0	6.94e-118
URI120H	contig_16	11629	10867	762	renamed_GCF_000008685.2	cp26	9274	10036	762	100.0	1.063e-165
URI120H	contig_17	10750	10189	561	renamed_GCF_000008685.2	cp9	1891	2452	561	96.2	1.697e-118
URI120H	contig_18	24215	23873	342	renamed_GCF_000008685.2	lp5	263	638	342	74.1	1.177e-53
URI120H	contig_19	1212	2211	999	renamed_GCF_000008685.2	lp28-1	466	1465	999	100.0	6.954e-219
URI120H	contig_19	3522	3822	300	renamed_GCF_000008685.2	lp28-3	1044	1368	300	89.8	8.93e-58
URI120H	contig_20	22523	21707	816	renamed_GCF_000008685.2	lp28-4	2535	3351	816	100.0	8.08e-178
URI120H	contig_21	52	793	741	renamed_GCF_000008685.2	lp17	13338	14079	741	100.0	7.64e-166
URI120H	contig_21	6447	6177	270	renamed_GCF_000008685.2	lp17	14069	14339	270	100.0	1.489e-55
URI120H	contig_21	10629	10926	297	renamed_GCF_000008685.2	lp17	9980	9590	297	100.0	9.385e-65
URI120H	contig_21	12732	12405	327	renamed_GCF_000008685.2	lp17	7784	8111	327	100.0	1.029e-68
URI120H	contig_21	14064	14643	579	renamed_GCF_000008685.2	lp17	6452	5873	579	100.0	2.345e-126
URI120H	contig_24	1240	661	579	renamed_GCF_000008685.2	cp32-8	22112	22691	579	100.0	3.43e-122
URI120H	contig_1	86356	85033	1323	renamed_GCF_000008685.2	chromosome	824381	825704	1323	100.0	8.966e-297
URI120H	contig_1	88394	88043	351	renamed_GCF_000008685.2	chromosome	822343	822694	351	100.0	6.889e-77
URI120H	contig_1	91196	90209	987	renamed_GCF_000008685.2	chromosome	819541	820528	987	100.0	5.255e-220
URI120H	contig_1	92133	91821	312	renamed_GCF_000008685.2	chromosome	818604	818916	312	100.0	1.086e-65
URI120H	contig_1	93535	94426	891	renamed_GCF_000008685.2	chromosome	817160	816311	891	99.6	1.029e-187
URI120H	contig_1	96040	97048	1008	renamed_GCF_000008685.2	chromosome	814697	813689	1008	100.0	5.214e-215
URI120H	contig_1	98358	99240	882	renamed_GCF_000008685.2	chromosome	812388	811506	882	100.0	2.526e-193
URI120H	contig_1	101194	102286	1092	renamed_GCF_000008685.2	chromosome	809552	808460	1092	100.0	7.863e-242
URI120H	contig_1	115892	116906	1014	renamed_GCF_000008685.2	chromosome	794855	793841	1014	100.0	1.719e-228
URI120H	contig_1	173040	172320	720	renamed_GCF_000008685.2	chromosome	737708	738428	720	100.0	9.639e-160
URI120H	contig_1	176668	175459	1209	renamed_GCF_000008685.2	chromosome	734080	735289	1209	100.0	8.188e-270
URI120H	contig_1	178955	176945	2010	renamed_GCF_000008685.2	chromosome	731793	733803	2010	100.0	0.0
URI120H	contig_1	179565	179028	537	renamed_GCF_000008685.2	chromosome	731183	731720	537	100.0	1.936e-121
URI120H	contig_1	193006	192079	927	renamed_GCF_000008685.2	chromosome	717742	718669	927	100.0	3.519e-197
URI120H	contig_1	194129	192977	1152	renamed_GCF_000008685.2	chromosome	716619	717771	1152	100.0	1.261e-246
URI120H	contig_1	195740	194129	1611	renamed_GCF_000008685.2	chromosome	715008	716619	1611	100.0	0.0
URI120H	contig_1	195982	196645	663	renamed_GCF_000008685.2	chromosome	714766	714103	663	100.0	1.333e-146
URI120H	contig_1	196641	197505	864	renamed_GCF_000008685.2	chromosome	714107	713243	864	100.0	1.134e-190
URI120H	contig_1	197498	198545	1047	renamed_GCF_000008685.2	chromosome	713250	712203	1047	100.0	1.709e-225
URI120H	contig_1	245736	247569	1833	renamed_GCF_000008685.2	chromosome	665011	663178	1833	100.0	0.0
URI120H	contig_1	265146	265611	465	renamed_GCF_000008685.2	chromosome	645601	645136	465	100.0	4.176e-101
URI120H	contig_1	266097	267453	1356	renamed_GCF_000008685.2	chromosome	644650	643294	1356	100.0	1.597e-304
URI120H	contig_1	270907	268498	2409	renamed_GCF_000008685.2	chromosome	639858	642249	2409	100.0	0.0
URI120H	contig_1	274155	272790	1365	renamed_GCF_000008685.2	chromosome	636592	637957	1365	100.0	3.184e-298
URI120H	contig_1	278756	278264	492	renamed_GCF_000008685.2	chromosome	631990	632482	492	100.0	1.786e-106
URI120H	contig_1	280048	281551	1503	renamed_GCF_000008685.2	chromosome	630698	629195	1503	100.0	0.0
URI120H	contig_1	285740	284486	1254	renamed_GCF_000008685.2	chromosome	625006	626260	1254	100.0	1.925e-276
URI120H	contig_1	288742	287299	1443	renamed_GCF_000008685.2	chromosome	622004	623447	1443	100.0	0.0
URI120H	contig_1	305977	307021	1044	renamed_GCF_000008685.2	chromosome	604769	603725	1044	100.0	3.194e-235
URI120H	contig_1	361127	361826	699	renamed_GCF_000008685.2	chromosome	549618	548919	699	100.0	1.058e-146
URI120H	contig_1	375042	373218	1824	renamed_GCF_000008685.2	chromosome	535703	537527	1824	100.0	0.0
URI120H	contig_1	379641	381549	1908	renamed_GCF_000008685.2	chromosome	531105	529197	1908	100.0	0.0
URI120H	contig_1	402928	401893	1035	renamed_GCF_000008685.2	chromosome	507813	508848	1035	100.0	4.156e-222
URI120H	contig_1	403871	403757	114	renamed_GCF_000008685.2	chromosome	506864	506984	114	100.0	7.638e-22
URI120H	contig_1	405943	405637	306	renamed_GCF_000008685.2	chromosome	504798	505104	306	100.0	1.468e-61
URI120H	contig_1	407376	406833	543	renamed_GCF_000008685.2	chromosome	503365	503908	543	100.0	7.636e-116
URI120H	contig_1	412847	412550	297	renamed_GCF_000008685.2	chromosome	497894	498191	297	100.0	5.69e-62
URI120H	contig_1	414474	414162	312	renamed_GCF_000008685.2	chromosome	496267	496579	312	100.0	2.953e-63
URI120H	contig_1	418154	416789	1365	renamed_GCF_000008685.2	chromosome	492587	493952	1365	100.0	1.721e-296
URI120H	contig_1	421009	420187	822	renamed_GCF_000008685.2	chromosome	489732	490554	822	100.0	2.749e-182
URI120H	contig_1	425192	424664	528	renamed_GCF_000008685.2	chromosome	485549	486077	528	100.0	1.004e-118
URI120H	contig_1	438985	439519	534	renamed_GCF_000008685.2	chromosome	471756	471222	534	100.0	8.816e-113
URI120H	contig_1	440770	441064	294	renamed_GCF_000008685.2	chromosome	469971	469677	294	100.0	2.2e-63
URI120H	contig_1	443463	445224	1761	renamed_GCF_000008685.2	chromosome	467278	465517	1761	100.0	0.0
URI120H	contig_1	450826	450670	156	renamed_GCF_000008685.2	chromosome	459915	460071	156	100.0	2.965e-30
URI120H	contig_1	494056	493639	417	renamed_GCF_000008685.2	chromosome	416688	417105	417	100.0	1.248e-89
URI120H	contig_1	499958	499298	660	renamed_GCF_000008685.2	chromosome	410786	411446	660	100.0	1.008e-140
URI120H	contig_1	409245	408876	369	renamed_GCF_000008685.2	chromosome	501496	501865	369	100.0	9.223e-77
URI120H	contig_1	411401	411038	363	renamed_GCF_000008685.2	chromosome	499340	499703	363	100.0	3.407e-78
URI120H	contig_1	432667	434479	1812	renamed_GCF_000008685.2	chromosome	478005	476262	1812	100.0	0.0
URI120H	contig_1	438176	437333	843	renamed_GCF_000008685.2	chromosome	472565	473408	843	100.0	5.328e-187
URI120H	contig_1	485159	484031	1128	renamed_GCF_000008685.2	chromosome	425583	426711	1128	100.0	1.044e-244
URI120H	contig_1	487687	486907	780	renamed_GCF_000008685.2	chromosome	423054	423834	780	100.0	3.296e-173
URI120H	contig_1	489364	491242	1878	renamed_GCF_000008685.2	chromosome	421380	419502	1878	100.0	0.0
URI120H	contig_1	502846	503401	555	renamed_GCF_000008685.2	chromosome	407898	407343	555	100.0	5.734e-121
URI120H	contig_1	559696	561145	1449	renamed_GCF_000008685.2	chromosome	351045	349599	1449	99.7	6.4e-322
URI120H	contig_1	563443	563884	441	renamed_GCF_000008685.2	chromosome	347301	346860	441	100.0	1.706e-98
URI120H	contig_1	568410	567537	873	renamed_GCF_000008685.2	chromosome	342334	343207	873	100.0	1.573e-188
URI120H	contig_1	575808	574236	1572	renamed_GCF_000008685.2	chromosome	334936	336508	1572	100.0	0.0
URI120H	contig_1	579992	581102	1110	renamed_GCF_000008685.2	chromosome	330752	329642	1110	100.0	1.105e-249
URI120H	contig_1	583017	584046	1029	renamed_GCF_000008685.2	chromosome	327757	326698	1029	99.7	7.409e-232
URI120H	contig_1	586965	587898	933	renamed_GCF_000008685.2	chromosome	323779	322846	933	100.0	1.839e-205
URI120H	contig_1	590436	589392	1044	renamed_GCF_000008685.2	chromosome	320308	321352	1044	100.0	3.013e-227
URI120H	contig_1	591628	592468	840	renamed_GCF_000008685.2	chromosome	319116	318276	840	99.6	1.977e-180
URI120H	contig_1	594601	595438	837	renamed_GCF_000008685.2	chromosome	316143	315306	837	100.0	2.887e-184
URI120H	contig_1	750656	749537	1119	renamed_GCF_000008685.2	chromosome	160089	161208	1119	100.0	2.349e-251
URI120H	contig_1	776905	778276	1371	renamed_GCF_000008685.2	chromosome	133842	132471	1371	100.0	2.422e-302
URI120H	contig_1	780615	783321	2706	renamed_GCF_000008685.2	chromosome	130132	127426	2706	100.0	0.0
URI120H	contig_1	785200	785950	750	renamed_GCF_000008685.2	chromosome	125547	124797	750	100.0	1.281e-161
URI120H	contig_1	806976	807732	756	renamed_GCF_000008685.2	chromosome	103771	103015	756	100.0	4.353e-166
URI120H	contig_1	810520	809998	522	renamed_GCF_000008685.2	chromosome	100227	100749	522	100.0	2.976e-114
URI120H	contig_1	812881	813805	924	renamed_GCF_000008685.2	chromosome	97866	96942	924	100.0	7.888e-205
URI120H	contig_1	816142	816529	387	renamed_GCF_000008685.2	chromosome	94605	94218	387	100.0	1.031e-86
URI120H	contig_1	841181	840620	561	renamed_GCF_000008685.2	chromosome	69565	70126	561	100.0	3.775e-118
URI120H	contig_1	845456	844994	462	renamed_GCF_000008685.2	chromosome	65290	65752	462	100.0	3.193e-95
URI120H	contig_3	42049	41659	390	renamed_GCF_000008685.2	cp32-1	5767	6157	390	100.0	3.229e-83
URI120H	contig_5	4039	5026	987	renamed_GCF_000008685.2	lp36	30463	29476	987	100.0	5.255e-220
URI120H	contig_5	6214	7120	906	renamed_GCF_000008685.2	lp36	28288	27382	906	100.0	5.634e-197
URI120H	contig_6	12062	12938	876	renamed_GCF_000008685.2	cp32-1	12823	13699	876	100.0	5.609e-192
URI120H	contig_6	14453	14657	204	renamed_GCF_000008685.2	cp32-9	15311	15515	204	100.0	2.578e-39
URI120H	contig_7	9628	9070	558	renamed_GCF_000008685.2	cp32-1	2010	2568	558	100.0	1.105e-122
URI120H	contig_11	11176	11599	423	renamed_GCF_000008685.2	cp32-4	17102	17525	423	100.0	4.616e-93
URI120H	contig_11	26952	27720	768	renamed_GCF_000008685.2	cp32-4	2579	3347	768	100.0	3.291e-171
URI120H	contig_11	29324	29780	456	renamed_GCF_000008685.2	cp32-4	4951	5407	456	100.0	1.075e-97
URI120H	contig_12	8632	8395	237	renamed_GCF_000008685.2	cp32-3	8723	8960	237	98.7	1.76e-48
URI120H	contig_12	11202	10635	567	renamed_GCF_000008685.2	cp32-3	6153	6720	567	100.0	9.584e-126
URI120H	contig_12	11959	11575	384	renamed_GCF_000008685.2	cp32-1	5396	5780	384	100.0	2.931e-83
URI120H	contig_12	29775	29328	447	renamed_GCF_000008685.2	cp32-3	17802	18249	447	100.0	7.667e-100
URI120H	contig_14	14793	15303	510	renamed_GCF_000008685.2	lp28-2	14885	14375	510	100.0	3.606e-110
URI120H	contig_14	16537	16930	393	renamed_GCF_000008685.2	lp28-2	13141	12748	393	100.0	6.841e-84
URI120H	contig_14	18187	18616	429	renamed_GCF_000008685.2	lp28-2	11491	11062	429	100.0	3.057e-90
URI120H	contig_15	5915	5639	276	renamed_GCF_000008685.2	lp28-3	22677	22953	276	100.0	6.026e-58
URI120H	contig_15	10646	9890	756	renamed_GCF_000008685.2	lp28-3	17946	18702	756	100.0	8.81e-167
URI120H	contig_15	18076	18745	669	renamed_GCF_000008685.2	lp28-3	10516	9847	669	100.0	5.739e-140
URI120H	contig_16	17105	18428	1323	renamed_GCF_000008685.2	cp26	3798	2475	1323	100.0	1.419e-291
URI120H	contig_17	2953	2659	294	renamed_GCF_000008685.2	lp21	15790	16084	294	100.0	2.432e-62
URI120H	contig_19	8655	8097	558	renamed_GCF_000008685.2	lp28-1	7869	7353	558	100.0	3.959e-117
URI120H	contig_19	9515	9773	258	renamed_GCF_000008685.2	lp28-1	8771	9029	258	100.0	1.351e-54
URI120H	contig_19	11735	11441	294	renamed_GCF_000008685.2	lp28-1	10895	10697	294	100.0	9.155e-41
URI120H	contig_19	13736	13184	552	renamed_GCF_000008685.2	lp28-1	12992	12440	552	100.0	6.015e-120
URI120H	contig_20	12538	11785	753	renamed_GCF_000008685.2	lp28-4	12453	13206	753	100.0	4.561e-165
URI120H	contig_20	13068	12513	555	renamed_GCF_000008685.2	lp28-4	11923	12478	555	100.0	3.559e-126
URI120H	contig_20	14174	13064	1110	renamed_GCF_000008685.2	lp28-4	10814	11927	1110	99.7	1.008e-250
URI120H	contig_20	16972	16450	522	renamed_GCF_000008685.2	lp28-4	7182	8538	522	100.0	3.275e-113
URI120H	contig_1	50298	48963	1335	renamed_GCF_000008685.2	chromosome	860439	861774	1335	100.0	8.434e-291
URI120H	contig_1	53232	51822	1410	renamed_GCF_000008685.2	chromosome	857505	858915	1410	100.0	1.384e-306
URI120H	contig_1	54749	53228	1521	renamed_GCF_000008685.2	chromosome	855988	857509	1521	100.0	0.0
URI120H	contig_1	55869	54741	1128	renamed_GCF_000008685.2	chromosome	854868	855996	1128	100.0	2.385e-261
URI120H	contig_1	58249	56959	1290	renamed_GCF_000008685.2	chromosome	852488	853778	1290	100.0	6.634e-286
URI120H	contig_1	59744	58223	1521	renamed_GCF_000008685.2	chromosome	850993	852514	1521	100.0	0.0
URI120H	contig_1	61919	59750	2169	renamed_GCF_000008685.2	chromosome	848836	850987	2169	99.8	0.0
URI120H	contig_1	63247	62398	849	renamed_GCF_000008685.2	chromosome	847490	848339	849	100.0	6.426e-186
URI120H	contig_1	63612	63249	363	renamed_GCF_000008685.2	chromosome	847125	847488	363	100.0	2.269e-74
URI120H	contig_1	67735	66286	1449	renamed_GCF_000008685.2	chromosome	843002	844451	1449	100.0	7.712e-320
URI120H	contig_1	68186	67748	438	renamed_GCF_000008685.2	chromosome	842500	842989	438	99.3	1.307e-92
URI120H	contig_1	71494	68905	2589	renamed_GCF_000008685.2	chromosome	839243	841832	2589	100.0	0.0
URI120H	contig_1	72191	71657	534	renamed_GCF_000008685.2	chromosome	838546	839080	534	100.0	7.282e-115
URI120H	contig_1	79174	79783	609	renamed_GCF_000008685.2	chromosome	831563	830954	609	100.0	7.938e-135
URI120H	contig_1	81520	80416	1104	renamed_GCF_000008685.2	chromosome	829217	830321	1104	100.0	4.529e-250
URI120H	contig_1	83107	81625	1482	renamed_GCF_000008685.2	chromosome	827630	829112	1482	100.0	0.0
URI120H	contig_1	85037	83117	1920	renamed_GCF_000008685.2	chromosome	825700	827620	1920	100.0	0.0
URI120H	contig_1	86922	86355	567	renamed_GCF_000008685.2	chromosome	823815	824382	567	100.0	1.275e-122
URI120H	contig_1	87475	86926	549	renamed_GCF_000008685.2	chromosome	823262	823811	549	100.0	1.698e-116
URI120H	contig_1	97507	98308	801	renamed_GCF_000008685.2	chromosome	813239	812438	801	100.0	9.279e-174
URI120H	contig_1	99236	100277	1041	renamed_GCF_000008685.2	chromosome	811510	810469	1041	100.0	2.778e-236
URI120H	contig_1	100251	101046	795	renamed_GCF_000008685.2	chromosome	810495	809700	795	100.0	1.877e-173
URI120H	contig_1	102282	102771	489	renamed_GCF_000008685.2	chromosome	808464	807975	489	100.0	6.125e-101
URI120H	contig_1	112699	113629	930	renamed_GCF_000008685.2	chromosome	798048	797118	930	100.0	3.063e-199
URI120H	contig_1	118397	117122	1275	renamed_GCF_000008685.2	chromosome	792350	793625	1275	100.0	1.279e-284
URI120H	contig_1	118495	118954	459	renamed_GCF_000008685.2	chromosome	792252	791793	459	100.0	5.068e-98
URI120H	contig_1	119940	120801	861	renamed_GCF_000008685.2	chromosome	790807	789946	861	100.0	1.57e-186
URI120H	contig_1	121427	120809	618	renamed_GCF_000008685.2	chromosome	789302	789938	618	100.0	3.406e-137
URI120H	contig_1	348562	346579	1983	renamed_GCF_000008685.2	chromosome	562184	564167	1983	100.0	0.0
URI120H	contig_1	349192	349630	438	renamed_GCF_000008685.2	chromosome	561554	561116	438	100.0	1.44e-91
URI120H	contig_1	350014	352741	2727	renamed_GCF_000008685.2	chromosome	560732	558005	2727	100.0	0.0
URI120H	contig_1	352722	353340	618	renamed_GCF_000008685.2	chromosome	558024	557406	618	100.0	1.216e-131
URI120H	contig_1	355531	354166	1365	renamed_GCF_000008685.2	chromosome	555215	556580	1365	100.0	6.28e-308
URI120H	contig_1	356755	355534	1221	renamed_GCF_000008685.2	chromosome	553991	555212	1221	100.0	5.34e-268
URI120H	contig_1	357608	356957	651	renamed_GCF_000008685.2	chromosome	553138	553789	651	100.0	1.464e-143
URI120H	contig_1	359022	361104	2082	renamed_GCF_000008685.2	chromosome	551723	549641	2082	100.0	0.0
URI120H	contig_1	361860	362259	399	renamed_GCF_000008685.2	chromosome	548885	548486	399	100.0	1.521e-84
URI120H	contig_1	406444	405946	498	renamed_GCF_000008685.2	chromosome	504297	504795	498	100.0	1.785e-107
URI120H	contig_1	406816	406456	360	renamed_GCF_000008685.2	chromosome	503925	504285	360	100.0	4.361e-75
URI120H	contig_1	411686	411407	279	renamed_GCF_000008685.2	chromosome	499055	499334	279	100.0	1.411e-57
URI120H	contig_1	412529	411695	834	renamed_GCF_000008685.2	chromosome	498212	499046	834	100.0	1.895e-188
URI120H	contig_1	413497	412867	630	renamed_GCF_000008685.2	chromosome	497244	497874	630	100.0	4.528e-136
URI120H	contig_1	414127	413506	621	renamed_GCF_000008685.2	chromosome	496614	497235	621	100.0	8.732e-136
URI120H	contig_1	415709	414524	1185	renamed_GCF_000008685.2	chromosome	495032	496217	1185	100.0	4.832e-263
URI120H	contig_1	416199	416592	393	renamed_GCF_000008685.2	chromosome	494539	494149	393	100.0	4.545e-80
URI120H	contig_1	420098	418814	1284	renamed_GCF_000008685.2	chromosome	490643	491927	1284	100.0	9.564e-281
URI120H	contig_1	421250	421022	228	renamed_GCF_000008685.2	chromosome	489539	489719	228	100.0	1.455e-33
URI120H	contig_1	446689	445609	1080	renamed_GCF_000008685.2	chromosome	464052	465132	1080	100.0	9.122e-247
URI120H	contig_1	447923	446855	1068	renamed_GCF_000008685.2	chromosome	462818	463886	1068	100.0	4.491e-244
URI120H	contig_1	448697	447968	729	renamed_GCF_000008685.2	chromosome	462044	462773	729	100.0	2.248e-160
URI120H	contig_1	450690	450330	360	renamed_GCF_000008685.2	chromosome	460051	460411	360	100.0	4.812e-74
URI120H	contig_1	458820	459603	783	renamed_GCF_000008685.2	chromosome	451921	451138	783	100.0	1.017e-169
URI120H	contig_1	461323	460570	753	renamed_GCF_000008685.2	chromosome	449418	450171	753	100.0	3.278e-160
URI120H	contig_1	462150	462540	390	renamed_GCF_000008685.2	chromosome	448591	448201	390	100.0	7.926e-82
URI120H	contig_1	462887	462569	318	renamed_GCF_000008685.2	chromosome	447854	448172	318	100.0	8.883e-69
URI120H	contig_1	463866	464415	549	renamed_GCF_000008685.2	chromosome	446875	446326	549	100.0	4.738e-122
URI120H	contig_1	513667	514141	474	renamed_GCF_000008685.2	chromosome	397077	396603	474	100.0	4.822e-101
URI120H	contig_1	514238	515264	1026	renamed_GCF_000008685.2	chromosome	396506	395480	1026	100.0	3.003e-224
URI120H	contig_1	515578	516640	1062	renamed_GCF_000008685.2	chromosome	395166	394104	1062	100.0	1.904e-235
URI120H	contig_1	516681	517701	1020	renamed_GCF_000008685.2	chromosome	394063	393043	1020	100.0	6.665e-223
URI120H	contig_1	517787	518813	1026	renamed_GCF_000008685.2	chromosome	392957	391931	1026	100.0	1.232e-225
URI120H	contig_1	518925	520350	1425	renamed_GCF_000008685.2	chromosome	391819	390391	1425	100.0	0.0
URI120H	contig_1	520403	521768	1365	renamed_GCF_000008685.2	chromosome	390341	388976	1365	99.5	7.255e-289
URI120H	contig_1	521818	522238	420	renamed_GCF_000008685.2	chromosome	388926	388506	420	100.0	9.787e-93
URI120H	contig_1	522264	522927	663	renamed_GCF_000008685.2	chromosome	388480	387817	663	100.0	4.965e-149
URI120H	contig_1	523411	522937	474	renamed_GCF_000008685.2	chromosome	387333	387807	474	100.0	1.339e-106
URI120H	contig_1	545141	545630	489	renamed_GCF_000008685.2	chromosome	365603	365114	489	100.0	3.787e-106
URI120H	contig_1	545664	546615	951	renamed_GCF_000008685.2	chromosome	364972	364129	951	99.6	1.174e-187
URI120H	contig_1	546627	548427	1800	renamed_GCF_000008685.2	chromosome	364117	362317	1800	100.0	0.0
URI120H	contig_1	549545	548423	1122	renamed_GCF_000008685.2	chromosome	361187	362321	1122	100.0	1.01e-252
URI120H	contig_1	549666	551232	1566	renamed_GCF_000008685.2	chromosome	361078	359512	1566	100.0	0.0
URI120H	contig_1	551249	551528	279	renamed_GCF_000008685.2	chromosome	359495	359216	279	100.0	2.841e-58
URI120H	contig_1	552287	551546	741	renamed_GCF_000008685.2	chromosome	358457	359198	741	100.0	9.218e-164
URI120H	contig_1	553738	552304	1434	renamed_GCF_000008685.2	chromosome	357006	358440	1434	100.0	9.657e-315
URI120H	contig_1	555254	553835	1419	renamed_GCF_000008685.2	chromosome	355490	356909	1419	100.0	1.415e-316
URI120H	contig_1	555446	556097	651	renamed_GCF_000008685.2	chromosome	355298	354647	651	100.0	1.769e-141
URI120H	contig_1	624786	626877	2091	renamed_GCF_000008685.2	chromosome	285962	283868	2091	99.8	0.0
URI120H	contig_1	626880	628047	1167	renamed_GCF_000008685.2	chromosome	283865	282698	1167	100.0	1.172e-258
URI120H	contig_1	628058	628946	888	renamed_GCF_000008685.2	chromosome	282687	281799	888	100.0	4.025e-189
URI120H	contig_1	628952	629432	480	renamed_GCF_000008685.2	chromosome	281793	281313	480	100.0	1.072e-101
URI120H	contig_1	629434	631339	1905	renamed_GCF_000008685.2	chromosome	281311	279406	1905	100.0	0.0
URI120H	contig_1	631365	631668	303	renamed_GCF_000008685.2	chromosome	279380	279077	303	100.0	2.087e-65
URI120H	contig_1	631687	632209	522	renamed_GCF_000008685.2	chromosome	279058	278536	522	100.0	3.966e-111
URI120H	contig_1	632186	633656	1470	renamed_GCF_000008685.2	chromosome	278559	277089	1470	100.0	8.9e-322
URI120H	contig_1	634188	633681	507	renamed_GCF_000008685.2	chromosome	276671	277064	507	100.0	6.298e-87
URI120H	contig_1	634249	635503	1254	renamed_GCF_000008685.2	chromosome	276496	275242	1254	100.0	4.99e-283
URI120H	contig_1	654283	651760	2523	renamed_GCF_000008685.2	chromosome	256462	258985	2523	100.0	0.0
URI120H	contig_1	655100	654485	615	renamed_GCF_000008685.2	chromosome	255645	256260	615	100.0	1.16e-131
URI120H	contig_1	655801	655096	705	renamed_GCF_000008685.2	chromosome	254944	255649	705	100.0	7.263e-152
URI120H	contig_1	657587	655814	1773	renamed_GCF_000008685.2	chromosome	253158	254931	1773	100.0	0.0
URI120H	contig_1	658312	657706	606	renamed_GCF_000008685.2	chromosome	252433	253039	606	100.0	4.115e-133
URI120H	contig_1	658508	659534	1026	renamed_GCF_000008685.2	chromosome	252237	251211	1026	100.0	5.545e-226
URI120H	contig_1	659534	660089	555	renamed_GCF_000008685.2	chromosome	251211	250656	555	100.0	3.12e-119
URI120H	contig_1	660075	660570	495	renamed_GCF_000008685.2	chromosome	250670	250175	495	100.0	5.051e-104
URI120H	contig_1	662219	660656	1563	renamed_GCF_000008685.2	chromosome	248505	250089	1563	100.0	0.0
URI120H	contig_1	664149	662643	1506	renamed_GCF_000008685.2	chromosome	246596	248102	1506	100.0	0.0
URI120H	contig_1	673603	675151	1548	renamed_GCF_000008685.2	chromosome	237142	235594	1548	100.0	0.0
URI120H	contig_1	675211	675457	246	renamed_GCF_000008685.2	chromosome	235534	235288	246	100.0	3.025e-52
URI120H	contig_1	678408	675492	2916	renamed_GCF_000008685.2	chromosome	232337	235253	2916	100.0	0.0
URI120H	contig_1	679125	678423	702	renamed_GCF_000008685.2	chromosome	231620	232322	702	100.0	1.161e-154
URI120H	contig_1	679254	680532	1278	renamed_GCF_000008685.2	chromosome	231491	230213	1278	100.0	4.58e-288
URI120H	contig_1	681529	680521	1008	renamed_GCF_000008685.2	chromosome	229216	230224	1008	100.0	1.228e-222
URI120H	contig_1	682224	682932	708	renamed_GCF_000008685.2	chromosome	228521	227813	708	100.0	8.763e-159
URI120H	contig_1	682918	684136	1218	renamed_GCF_000008685.2	chromosome	227827	226609	1218	100.0	6.126e-266
URI120H	contig_1	699445	698677	768	renamed_GCF_000008685.2	chromosome	211300	212068	768	100.0	8.822e-169
URI120H	contig_1	702125	702662	537	renamed_GCF_000008685.2	chromosome	208581	208083	537	99.3	7.373e-107
URI120H	contig_1	704217	702639	1578	renamed_GCF_000008685.2	chromosome	206528	208106	1578	100.0	0.0
URI120H	contig_1	705673	704701	972	renamed_GCF_000008685.2	chromosome	205174	206044	972	99.6	3.289e-188
URI120H	contig_1	706609	705673	936	renamed_GCF_000008685.2	chromosome	204136	205072	936	100.0	4.7e-204
URI120H	contig_1	707896	706657	1239	renamed_GCF_000008685.2	chromosome	202849	204088	1239	100.0	5.514e-262
URI120H	contig_1	708167	709694	1527	renamed_GCF_000008685.2	chromosome	202578	201051	1527	100.0	0.0
URI120H	contig_1	721469	721670	201	renamed_GCF_000008685.2	chromosome	189276	189075	201	100.0	9.889e-41
URI120H	contig_1	722251	722512	261	renamed_GCF_000008685.2	chromosome	188494	188233	261	100.0	7.054e-54
URI120H	contig_1	722508	722922	414	renamed_GCF_000008685.2	chromosome	188237	187823	414	100.0	2.918e-88
URI120H	contig_1	722914	723568	654	renamed_GCF_000008685.2	chromosome	187831	187177	654	100.0	1.397e-144
URI120H	contig_1	723797	723551	246	renamed_GCF_000008685.2	chromosome	186948	187194	246	100.0	9.168e-49
URI120H	contig_1	724192	723799	393	renamed_GCF_000008685.2	chromosome	186553	186946	393	100.0	5.626e-86
URI120H	contig_1	727860	727365	495	renamed_GCF_000008685.2	chromosome	182885	183380	495	100.0	9.271e-106
URI120H	contig_1	727943	729338	1395	renamed_GCF_000008685.2	chromosome	182802	181407	1395	100.0	4.219e-300
URI120H	contig_1	729340	731206	1866	renamed_GCF_000008685.2	chromosome	181405	179539	1866	100.0	0.0
URI120H	contig_1	731202	731829	627	renamed_GCF_000008685.2	chromosome	179543	178916	627	100.0	1.275e-132
URI120H	contig_1	731885	732878	993	renamed_GCF_000008685.2	chromosome	178860	177867	993	100.0	4.528e-214
URI120H	contig_1	732892	733768	876	renamed_GCF_000008685.2	chromosome	177853	176977	876	100.0	9.427e-195
URI120H	contig_1	733771	734677	906	renamed_GCF_000008685.2	chromosome	176974	176068	906	100.0	1.374e-195
URI120H	contig_1	735661	736648	987	renamed_GCF_000008685.2	chromosome	174970	174097	987	100.0	1.551e-190
URI120H	contig_1	736629	737217	588	renamed_GCF_000008685.2	chromosome	174116	173528	588	100.0	1.529e-132
URI120H	contig_1	737165	739214	2049	renamed_GCF_000008685.2	chromosome	173535	171531	2049	99.8	0.0
URI120H	contig_1	762086	763097	1011	renamed_GCF_000008685.2	chromosome	148659	147648	1011	100.0	5.463e-215
URI120H	contig_1	763250	764369	1119	renamed_GCF_000008685.2	chromosome	147495	146376	1119	100.0	3.727e-246
URI120H	contig_1	764375	765275	900	renamed_GCF_000008685.2	chromosome	146370	145470	900	100.0	6.779e-194
URI120H	contig_1	765287	766160	873	renamed_GCF_000008685.2	chromosome	145458	144585	873	100.0	2.787e-199
URI120H	contig_1	766479	767802	1323	renamed_GCF_000008685.2	chromosome	144230	142943	1323	99.7	1.75e-280
URI120H	contig_1	767813	768767	954	renamed_GCF_000008685.2	chromosome	142932	141978	954	100.0	1.517e-202
URI120H	contig_1	772002	772314	312	renamed_GCF_000008685.2	chromosome	138745	138433	312	100.0	1.981e-67
URI120H	contig_1	772981	774874	1893	renamed_GCF_000008685.2	chromosome	137766	135873	1893	100.0	0.0
URI120H	contig_1	796144	797839	1695	renamed_GCF_000008685.2	chromosome	114603	112908	1695	100.0	0.0
URI120H	contig_1	797978	798398	420	renamed_GCF_000008685.2	chromosome	112769	112349	420	100.0	6.488e-89
URI120H	contig_1	798409	798859	450	renamed_GCF_000008685.2	chromosome	112338	111888	450	100.0	4.387e-98
URI120H	contig_1	798872	799163	291	renamed_GCF_000008685.2	chromosome	111875	111584	291	100.0	1.894e-64
URI120H	contig_1	799180	799702	522	renamed_GCF_000008685.2	chromosome	111567	111045	522	100.0	1.783e-111
URI120H	contig_1	799705	801073	1368	renamed_GCF_000008685.2	chromosome	111042	109674	1368	100.0	1.976e-295
URI120H	contig_1	802441	801076	1365	renamed_GCF_000008685.2	chromosome	108306	109671	1365	100.0	4.349e-312
URI120H	contig_1	802577	803774	1197	renamed_GCF_000008685.2	chromosome	108170	106973	1197	100.0	8.414e-259
URI120H	contig_1	803853	804864	1011	renamed_GCF_000008685.2	chromosome	106894	105883	1011	100.0	4.14e-218
URI120H	contig_1	804892	805330	438	renamed_GCF_000008685.2	chromosome	105846	105417	438	100.0	3.53e-90
URI120H	contig_1	829343	827807	1536	renamed_GCF_000008685.2	chromosome	81404	82940	1536	100.0	0.0
URI120H	contig_1	829765	829339	426	renamed_GCF_000008685.2	chromosome	80982	81408	426	100.0	5.338e-92
URI120H	contig_1	831243	829974	1269	renamed_GCF_000008685.2	chromosome	79504	80773	1269	100.0	1.4e-282
URI120H	contig_1	831395	831746	351	renamed_GCF_000008685.2	chromosome	79322	79001	351	100.0	3.732e-67
URI120H	contig_1	831738	833037	1299	renamed_GCF_000008685.2	chromosome	79009	77710	1299	100.0	8.363e-285
URI120H	contig_1	834297	833046	1251	renamed_GCF_000008685.2	chromosome	76450	77701	1251	100.0	1.724e-268
URI120H	contig_1	834974	834293	681	renamed_GCF_000008685.2	chromosome	75773	76454	681	100.0	3.584e-147
URI120H	contig_1	838100	837254	846	renamed_GCF_000008685.2	chromosome	72646	73492	846	100.0	5.813e-178
URI120H	contig_1	850213	850711	498	renamed_GCF_000008685.2	chromosome	60533	60035	498	100.0	3.278e-109
URI120H	contig_1	850707	851646	939	renamed_GCF_000008685.2	chromosome	60039	59100	939	100.0	4.091e-206
URI120H	contig_1	851710	852718	1008	renamed_GCF_000008685.2	chromosome	58982	58028	1008	100.0	2.425e-206
URI120H	contig_1	853488	852771	717	renamed_GCF_000008685.2	chromosome	57258	57975	717	100.0	1.471e-154
URI120H	contig_1	853561	853915	354	renamed_GCF_000008685.2	chromosome	57185	56831	354	100.0	1.322e-78
URI120H	contig_1	853998	854466	468	renamed_GCF_000008685.2	chromosome	56748	56280	468	100.0	3.979e-102
URI120H	contig_1	854466	855246	780	renamed_GCF_000008685.2	chromosome	56280	55500	780	99.6	1.628e-172
URI120H	contig_1	855242	857213	1971	renamed_GCF_000008685.2	chromosome	55504	53533	1971	100.0	0.0
URI120H	contig_1	857285	858293	1008	renamed_GCF_000008685.2	chromosome	53461	52453	1008	100.0	6.65e-221
URI120H	contig_1	858312	859494	1182	renamed_GCF_000008685.2	chromosome	52434	51252	1182	100.0	6.664e-259
URI120H	contig_1	899326	898585	741	renamed_GCF_000008685.2	chromosome	11420	12161	741	100.0	4.147e-164
URI120H	contig_1	900166	899326	840	renamed_GCF_000008685.2	chromosome	10580	11420	840	100.0	7.775e-191
URI120H	contig_1	900544	900169	375	renamed_GCF_000008685.2	chromosome	10202	10577	375	100.0	3.75e-79
URI120H	contig_1	901545	900540	1005	renamed_GCF_000008685.2	chromosome	9201	10206	1005	100.0	1.697e-218
URI120H	contig_1	902320	901549	771	renamed_GCF_000008685.2	chromosome	8426	9197	771	100.0	1.781e-161
URI120H	contig_1	902431	903289	858	renamed_GCF_000008685.2	chromosome	8315	7457	858	100.0	6.472e-196
URI120H	contig_1	903349	904438	1089	renamed_GCF_000008685.2	chromosome	7397	6308	1089	100.0	1.828e-240
URI120H	contig_1	904440	905496	1056	renamed_GCF_000008685.2	chromosome	6306	5250	1056	99.7	7.804e-236
URI120H	contig_1	907352	905558	1794	renamed_GCF_000008685.2	chromosome	3418	5188	1794	100.0	0.0
URI120H	contig_2	9116	9965	849	renamed_GCF_000008685.2	lp54	44533	43684	849	100.0	7.054e-185
URI120H	contig_2	10128	11037	909	renamed_GCF_000008685.2	lp54	43532	42623	909	99.3	2.657e-197
URI120H	contig_2	11394	11187	207	renamed_GCF_000008685.2	lp54	42266	42473	207	100.0	9.856e-42
URI120H	contig_2	11641	12265	624	renamed_GCF_000008685.2	lp54	42019	41395	624	100.0	3.1e-139
URI120H	contig_2	12615	13449	834	renamed_GCF_000008685.2	lp54	41045	40211	834	100.0	3.319e-182
URI120H	contig_2	13548	13788	240	renamed_GCF_000008685.2	lp54	40112	39872	240	100.0	3.722e-49
URI120H	contig_2	14255	15500	1245	renamed_GCF_000008685.2	lp54	39405	38160	1245	100.0	4.898e-273
URI120H	contig_2	17393	17126	267	renamed_GCF_000008685.2	lp54	36255	36534	267	98.8	1.568e-54
URI120H	contig_10	18925	17572	1353	renamed_GCF_000008685.2	cp32-9	29298	30651	1353	99.5	6.861e-305
URI120H	contig_10	20198	19679	519	renamed_GCF_000008685.2	cp32-9	28025	28544	519	99.4	3.122e-113
URI120H	contig_10	21426	20394	1032	renamed_GCF_000008685.2	cp32-9	26797	27829	1032	100.0	2.498e-227
URI120H	contig_10	22014	21453	561	renamed_GCF_000008685.2	cp32-9	26209	26770	561	100.0	4.739e-124
URI120H	contig_10	23652	23226	426	renamed_GCF_000008685.2	cp32-9	24571	24997	426	100.0	1.627e-96
URI120H	contig_10	25030	23704	1326	renamed_GCF_000008685.2	cp32-9	23193	24519	1326	100.0	7.132e-300
URI120H	contig_10	26040	25500	540	renamed_GCF_000008685.2	cp32-9	22183	22723	540	100.0	1.782e-114
URI120H	contig_11	2355	2811	456	renamed_GCF_000008685.2	cp32-4	8281	8737	456	100.0	1.971e-99
URI120H	contig_11	2807	3044	237	renamed_GCF_000008685.2	lp56	12192	12429	237	100.0	1.76e-48
URI120H	contig_11	3051	4347	1296	renamed_GCF_000008685.2	cp32-4	8977	10273	1296	100.0	2.13e-282
URI120H	contig_11	4369	4966	597	renamed_GCF_000008685.2	cp32-4	10295	10892	597	100.0	4.743e-130
URI120H	contig_11	4969	5920	951	renamed_GCF_000008685.2	cp32-4	10895	11846	951	100.0	4.333e-216
URI120H	contig_11	5937	6492	555	renamed_GCF_000008685.2	cp32-4	11863	12418	555	100.0	3.12e-119
URI120H	contig_11	6521	6854	333	renamed_GCF_000008685.2	cp32-6	12513	12846	333	100.0	8.424e-72
URI120H	contig_11	6850	7726	876	renamed_GCF_000008685.2	cp32-4	12776	13652	876	100.0	5.609e-192
URI120H	contig_11	7735	8341	606	renamed_GCF_000008685.2	cp32-1	13708	14314	606	100.0	5.47e-130
URI120H	contig_11	8350	9166	816	renamed_GCF_000008685.2	cp32-4	14276	15092	816	100.0	1.49e-179
URI120H	contig_12	12414	11958	456	renamed_GCF_000008685.2	cp32-1	4941	5397	456	100.0	1.075e-97
URI120H	contig_12	13393	12433	960	renamed_GCF_000008685.2	cp32-7	3961	4921	960	100.0	6.593e-213
URI120H	contig_12	14781	14016	765	renamed_GCF_000008685.2	cp32-7	2573	3338	765	99.6	3.139e-171
URI120H	contig_12	17290	16066	1224	renamed_GCF_000008685.2	cp32-3	65	1289	1224	100.0	2.096e-270
URI120H	contig_12	18708	17355	1353	renamed_GCF_000008685.2	cp32-3	28870	30223	1353	100.0	1.268e-306
URI120H	contig_12	19343	18704	639	renamed_GCF_000008685.2	cp32-3	28235	28874	639	100.0	1.943e-138
URI120H	contig_12	20169	19659	510	renamed_GCF_000008685.2	cp32-3	27409	27919	510	100.0	3.969e-109
URI120H	contig_12	20871	20280	591	renamed_GCF_000008685.2	cp32-3	26707	27298	591	100.0	2.345e-128
URI120H	contig_12	21302	22079	777	renamed_GCF_000008685.2	cp32-3	26276	25499	777	100.0	3.144e-173
URI120H	contig_12	22510	22084	426	renamed_GCF_000008685.2	cp32-3	25068	25494	426	100.0	3.62e-96
URI120H	contig_12	23888	22562	1326	renamed_GCF_000008685.2	cp32-3	23690	25016	1326	100.0	1.445e-300
URI120H	contig_12	26323	25582	741	renamed_GCF_000008685.2	cp32-3	21256	21997	741	100.0	5.003e-162
URI120H	contig_12	26865	26298	567	renamed_GCF_000008685.2	cp32-3	20714	21281	567	100.0	2.944e-130
URI120H	contig_13	18536	17183	1353	renamed_GCF_000008685.2	cp32-6	28485	29838	1353	100.0	6.259e-306
URI120H	contig_13	19099	18532	567	renamed_GCF_000008685.2	cp32-6	27922	28489	567	100.0	2.836e-122
URI120H	contig_13	19276	19945	669	renamed_GCF_000008685.2	cp32-6	27745	27076	669	100.0	4.521e-151
URI120H	contig_13	20765	20006	759	renamed_GCF_000008685.2	cp32-6	26256	27015	759	100.0	2.986e-162
URI120H	contig_13	21201	21972	771	renamed_GCF_000008685.2	cp32-6	25820	25049	771	100.0	3.141e-172
URI120H	contig_13	22403	21977	426	renamed_GCF_000008685.2	cp32-6	24618	25044	426	100.0	8.056e-96
URI120H	contig_13	24922	24253	669	renamed_GCF_000008685.2	cp32-6	22101	22770	669	100.0	2.138e-142
URI120H	contig_13	25504	24925	579	renamed_GCF_000008685.2	cp32-6	21519	22098	579	100.0	5.735e-125
URI120H	contig_13	26303	25553	750	renamed_GCF_000008685.2	cp32-6	20720	21470	750	100.0	4.35e-165
URI120H	contig_14	23768	23000	768	renamed_GCF_000008685.2	lp28-2	5910	6678	768	100.0	2.365e-166
URI120H	contig_14	24301	23728	573	renamed_GCF_000008685.2	lp28-2	5377	5950	573	100.0	1.602e-129
URI120H	contig_14	28632	27750	882	renamed_GCF_000008685.2	lp28-2	1046	1928	882	100.0	1.741e-197
URI120H	contig_14	29563	28669	894	renamed_GCF_000008685.2	lp28-2	115	1009	894	100.0	3.048e-193
URI120H	contig_15	395	968	573	renamed_GCF_000008685.2	lp28-3	28197	27624	573	100.0	5.735e-124
URI120H	contig_15	1147	1615	468	renamed_GCF_000008685.2	lp28-3	27445	26977	468	99.3	1.339e-105
URI120H	contig_15	2248	3160	912	renamed_GCF_000008685.2	lp28-3	26371	25432	912	100.0	5.639e-198
URI120H	contig_16	18717	20067	1350	renamed_GCF_000008685.2	cp26	2186	836	1350	100.0	7.868e-303
URI120H	contig_16	20152	20596	444	renamed_GCF_000008685.2	cp26	751	307	444	100.0	2.98e-101
URI120H	contig_16	20858	20579	279	renamed_GCF_000008685.2	cp26	45	324	279	100.0	2.323e-60
URI120H	contig_16	22577	20948	1629	renamed_GCF_000008685.2	cp26	24824	26453	1629	100.0	0.0
URI120H	contig_16	24147	22902	1245	renamed_GCF_000008685.2	cp26	23254	24499	1245	100.0	1.056e-281
URI120H	contig_16	24247	24799	552	renamed_GCF_000008685.2	cp26	23154	22602	552	100.0	6.015e-120
URI120H	contig_16	25504	24808	696	renamed_GCF_000008685.2	cp26	21897	22593	696	100.0	1.401e-151
URI120H	contig_16	25577	26063	486	renamed_GCF_000008685.2	cp26	21833	21338	486	100.0	3.279e-107
URI120H	contig_17	810	378	432	renamed_GCF_000008685.2	lp5	4387	4819	432	99.3	2.641e-92
URI120H	contig_17	1858	865	993	renamed_GCF_000008685.2	lp5	3339	4332	993	100.0	1.858e-215
URI120H	contig_18	6938	7802	864	renamed_GCF_000008685.2	lp25	6897	7761	864	100.0	7.808e-195
URI120H	contig_18	10228	9607	621	renamed_GCF_000008685.2	lp25	10187	9566	621	100.0	1.329e-139
URI120H	contig_18	10750	10240	510	renamed_GCF_000008685.2	lp25	10694	10199	510	99.3	8.021e-110
URI120H	contig_18	12120	11538	582	renamed_GCF_000008685.2	lp25	12079	11497	582	100.0	4.521e-128
URI120H	contig_18	12895	12136	759	renamed_GCF_000008685.2	lp25	12854	12095	759	100.0	2.255e-165
URI120H	contig_18	13434	12870	564	renamed_GCF_000008685.2	lp25	13393	12829	564	100.0	4.519e-125
URI120H	contig_18	14517	13443	1074	renamed_GCF_000008685.2	lp25	14530	13402	1074	99.7	2.22e-244
URI120H	contig_18	15619	15082	537	renamed_GCF_000008685.2	lp25	15545	15041	537	99.4	7.638e-115
URI120H	contig_20	2060	2897	837	renamed_GCF_000008685.2	lp28-4	22931	22094	837	100.0	1.426e-183
URI120H	contig_20	3429	4221	792	renamed_GCF_000008685.2	lp28-4	21562	20770	792	100.0	1.631e-174
URI120H	contig_20	5808	6474	666	renamed_GCF_000008685.2	lp28-4	19183	18517	666	99.5	3.416e-145
URI120H	contig_20	9640	8461	1179	renamed_GCF_000008685.2	lp28-4	15351	16530	1179	100.0	4.972e-253
URI120H	contig_20	11727	11154	573	renamed_GCF_000008685.2	lp28-4	13264	13837	573	100.0	2.579e-124
URI120H	contig_55	21	234	213	renamed_GCF_000008685.2	lp36	35867	36422	213	100.0	1.447e-46
URI120H	contig_56	21	237	216	renamed_GCF_000008685.2	lp28-4	26359	26914	216	100.0	2.76e-48
URI120H	contig_1	110472	111540	1068	renamed_GCF_000008685.2	chromosome	800275	799207	1068	100.0	8.292e-246
URI120H	contig_1	111731	112691	960	renamed_GCF_000008685.2	chromosome	799016	798056	960	100.0	6.008e-214
URI120H	contig_1	150546	149100	1446	renamed_GCF_000008685.2	chromosome	760225	761647	1446	99.7	9.686e-317
URI120H	contig_1	151162	150532	630	renamed_GCF_000008685.2	chromosome	759585	760215	630	100.0	3.747e-138
URI120H	contig_1	154394	153077	1317	renamed_GCF_000008685.2	chromosome	756353	757670	1317	100.0	1.293e-291
URI120H	contig_1	156198	154398	1800	renamed_GCF_000008685.2	chromosome	754636	756349	1800	100.0	0.0
URI120H	contig_1	156680	156197	483	renamed_GCF_000008685.2	chromosome	754067	754550	483	100.0	1.405e-107
URI120H	contig_1	157525	156679	846	renamed_GCF_000008685.2	chromosome	753291	754068	846	100.0	1.342e-168
URI120H	contig_1	158578	157528	1050	renamed_GCF_000008685.2	chromosome	752169	753219	1050	100.0	6.109e-229
URI120H	contig_1	189630	187728	1902	renamed_GCF_000008685.2	chromosome	721118	723020	1902	100.0	0.0
URI120H	contig_1	191922	189660	2262	renamed_GCF_000008685.2	chromosome	718826	721088	2262	100.0	0.0
URI120H	contig_1	210783	212349	1566	renamed_GCF_000008685.2	chromosome	699965	698399	1566	100.0	0.0
URI120H	contig_1	213163	212416	747	renamed_GCF_000008685.2	chromosome	697585	698332	747	100.0	1.547e-167
URI120H	contig_1	213311	213998	687	renamed_GCF_000008685.2	chromosome	697437	696750	687	100.0	2.97e-150
URI120H	contig_1	215118	213984	1134	renamed_GCF_000008685.2	chromosome	695630	696764	1134	100.0	1.419e-259
URI120H	contig_1	215225	216056	831	renamed_GCF_000008685.2	chromosome	695523	694692	831	100.0	5.839e-184
URI120H	contig_1	217195	216052	1143	renamed_GCF_000008685.2	chromosome	693553	694696	1143	100.0	3.979e-258
URI120H	contig_1	218120	217220	900	renamed_GCF_000008685.2	chromosome	692628	693528	900	100.0	8.957e-191
URI120H	contig_1	219864	218103	1761	renamed_GCF_000008685.2	chromosome	690884	692645	1761	100.0	0.0
URI120H	contig_1	262421	264089	1668	renamed_GCF_000008685.2	chromosome	648254	646658	1668	100.0	0.0
URI120H	contig_1	265029	264066	963	renamed_GCF_000008685.2	chromosome	645718	646681	963	100.0	1.162e-215
URI120H	contig_1	291919	289711	2208	renamed_GCF_000008685.2	chromosome	618827	621035	2208	100.0	0.0
URI120H	contig_1	292187	294335	2148	renamed_GCF_000008685.2	chromosome	618559	616411	2148	100.0	0.0
URI120H	contig_1	294356	294983	627	renamed_GCF_000008685.2	chromosome	616390	615763	627	100.0	5.736e-133
URI120H	contig_1	294975	296733	1758	renamed_GCF_000008685.2	chromosome	615771	614013	1758	100.0	0.0
URI120H	contig_1	298699	296761	1938	renamed_GCF_000008685.2	chromosome	612047	613985	1938	100.0	0.0
URI120H	contig_1	299438	298724	714	renamed_GCF_000008685.2	chromosome	611308	612022	714	100.0	1.949e-159
URI120H	contig_1	299553	300804	1251	renamed_GCF_000008685.2	chromosome	611193	609942	1251	100.0	7.081e-270
URI120H	contig_1	300840	301686	846	renamed_GCF_000008685.2	chromosome	609906	609060	846	100.0	3.324e-184
URI120H	contig_1	339464	338894	570	renamed_GCF_000008685.2	chromosome	571282	571852	570	100.0	1.471e-121
URI120H	contig_1	341188	339466	1722	renamed_GCF_000008685.2	chromosome	569558	571280	1722	100.0	0.0
URI120H	contig_1	362255	362900	645	renamed_GCF_000008685.2	chromosome	548490	547845	645	100.0	1.056e-137
URI120H	contig_1	366160	363358	2802	renamed_GCF_000008685.2	chromosome	544585	547387	2802	99.8	0.0
URI120H	contig_1	366914	366140	774	renamed_GCF_000008685.2	chromosome	543831	544605	774	100.0	1.787e-170
URI120H	contig_1	367697	366929	768	renamed_GCF_000008685.2	chromosome	543048	543816	768	100.0	8.433e-178
URI120H	contig_1	368483	367721	762	renamed_GCF_000008685.2	chromosome	542262	543024	762	100.0	5.516e-173
URI120H	contig_1	428142	426459	1683	renamed_GCF_000008685.2	chromosome	482599	484282	1683	100.0	0.0
URI120H	contig_1	428684	429398	714	renamed_GCF_000008685.2	chromosome	482057	481343	714	100.0	3.944e-160
URI120H	contig_1	431033	429722	1311	renamed_GCF_000008685.2	chromosome	479708	481019	1311	100.0	7.438e-297
URI120H	contig_1	435136	434530	606	renamed_GCF_000008685.2	chromosome	475605	476211	606	100.0	1.006e-131
URI120H	contig_1	436129	435139	990	renamed_GCF_000008685.2	chromosome	474612	475602	990	100.0	3.939e-215
URI120H	contig_1	436185	437337	1152	renamed_GCF_000008685.2	chromosome	474556	473404	1152	100.0	7.714e-261
URI120H	contig_1	438266	438971	705	renamed_GCF_000008685.2	chromosome	472358	471770	705	99.4	1.099e-121
URI120H	contig_1	482097	481068	1029	renamed_GCF_000008685.2	chromosome	428645	429674	1029	100.0	3.872e-239
URI120H	contig_1	482756	482120	636	renamed_GCF_000008685.2	chromosome	427986	428622	636	100.0	3.41e-140
URI120H	contig_1	484007	482792	1215	renamed_GCF_000008685.2	chromosome	426735	427950	1215	100.0	1.711e-262
URI120H	contig_1	486049	485191	858	renamed_GCF_000008685.2	chromosome	424693	425551	858	100.0	1.579e-194
URI120H	contig_1	486296	486920	624	renamed_GCF_000008685.2	chromosome	424442	423821	624	100.0	2.036e-135
URI120H	contig_1	489191	488561	630	renamed_GCF_000008685.2	chromosome	421553	422183	630	100.0	5.705e-142
URI120H	contig_1	501342	502191	849	renamed_GCF_000008685.2	chromosome	409402	408553	849	100.0	9.834e-190
URI120H	contig_1	502364	502544	180	renamed_GCF_000008685.2	chromosome	408380	408200	180	100.0	2.118e-37
URI120H	contig_1	503452	503884	432	renamed_GCF_000008685.2	chromosome	407292	406860	432	100.0	3.534e-89
URI120H	contig_1	504568	505057	489	renamed_GCF_000008685.2	chromosome	406176	405687	489	100.0	1.238e-101
URI120H	contig_1	505127	505502	375	renamed_GCF_000008685.2	chromosome	405617	405242	375	100.0	5.555e-75
URI120H	contig_1	565682	564380	1302	renamed_GCF_000008685.2	chromosome	345062	346364	1302	100.0	6.07e-289
URI120H	contig_1	567537	566565	972	renamed_GCF_000008685.2	chromosome	343207	344179	972	100.0	3.579e-213
URI120H	contig_1	569471	568421	1050	renamed_GCF_000008685.2	chromosome	341273	342323	1050	100.0	1.489e-227
URI120H	contig_1	570404	569483	921	renamed_GCF_000008685.2	chromosome	340340	341261	921	100.0	2.92e-198
URI120H	contig_1	572387	570761	1626	renamed_GCF_000008685.2	chromosome	338357	339983	1626	100.0	0.0
URI120H	contig_1	576229	577126	897	renamed_GCF_000008685.2	chromosome	334515	333618	897	100.0	1.666e-200
URI120H	contig_1	577146	579942	2796	renamed_GCF_000008685.2	chromosome	333598	330802	2796	100.0	0.0
URI120H	contig_1	581483	581123	360	renamed_GCF_000008685.2	chromosome	329261	329621	360	100.0	1.609e-77
URI120H	contig_1	596317	596599	282	renamed_GCF_000008685.2	chromosome	314427	314145	282	100.0	2.699e-59
URI120H	contig_1	598030	599086	1056	renamed_GCF_000008685.2	chromosome	312715	311659	1056	100.0	1.239e-230
URI120H	contig_1	599092	600187	1095	renamed_GCF_000008685.2	chromosome	311617	310558	1095	99.7	2.491e-229
URI120H	contig_1	600965	602207	1242	renamed_GCF_000008685.2	chromosome	309780	308538	1242	100.0	1.368e-269
URI120H	contig_1	602228	603428	1200	renamed_GCF_000008685.2	chromosome	308517	307317	1200	100.0	3.302e-261
URI120H	contig_1	604127	605075	948	renamed_GCF_000008685.2	chromosome	306615	305670	948	100.0	3.249e-210
URI120H	contig_1	605084	605633	549	renamed_GCF_000008685.2	chromosome	305661	305112	549	100.0	9.24e-115
URI120H	contig_1	607005	607413	408	renamed_GCF_000008685.2	chromosome	303740	303332	408	100.0	2.649e-88
URI120H	contig_1	607909	608242	333	renamed_GCF_000008685.2	chromosome	302839	302503	333	99.0	1.253e-67
URI120H	contig_1	608256	609966	1710	renamed_GCF_000008685.2	chromosome	302489	300779	1710	100.0	0.0
URI120H	contig_1	744858	745845	987	renamed_GCF_000008685.2	chromosome	165887	164900	987	100.0	2.687e-210
URI120H	contig_1	747868	747700	168	renamed_GCF_000008685.2	chromosome	162877	163045	168	100.0	5.294e-34
URI120H	contig_1	747944	749546	1602	renamed_GCF_000008685.2	chromosome	162801	161199	1602	100.0	0.0
URI120H	contig_1	776773	774883	1890	renamed_GCF_000008685.2	chromosome	133974	135864	1890	100.0	0.0
URI120H	contig_1	779450	778322	1128	renamed_GCF_000008685.2	chromosome	131297	132425	1128	100.0	3.566e-248
URI120H	contig_1	779633	780578	945	renamed_GCF_000008685.2	chromosome	131114	130169	945	100.0	6.888e-210
URI120H	contig_1	783334	784432	1098	renamed_GCF_000008685.2	chromosome	127413	126315	1098	100.0	1.369e-236
URI120H	contig_1	784446	785214	768	renamed_GCF_000008685.2	chromosome	126301	125533	768	100.0	3.291e-171
URI120H	contig_1	785933	786599	666	renamed_GCF_000008685.2	chromosome	124814	124148	666	100.0	8.347e-144
URI120H	contig_1	786601	788257	1656	renamed_GCF_000008685.2	chromosome	124146	122490	1656	100.0	0.0
URI120H	contig_1	846709	845470	1239	renamed_GCF_000008685.2	chromosome	64037	65276	1239	100.0	5.707e-279
URI120H	contig_1	849489	850179	690	renamed_GCF_000008685.2	chromosome	61257	60567	690	100.0	1.401e-150
URI120H	contig_1	869314	869986	672	renamed_GCF_000008685.2	chromosome	41432	40760	672	100.0	1.856e-144
URI120H	contig_1	870921	870069	852	renamed_GCF_000008685.2	chromosome	39825	40677	852	100.0	1.031e-189
URI120H	contig_1	874137	874890	753	renamed_GCF_000008685.2	chromosome	36609	35856	753	100.0	1.343e-161
URI120H	contig_1	876709	878590	1881	renamed_GCF_000008685.2	chromosome	34037	32156	1881	100.0	0.0
URI120H	contig_1	878657	879197	540	renamed_GCF_000008685.2	chromosome	32089	31549	540	100.0	3.274e-116
URI120H	contig_1	879720	879267	453	renamed_GCF_000008685.2	chromosome	31026	31479	453	100.0	2.279e-97
URI120H	contig_2	39323	38777	546	renamed_GCF_000008685.2	lp54	14337	14883	546	100.0	1.338e-118
URI120H	contig_2	40106	39353	753	renamed_GCF_000008685.2	lp54	13554	14307	753	100.0	4.561e-165
URI120H	contig_3	14973	14226	747	renamed_GCF_000008685.2	lp56	36388	37135	747	100.0	3.778e-166
URI120H	contig_3	16247	15554	693	renamed_GCF_000008685.2	lp56	35114	35807	693	98.2	6.307e-143
URI120H	contig_3	19468	18901	567	renamed_GCF_000008685.2	lp56	31891	32458	567	100.0	5.734e-123
URI120H	contig_5	9400	8845	555	renamed_GCF_000008685.2	lp36	25102	25657	555	100.0	3.12e-119
URI120H	contig_6	14660	15008	348	renamed_GCF_000008685.2	cp32-6	15437	15785	348	98.2	4.373e-73
URI120H	contig_7	4935	3822	1113	renamed_GCF_000008685.2	cp32-6	6710	7823	1113	99.4	1.528e-246
URI120H	contig_10	1099	544	555	renamed_GCF_000008685.2	cp32-9	16641	17196	555	100.0	1.867e-116
URI120H	contig_10	1557	1203	354	renamed_GCF_000008685.2	lp56	19584	19938	354	100.0	1.459e-77
URI120H	contig_10	2222	1874	348	renamed_GCF_000008685.2	cp32-9	15518	15866	348	100.0	8.822e-74
URI120H	contig_10	2429	2225	204	renamed_GCF_000008685.2	cp32-4	15166	15370	204	100.0	2.578e-39
URI120H	contig_11	13033	14131	1098	renamed_GCF_000008685.2	cp32-4	18959	20057	1098	100.0	8.352e-251
URI120H	contig_11	14682	15438	756	renamed_GCF_000008685.2	cp32-4	20608	21364	756	100.0	8.022e-168
URI120H	contig_11	23020	24373	1353	renamed_GCF_000008685.2	cp32-4	28946	30299	1353	100.0	2.818e-306
URI120H	contig_11	24438	25662	1224	renamed_GCF_000008685.2	cp32-4	65	1289	1224	100.0	4.655e-270
URI120H	contig_11	26385	26949	564	renamed_GCF_000008685.2	cp32-4	2012	2576	564	100.0	2.235e-124
URI120H	contig_11	27748	28324	576	renamed_GCF_000008685.2	cp32-4	3375	3951	576	100.0	1.005e-126
URI120H	contig_11	29779	30163	384	renamed_GCF_000008685.2	lp56	8866	9250	384	100.0	2.931e-83
URI120H	contig_14	5953	6646	693	renamed_GCF_000008685.2	lp28-2	23725	23032	693	100.0	4.125e-156
URI120H	contig_14	7019	7406	387	renamed_GCF_000008685.2	lp28-2	22659	22272	387	100.0	4.63e-87
URI120H	contig_14	7374	10059	2685	renamed_GCF_000008685.2	lp28-2	22259	19619	2685	99.8	0.0
URI120H	contig_14	10059	10842	783	renamed_GCF_000008685.2	lp28-2	19619	18836	783	100.0	1.354e-183
URI120H	contig_14	11659	11998	339	renamed_GCF_000008685.2	lp28-2	18019	17680	339	100.0	5.085e-70
URI120H	contig_14	13196	14222	1026	renamed_GCF_000008685.2	lp28-2	16482	15456	1026	100.0	1.723e-230
URI120H	contig_14	14247	14793	546	renamed_GCF_000008685.2	lp28-2	15431	14885	546	100.0	8.811e-115
URI120H	contig_14	15337	16171	834	renamed_GCF_000008685.2	lp28-2	14341	13507	834	100.0	1.239e-184
URI120H	contig_14	16183	16522	339	renamed_GCF_000008685.2	lp28-2	13495	13156	339	100.0	3.422e-74
URI120H	contig_14	16926	17370	444	renamed_GCF_000008685.2	lp28-2	12752	12308	444	100.0	8.866e-98
URI120H	contig_14	17359	18178	819	renamed_GCF_000008685.2	lp28-2	12319	11500	819	100.0	1.075e-183
URI120H	contig_16	13068	12138	930	renamed_GCF_000008685.2	cp26	7835	8765	930	100.0	7.897e-206
URI120H	contig_16	14227	13189	1038	renamed_GCF_000008685.2	cp26	6676	7714	1038	100.0	8.529e-232
URI120H	contig_16	16135	15037	1098	renamed_GCF_000008685.2	cp26	4768	5866	1098	100.0	2.035e-249
URI120H	contig_16	16464	16146	318	renamed_GCF_000008685.2	cp26	4481	4757	318	100.0	7.253e-55
URI120H	contig_16	16820	16472	348	renamed_GCF_000008685.2	cp26	4083	4431	348	100.0	1.075e-71
URI120H	contig_17	2231	2516	285	renamed_GCF_000008685.2	lp21	16548	16227	285	98.9	2.097e-62
URI120H	contig_17	3395	2930	465	renamed_GCF_000008685.2	lp21	15348	15813	465	99.3	4.176e-101
URI120H	contig_17	4096	3508	588	renamed_GCF_000008685.2	lp21	14647	15235	588	100.0	4.973e-128
URI120H	contig_17	7474	6934	540	renamed_GCF_000008685.2	cp9	6808	6280	540	87.1	4.907e-95
URI120H	contig_27	329	719	390	renamed_GCF_000008685.2	cp32-8	5767	6157	390	100.0	3.229e-83
URI120H	contig_1	5836	6808	972	renamed_GCF_000008685.2	chromosome	904900	903928	972	100.0	2.334e-209
URI120H	contig_1	50626	51799	1173	renamed_GCF_000008685.2	chromosome	860111	858938	1173	100.0	1.287e-258
URI120H	contig_1	56963	55895	1068	renamed_GCF_000008685.2	chromosome	853774	854842	1068	100.0	1.362e-231
URI120H	contig_1	62200	61933	267	renamed_GCF_000008685.2	chromosome	848537	848804	267	100.0	3.495e-54
URI120H	contig_1	66284	63635	2649	renamed_GCF_000008685.2	chromosome	844453	847102	2649	100.0	0.0
URI120H	contig_1	68904	68286	618	renamed_GCF_000008685.2	chromosome	841833	842451	618	100.0	1.393e-138
URI120H	contig_1	74677	72211	2466	renamed_GCF_000008685.2	chromosome	836060	838526	2466	100.0	0.0
URI120H	contig_1	79796	80420	624	renamed_GCF_000008685.2	chromosome	830941	830317	624	100.0	5.187e-142
URI120H	contig_1	118960	119941	981	renamed_GCF_000008685.2	chromosome	791787	790806	981	100.0	5.759e-218
URI120H	contig_1	123888	121785	2103	renamed_GCF_000008685.2	chromosome	786859	788962	2103	100.0	0.0
URI120H	contig_1	127499	127772	273	renamed_GCF_000008685.2	chromosome	783248	782975	273	100.0	3.858e-54
URI120H	contig_1	131990	129362	2628	renamed_GCF_000008685.2	chromosome	778757	781385	2628	100.0	0.0
URI120H	contig_1	139608	141201	1593	renamed_GCF_000008685.2	chromosome	771139	769546	1593	100.0	0.0
URI120H	contig_1	147169	146386	783	renamed_GCF_000008685.2	chromosome	763578	764361	783	100.0	1.874e-171
URI120H	contig_1	166227	165903	324	renamed_GCF_000008685.2	chromosome	744521	744845	324	100.0	1.32e-65
URI120H	contig_1	170061	169323	738	renamed_GCF_000008685.2	chromosome	740687	741425	738	100.0	4.772e-162
URI120H	contig_1	170509	170326	183	renamed_GCF_000008685.2	chromosome	740239	740422	183	100.0	1.805e-39
URI120H	contig_1	199538	199097	441	renamed_GCF_000008685.2	chromosome	711210	711651	441	100.0	1.245e-93
URI120H	contig_1	204076	201481	2595	renamed_GCF_000008685.2	chromosome	706672	709267	2595	100.0	0.0
URI120H	contig_1	206818	205789	1029	renamed_GCF_000008685.2	chromosome	703960	704959	1029	99.6	3.451e-223
URI120H	contig_1	207782	208466	684	renamed_GCF_000008685.2	chromosome	702951	702282	684	100.0	4.537e-145
URI120H	contig_1	209720	209363	357	renamed_GCF_000008685.2	chromosome	701028	701385	357	100.0	2.301e-81
URI120H	contig_1	228070	227371	699	renamed_GCF_000008685.2	chromosome	682678	683377	699	100.0	1.337e-152
URI120H	contig_1	230185	230995	810	renamed_GCF_000008685.2	chromosome	680557	679753	810	99.6	5.278e-173
URI120H	contig_1	234277	232888	1389	renamed_GCF_000008685.2	chromosome	676471	677860	1389	100.0	1.442e-302
URI120H	contig_1	237536	238982	1446	renamed_GCF_000008685.2	chromosome	673167	671766	1446	100.0	1.676e-310
URI120H	contig_1	309737	308402	1335	renamed_GCF_000008685.2	chromosome	601009	602344	1335	100.0	3.161e-293
URI120H	contig_1	314216	312155	2061	renamed_GCF_000008685.2	chromosome	596530	598591	2061	100.0	0.0
URI120H	contig_1	319559	318389	1170	renamed_GCF_000008685.2	chromosome	591187	592357	1170	100.0	9.606e-253
URI120H	contig_1	320538	321063	525	renamed_GCF_000008685.2	chromosome	590208	589683	525	100.0	5.037e-109
URI120H	contig_1	329102	327329	1773	renamed_GCF_000008685.2	chromosome	581644	583417	1773	100.0	0.0
URI120H	contig_1	342477	341607	870	renamed_GCF_000008685.2	chromosome	568269	569139	870	100.0	1.737e-195
URI120H	contig_1	344777	342923	1854	renamed_GCF_000008685.2	chromosome	565954	567823	1854	99.8	0.0
URI120H	contig_1	348803	349184	381	renamed_GCF_000008685.2	chromosome	561943	561562	381	100.0	2.258e-77
URI120H	contig_1	349619	350018	399	renamed_GCF_000008685.2	chromosome	561127	560728	399	100.0	7.535e-84
URI120H	contig_1	353323	354184	861	renamed_GCF_000008685.2	chromosome	557423	556562	861	100.0	5.864e-189
URI120H	contig_1	451217	450917	300	renamed_GCF_000008685.2	chromosome	459524	459824	300	100.0	7.304e-60
URI120H	contig_1	452465	451307	1158	renamed_GCF_000008685.2	chromosome	458276	459434	1158	100.0	2.482e-257
URI120H	contig_1	454166	452705	1461	renamed_GCF_000008685.2	chromosome	456575	458036	1461	100.0	0.0
URI120H	contig_1	454353	456258	1905	renamed_GCF_000008685.2	chromosome	456388	454483	1905	100.0	0.0
URI120H	contig_1	456269	458702	2433	renamed_GCF_000008685.2	chromosome	454472	452039	2433	100.0	0.0
URI120H	contig_1	462037	461431	606	renamed_GCF_000008685.2	chromosome	448707	449310	606	100.0	1.106e-130
URI120H	contig_1	462981	463773	792	renamed_GCF_000008685.2	chromosome	447736	446968	792	99.6	3.782e-165
URI120H	contig_1	468189	469029	840	renamed_GCF_000008685.2	chromosome	442552	441712	840	100.0	1.361e-184
URI120H	contig_1	491238	492357	1119	renamed_GCF_000008685.2	chromosome	419506	418387	1119	100.0	8.015e-255
URI120H	contig_1	503883	504564	681	renamed_GCF_000008685.2	chromosome	406861	406180	681	100.0	2.702e-150
URI120H	contig_1	509067	513201	4134	renamed_GCF_000008685.2	chromosome	401677	397543	4134	100.0	0.0
URI120H	contig_1	513268	513643	375	renamed_GCF_000008685.2	chromosome	397476	397101	375	100.0	1.385e-81
URI120H	contig_1	536468	535091	1377	renamed_GCF_000008685.2	chromosome	374276	375653	1377	100.0	1.277e-310
URI120H	contig_1	536593	537178	585	renamed_GCF_000008685.2	chromosome	374151	373566	585	100.0	4.312e-129
URI120H	contig_1	537605	537224	381	renamed_GCF_000008685.2	chromosome	373139	373520	381	100.0	1.683e-80
URI120H	contig_1	539711	537698	2013	renamed_GCF_000008685.2	chromosome	371033	373046	2013	100.0	0.0
URI120H	contig_1	542289	541863	426	renamed_GCF_000008685.2	chromosome	368455	368881	426	100.0	3.899e-87
URI120H	contig_1	556108	557305	1197	renamed_GCF_000008685.2	chromosome	354636	353439	1197	100.0	5.312e-264
URI120H	contig_1	596621	598013	1392	renamed_GCF_000008685.2	chromosome	314123	312728	1392	100.0	1.047e-306
URI120H	contig_1	600222	600966	744	renamed_GCF_000008685.2	chromosome	310523	309779	744	100.0	5.245e-162
URI120H	contig_1	603428	604121	693	renamed_GCF_000008685.2	chromosome	307317	306624	693	100.0	2.971e-151
URI120H	contig_1	605625	606972	1347	renamed_GCF_000008685.2	chromosome	305120	303773	1347	100.0	1.016e-290
URI120H	contig_1	607436	607895	459	renamed_GCF_000008685.2	chromosome	303309	302850	459	100.0	4.601e-99
URI120H	contig_1	609981	611016	1035	renamed_GCF_000008685.2	chromosome	300764	299729	1035	100.0	3.255e-216
URI120H	contig_1	611969	613280	1311	renamed_GCF_000008685.2	chromosome	298776	297465	1311	100.0	6.981e-289
URI120H	contig_1	615517	615961	444	renamed_GCF_000008685.2	chromosome	295228	294784	444	100.0	1.185e-94
URI120H	contig_1	739495	739261	234	renamed_GCF_000008685.2	chromosome	171262	171484	234	98.6	1.134e-44
URI120H	contig_1	745925	747674	1749	renamed_GCF_000008685.2	chromosome	164820	163071	1749	100.0	0.0
URI120H	contig_1	847600	846718	882	renamed_GCF_000008685.2	chromosome	63146	64028	882	100.0	1.369e-191
URI120H	contig_1	868263	869304	1041	renamed_GCF_000008685.2	chromosome	42483	41442	1041	100.0	8.938e-232
URI120H	contig_1	871108	872611	1503	renamed_GCF_000008685.2	chromosome	39638	38135	1503	100.0	0.0
URI120H	contig_1	874910	876710	1800	renamed_GCF_000008685.2	chromosome	35836	34036	1800	100.0	0.0
URI120H	contig_2	17707	17431	276	renamed_GCF_000008685.2	lp54	35953	36229	276	100.0	3.31e-56
URI120H	contig_2	21400	20911	489	renamed_GCF_000008685.2	lp54	32260	32749	489	100.0	3.125e-108
URI120H	contig_2	23567	23027	540	renamed_GCF_000008685.2	lp54	30093	30633	540	100.0	4.969e-120
URI120H	contig_2	34936	33583	1353	renamed_GCF_000008685.2	lp54	18724	20077	1353	100.0	1.524e-304
URI120H	contig_2	38291	37859	432	renamed_GCF_000008685.2	lp54	15369	15801	432	99.3	1.792e-96
URI120H	contig_2	40666	40081	585	renamed_GCF_000008685.2	lp54	12994	13579	585	100.0	1.763e-130
URI120H	contig_3	15543	14976	567	renamed_GCF_000008685.2	lp56	35818	36385	567	100.0	4.74e-125
URI120H	contig_3	18905	17552	1353	renamed_GCF_000008685.2	lp56	32454	33807	1353	100.0	5.71e-307
URI120H	contig_3	20222	19649	573	renamed_GCF_000008685.2	lp56	31167	31710	573	100.0	2.482e-116
URI120H	contig_3	38850	37554	1296	renamed_GCF_000008685.2	lp56	12436	13732	1296	98.1	1.662e-276
URI120H	contig_3	39990	39561	429	renamed_GCF_000008685.2	lp56	11296	11725	429	100.0	5.601e-92
URI120H	contig_3	41116	40003	1113	renamed_GCF_000008685.2	lp56	10170	11283	1113	98.1	1.091e-241
URI120H	contig_10	439	10	429	renamed_GCF_000008685.2	cp32-9	17301	17730	429	100.0	2.284e-93
URI120H	contig_10	26610	26049	561	renamed_GCF_000008685.2	cp32-9	21613	22174	561	100.0	6.308e-121
URI120H	contig_10	27949	27382	567	renamed_GCF_000008685.2	cp32-9	20274	20841	567	100.0	1.456e-129
URI120H	contig_11	784	1897	1113	renamed_GCF_000008685.2	cp32-4	6710	7823	1113	100.0	1.393e-247
URI120H	contig_11	9447	9795	348	renamed_GCF_000008685.2	cp32-4	15373	15721	348	100.0	3.962e-74
URI120H	contig_11	10112	10466	354	renamed_GCF_000008685.2	cp32-4	16038	16392	354	100.0	6.554e-78
URI120H	contig_13	1419	1083	336	renamed_GCF_000008685.2	cp32-7	15765	16101	336	100.0	5.348e-69
URI120H	contig_13	1756	1399	357	renamed_GCF_000008685.2	cp32-7	15428	15785	357	99.1	1.866e-75
URI120H	contig_13	1963	1759	204	renamed_GCF_000008685.2	cp32-6	15230	15434	204	100.0	2.578e-39
URI120H	contig_13	3466	2860	606	renamed_GCF_000008685.2	lp56	17207	17813	606	100.0	5.47e-130
URI120H	contig_14	5570	5957	387	renamed_GCF_000008685.2	lp28-2	24108	23721	387	100.0	1.013e-78
URI120H	contig_14	6645	7020	375	renamed_GCF_000008685.2	lp28-2	23033	22658	375	100.0	2.05e-77
URI120H	contig_14	10851	11649	798	renamed_GCF_000008685.2	lp28-2	18827	18029	798	100.0	7.719e-184
URI120H	contig_14	11994	13185	1191	renamed_GCF_000008685.2	lp28-2	17684	16493	1191	100.0	6.781e-269
URI120H	contig_18	22723	21991	732	renamed_GCF_000008685.2	lp25	22677	21945	732	100.0	5.239e-160
URI120H	contig_19	3359	2843	516	renamed_GCF_000008685.2	lp28-1	2619	2097	516	100.0	2.617e-106
URI120H	contig_20	19931	19712	219	renamed_GCF_000008685.2	lp28-4	5127	5346	219	100.0	1.443e-47
URI120H	contig_21	8870	9533	663	renamed_GCF_000008685.2	lp17	11646	10983	663	100.0	1.005e-149
URI120H	contig_21	12250	11137	1113	renamed_GCF_000008685.2	lp17	8266	9379	1113	100.0	6.27e-248