QUERY_ID	QUERY_NAME	QUERY_START	QUERY_END	QUERY_LENGTH	REF_ID	REF_NAME	REF_START	REF_END	REF_LENGTH	IDENTITY	EVALUE
URI117H	contig_1	1010	170	840	renamed_GCF_000008685.2	chromosome	442552	441712	840	98.9	7.382e-183
URI117H	contig_1	6144	5427	717	renamed_GCF_000008685.2	chromosome	447736	446968	717	99.1	3.946e-152
URI117H	contig_1	7050	6660	390	renamed_GCF_000008685.2	chromosome	448591	448201	390	100.0	7.926e-82
URI117H	contig_1	7877	8630	753	renamed_GCF_000008685.2	chromosome	449418	450171	753	100.0	3.278e-160
URI117H	contig_1	12931	10498	2433	renamed_GCF_000008685.2	chromosome	454472	452039	2433	100.0	0.0
URI117H	contig_1	15034	16495	1461	renamed_GCF_000008685.2	chromosome	456575	458036	1461	99.5	0.0
URI117H	contig_1	16735	17893	1158	renamed_GCF_000008685.2	chromosome	458276	459434	1158	99.7	1.225e-256
URI117H	contig_1	18374	18530	156	renamed_GCF_000008685.2	chromosome	459915	460071	156	100.0	2.965e-30
URI117H	contig_1	21277	22345	1068	renamed_GCF_000008685.2	chromosome	462818	463886	1068	99.7	9.979e-244
URI117H	contig_2	137725	138157	432	renamed_GCF_000008685.2	chromosome	297469	297037	432	99.3	2.176e-94
URI117H	contig_2	138149	138767	618	renamed_GCF_000008685.2	chromosome	297045	296427	618	99.5	5.47e-132
URI117H	contig_2	138774	139953	1179	renamed_GCF_000008685.2	chromosome	296420	295241	1179	98.9	2.863e-259
URI117H	contig_2	139966	140410	444	renamed_GCF_000008685.2	chromosome	295228	294784	444	98.6	1.306e-93
URI117H	contig_2	140414	141743	1329	renamed_GCF_000008685.2	chromosome	294780	293451	1329	99.5	2.627e-294
URI117H	contig_2	141764	141989	225	renamed_GCF_000008685.2	chromosome	293429	293204	225	100.0	8.8e-46
URI117H	contig_2	141985	142768	783	renamed_GCF_000008685.2	chromosome	293208	292425	783	99.6	6.057e-167
URI117H	contig_2	142767	143550	783	renamed_GCF_000008685.2	chromosome	292426	291643	783	100.0	1.874e-171
URI117H	contig_2	162522	164715	2193	renamed_GCF_000008685.2	chromosome	272641	270487	2193	99.8	0.0
URI117H	contig_2	164729	165530	801	renamed_GCF_000008685.2	chromosome	270473	269672	801	99.6	3.29e-168
URI117H	contig_2	214473	213564	909	renamed_GCF_000008685.2	chromosome	220728	221637	909	99.3	4.638e-191
URI117H	contig_2	215402	214562	840	renamed_GCF_000008685.2	chromosome	219799	220639	840	100.0	1.641e-182
URI117H	contig_2	215567	216146	579	renamed_GCF_000008685.2	chromosome	219634	219055	579	100.0	8.388e-121
URI117H	contig_2	216123	216777	654	renamed_GCF_000008685.2	chromosome	219078	218424	654	100.0	1.052e-147
URI117H	contig_2	217921	216889	1032	renamed_GCF_000008685.2	chromosome	217277	218312	1032	99.1	2.355e-219
URI117H	contig_2	219775	217942	1833	renamed_GCF_000008685.2	chromosome	215426	217259	1833	99.6	0.0
URI117H	contig_2	223739	222971	768	renamed_GCF_000008685.2	chromosome	211300	212068	768	100.0	8.822e-169
URI117H	contig_2	239347	237343	2004	renamed_GCF_000008685.2	chromosome	195692	197696	2004	99.7	0.0
URI117H	contig_2	240164	239303	861	renamed_GCF_000008685.2	chromosome	194875	195736	861	98.9	3.489e-186
URI117H	contig_2	290857	292093	1236	renamed_GCF_000008685.2	chromosome	144230	142943	1236	99.5	6.15e-269
URI117H	contig_2	292104	293058	954	renamed_GCF_000008685.2	chromosome	142932	141978	954	99.0	1.826e-200
URI117H	contig_2	296293	296605	312	renamed_GCF_000008685.2	chromosome	138745	138433	312	99.0	2.189e-66
URI117H	contig_2	297268	299161	1893	renamed_GCF_000008685.2	chromosome	137766	135873	1893	99.6	0.0
URI117H	contig_2	301060	299170	1890	renamed_GCF_000008685.2	chromosome	133974	135864	1890	99.2	0.0
URI117H	contig_2	301192	302563	1371	renamed_GCF_000008685.2	chromosome	133842	132471	1371	100.0	2.422e-302
URI117H	contig_2	303737	302609	1128	renamed_GCF_000008685.2	chromosome	131297	132425	1128	99.4	1.93e-246
URI117H	contig_2	303920	304865	945	renamed_GCF_000008685.2	chromosome	131114	130169	945	100.0	6.888e-210
URI117H	contig_2	315230	316070	840	renamed_GCF_000008685.2	chromosome	119803	118963	840	97.1	3.15e-175
URI117H	contig_2	316104	316659	555	renamed_GCF_000008685.2	chromosome	118929	118374	555	99.4	3.776e-117
URI117H	contig_2	316663	317356	693	renamed_GCF_000008685.2	chromosome	118370	117677	693	98.2	1.337e-151
URI117H	contig_2	318227	319529	1302	renamed_GCF_000008685.2	chromosome	116806	115504	1302	98.3	5.194e-282
URI117H	contig_2	320227	319525	702	renamed_GCF_000008685.2	chromosome	114806	115508	702	100.0	2.35e-155
URI117H	contig_2	320430	322125	1695	renamed_GCF_000008685.2	chromosome	114603	112908	1695	100.0	0.0
URI117H	contig_2	322264	322684	420	renamed_GCF_000008685.2	chromosome	112769	112349	420	99.2	1.444e-88
URI117H	contig_2	322695	323145	450	renamed_GCF_000008685.2	chromosome	112338	111888	450	99.3	9.762e-98
URI117H	contig_2	323158	323449	291	renamed_GCF_000008685.2	chromosome	111875	111584	291	100.0	1.894e-64
URI117H	contig_2	334805	334283	522	renamed_GCF_000008685.2	chromosome	100227	100749	522	100.0	2.976e-114
URI117H	contig_2	336216	334827	1389	renamed_GCF_000008685.2	chromosome	98816	100205	1389	99.5	1.169e-313
URI117H	contig_2	336251	337169	918	renamed_GCF_000008685.2	chromosome	98648	97862	918	99.2	2.343e-174
URI117H	contig_2	337165	338089	924	renamed_GCF_000008685.2	chromosome	97866	96942	924	99.3	8.657e-204
URI117H	contig_2	338078	340421	2343	renamed_GCF_000008685.2	chromosome	96953	94610	2343	98.8	0.0
URI117H	contig_2	340426	340813	387	renamed_GCF_000008685.2	chromosome	94605	94218	387	100.0	1.031e-86
URI117H	contig_2	340999	341599	600	renamed_GCF_000008685.2	chromosome	94032	93432	600	100.0	1.47e-126
URI117H	contig_2	341608	342154	546	renamed_GCF_000008685.2	chromosome	93423	92877	546	97.7	1.472e-117
URI117H	contig_2	343917	345222	1305	renamed_GCF_000008685.2	chromosome	91115	89810	1305	100.0	2.863e-289
URI117H	contig_2	356023	357322	1299	renamed_GCF_000008685.2	chromosome	79009	77710	1299	99.7	4.127e-284
URI117H	contig_2	358582	357331	1251	renamed_GCF_000008685.2	chromosome	76450	77701	1251	99.7	8.508e-268
URI117H	contig_2	359259	358578	681	renamed_GCF_000008685.2	chromosome	75773	76454	681	100.0	3.584e-147
URI117H	contig_2	362385	361539	846	renamed_GCF_000008685.2	chromosome	72646	73492	846	99.2	6.38e-177
URI117H	contig_2	363831	362421	1410	renamed_GCF_000008685.2	chromosome	71200	72610	1410	99.5	1.263e-307
URI117H	contig_2	364859	363812	1047	renamed_GCF_000008685.2	chromosome	70141	71219	1047	99.7	6.395e-228
URI117H	contig_2	365466	364905	561	renamed_GCF_000008685.2	chromosome	69565	70126	561	100.0	3.775e-118
URI117H	contig_2	367787	365462	2325	renamed_GCF_000008685.2	chromosome	67247	69569	2325	99.4	0.0
URI117H	contig_2	387128	386426	702	renamed_GCF_000008685.2	chromosome	47916	48606	702	99.1	1.109e-146
URI117H	contig_2	387866	387191	675	renamed_GCF_000008685.2	chromosome	47166	47841	675	98.6	2.138e-143
URI117H	contig_2	388653	389022	369	renamed_GCF_000008685.2	chromosome	46379	46010	369	100.0	3.085e-80
URI117H	contig_2	389587	389041	546	renamed_GCF_000008685.2	chromosome	45445	45991	546	100.0	3.273e-117
URI117H	contig_2	389678	392126	2448	renamed_GCF_000008685.2	chromosome	45354	42906	2448	99.7	0.0
URI117H	contig_2	392151	392553	402	renamed_GCF_000008685.2	chromosome	42881	42479	402	100.0	2.405e-88
URI117H	contig_2	392549	393590	1041	renamed_GCF_000008685.2	chromosome	42483	41442	1041	99.4	2.178e-230
URI117H	contig_2	393600	394272	672	renamed_GCF_000008685.2	chromosome	41432	40760	672	100.0	1.856e-144
URI117H	contig_2	395207	394355	852	renamed_GCF_000008685.2	chromosome	39825	40677	852	99.6	5.092e-189
URI117H	contig_2	395394	396897	1503	renamed_GCF_000008685.2	chromosome	39638	38135	1503	99.8	0.0
URI117H	contig_3	2884	3793	909	renamed_GCF_000008685.2	lp54	43532	42623	909	99.6	5.38e-198
URI117H	contig_3	4150	3943	207	renamed_GCF_000008685.2	lp54	42266	42473	207	100.0	9.856e-42
URI117H	contig_3	4397	5021	624	renamed_GCF_000008685.2	lp54	42019	41395	624	100.0	3.1e-139
URI117H	contig_3	5371	6205	834	renamed_GCF_000008685.2	lp54	41045	40211	834	98.9	1.8e-180
URI117H	contig_3	6304	6544	240	renamed_GCF_000008685.2	lp54	40112	39872	240	100.0	3.722e-49
URI117H	contig_3	7013	8258	1245	renamed_GCF_000008685.2	lp54	39405	38160	1245	98.5	3.184e-269
URI117H	contig_3	10151	9884	267	renamed_GCF_000008685.2	lp54	36255	36534	267	96.5	1.736e-53
URI117H	contig_3	10465	10189	276	renamed_GCF_000008685.2	lp54	35953	36229	276	100.0	3.31e-56
URI117H	contig_3	36166	35275	891	renamed_GCF_000008685.2	lp54	10287	11178	891	99.6	2.083e-188
URI117H	contig_3	36997	36175	822	renamed_GCF_000008685.2	lp54	9456	10278	822	99.6	1.415e-172
URI117H	contig_3	38012	37586	426	renamed_GCF_000008685.2	lp54	8441	8867	426	100.0	3.21e-89
URI117H	contig_3	38188	38008	180	renamed_GCF_000008685.2	lp54	8265	8445	180	100.0	1.452e-33
URI117H	contig_3	39245	38210	1035	renamed_GCF_000008685.2	lp54	7208	8243	1035	100.0	8.138e-232
URI117H	contig_3	39933	39306	627	renamed_GCF_000008685.2	lp54	6520	7147	627	99.0	1.16e-133
URI117H	contig_3	40808	39935	873	renamed_GCF_000008685.2	lp54	5645	6518	873	99.3	2.643e-191
URI117H	contig_4	2286	3597	1311	renamed_GCF_000008685.2	cp32-7	8969	10304	1311	81.0	4.301e-233
URI117H	contig_4	3609	4251	642	renamed_GCF_000008685.2	cp32-7	10316	10958	642	94.8	1.615e-132
URI117H	contig_5	6676	5734	942	renamed_GCF_000008685.2	cp32-7	10961	11903	942	97.7	3.561e-208
URI117H	contig_5	15089	14324	765	renamed_GCF_000008685.2	cp32-7	2573	3338	765	99.2	3.139e-171
URI117H	contig_5	15653	15095	558	renamed_GCF_000008685.2	cp32-7	2009	2567	558	100.0	1.105e-122
URI117H	contig_5	16358	15665	693	renamed_GCF_000008685.2	cp32-1	1305	1998	693	100.0	2.582e-144
URI117H	contig_5	17598	16374	1224	renamed_GCF_000008685.2	cp32-6	65	1289	1224	100.0	2.096e-270
URI117H	contig_5	19016	17663	1353	renamed_GCF_000008685.2	cp32-6	28485	29838	1353	99.7	1.39e-305
URI117H	contig_5	19579	19012	567	renamed_GCF_000008685.2	cp32-3	28235	28874	567	93.6	2.483e-115
URI117H	contig_5	21115	20605	510	renamed_GCF_000008685.2	cp32-3	27409	27919	510	96.4	1.177e-105
URI117H	contig_5	21850	21226	624	renamed_GCF_000008685.2	cp32-3	26707	27298	624	54.2	6.274e-63
URI117H	contig_5	22280	23057	777	renamed_GCF_000008685.2	cp32-7	25720	24943	777	100.0	1.414e-173
URI117H	contig_6	4174	3367	807	renamed_GCF_000008685.2	lp56	2743	3496	807	56.1	5.821e-84
URI117H	contig_6	21058	21796	738	renamed_GCF_000008685.2	lp38	11889	11151	738	91.8	4.993e-153
URI117H	contig_6	21841	22435	594	renamed_GCF_000008685.2	lp38	11105	10517	594	89.3	1.877e-114
URI117H	contig_7	4927	5764	837	renamed_GCF_000008685.2	lp28-4	22931	22094	837	98.9	7.731e-182
URI117H	contig_7	6296	7049	753	renamed_GCF_000008685.2	lp28-4	21562	20770	753	98.3	1.223e-162
URI117H	contig_7	8675	9341	666	renamed_GCF_000008685.2	lp28-4	19183	18517	666	99.5	1.537e-145
URI117H	contig_7	12501	11322	1179	renamed_GCF_000008685.2	lp28-4	15351	16530	1179	99.2	5.451e-252
URI117H	contig_7	14591	14018	573	renamed_GCF_000008685.2	lp28-4	13264	13837	573	100.0	2.579e-124
URI117H	contig_7	15402	14649	753	renamed_GCF_000008685.2	lp28-4	12453	13206	753	100.0	4.561e-165
URI117H	contig_8	18723	18087	636	renamed_GCF_000008685.2	cp26	16902	17535	636	78.1	2.717e-100
URI117H	contig_8	18954	20493	1539	renamed_GCF_000008685.2	cp26	16667	15131	1539	98.0	0.0
URI117H	contig_8	20517	21732	1215	renamed_GCF_000008685.2	cp26	15107	13892	1215	97.7	4.167e-261
URI117H	contig_8	23611	22018	1593	renamed_GCF_000008685.2	cp26	12013	13606	1593	99.4	0.0
URI117H	contig_8	24206	24704	498	renamed_GCF_000008685.2	cp26	11417	10919	498	98.1	4.372e-106
URI117H	contig_8	25523	24974	549	renamed_GCF_000008685.2	cp26	10103	10652	549	99.4	1.544e-117
URI117H	contig_8	26352	25590	762	renamed_GCF_000008685.2	cp26	9274	10036	762	98.8	5.77e-164
URI117H	contig_9	743	1610	867	renamed_GCF_000008685.2	lp28-3	26371	25432	867	99.6	1.571e-187
URI117H	contig_9	4364	4088	276	renamed_GCF_000008685.2	lp28-3	22677	22953	276	100.0	6.026e-58
URI117H	contig_9	5574	4824	750	renamed_GCF_000008685.2	lp28-3	21469	22219	750	100.0	6.33e-161
URI117H	contig_10	7433	7004	429	renamed_GCF_000008685.2	lp28-2	11491	11062	429	99.2	1.514e-89
URI117H	contig_10	8261	7442	819	renamed_GCF_000008685.2	lp28-2	12319	11500	819	100.0	1.075e-183
URI117H	contig_10	8694	8250	444	renamed_GCF_000008685.2	lp28-2	12752	12308	444	100.0	8.866e-98
URI117H	contig_10	9083	8690	393	renamed_GCF_000008685.2	lp28-2	13141	12748	393	99.2	3.389e-83
URI117H	contig_10	9437	9098	339	renamed_GCF_000008685.2	lp28-2	13495	13156	339	96.4	2.068e-71
URI117H	contig_10	10283	9449	834	renamed_GCF_000008685.2	lp28-2	14341	13507	834	97.1	3.643e-181
URI117H	contig_10	10828	10318	510	renamed_GCF_000008685.2	lp28-2	14885	14375	510	97.6	2.379e-106
URI117H	contig_10	11374	10828	546	renamed_GCF_000008685.2	lp28-2	15431	14885	546	99.4	4.794e-113
URI117H	contig_10	12425	11399	1026	renamed_GCF_000008685.2	lp28-2	16482	15456	1026	99.4	8.508e-230
URI117H	contig_10	13627	12436	1191	renamed_GCF_000008685.2	lp28-2	17684	16493	1191	99.7	6.781e-269
URI117H	contig_10	13962	13623	339	renamed_GCF_000008685.2	lp28-2	18019	17680	339	100.0	5.085e-70
URI117H	contig_10	14770	13972	798	renamed_GCF_000008685.2	lp28-2	18827	18029	798	93.2	2.604e-170
URI117H	contig_10	15562	14779	783	renamed_GCF_000008685.2	lp28-2	19619	18836	783	92.3	1.226e-167
URI117H	contig_10	18244	15562	2682	renamed_GCF_000008685.2	lp28-2	22259	19619	2682	97.9	0.0
URI117H	contig_12	11970	11043	927	renamed_GCF_000008685.2	lp36	15760	14833	927	99.6	1.39e-207
URI117H	contig_12	12483	13095	612	renamed_GCF_000008685.2	lp36	16274	16886	612	100.0	9.153e-134
URI117H	contig_12	14383	15475	1092	renamed_GCF_000008685.2	lp36	20388	21453	1092	96.9	5.792e-228
URI117H	contig_12	15720	15915	195	renamed_GCF_000008685.2	lp36	21719	21893	195	96.4	2.085e-32
URI117H	contig_12	15933	16155	222	renamed_GCF_000008685.2	lp36	21911	22133	222	100.0	1.866e-45
URI117H	contig_12	16316	16490	174	renamed_GCF_000008685.2	lp36	22293	22467	174	92.9	1.178e-34
URI117H	contig_12	17121	17415	294	renamed_GCF_000008685.2	lp28-1	10895	10697	294	98.4	2.041e-40
URI117H	contig_13	10035	10485	450	renamed_GCF_000008685.2	cp32-1	17231	17678	450	87.0	6.936e-85
URI117H	contig_14	15199	14443	756	renamed_GCF_000008685.2	cp32-9	20816	21572	756	99.6	4.781e-165
URI117H	contig_14	15741	15174	567	renamed_GCF_000008685.2	cp32-9	20274	20841	567	98.4	1.762e-127
URI117H	contig_14	16849	15751	1098	renamed_GCF_000008685.2	cp32-7	19116	20214	1098	96.7	7.872e-243
URI117H	contig_14	19533	19065	468	renamed_GCF_000008685.2	cp32-4	16496	16997	468	91.5	4.26e-93
URI117H	contig_14	19991	19637	354	renamed_GCF_000008685.2	cp32-6	16102	16456	354	100.0	1.459e-77
URI117H	contig_15	12097	10984	1113	renamed_GCF_000008685.2	lp17	8266	9379	1113	93.7	5.062e-233
URI117H	contig_15	12579	12252	327	renamed_GCF_000008685.2	lp17	7784	8111	327	99.0	2.291e-68
URI117H	contig_21	2840	1949	891	renamed_GCF_000008685.2	lp54	51176	50285	891	98.9	4.455e-197
URI117H	contig_21	3369	4143	774	renamed_GCF_000008685.2	lp54	51705	52479	774	100.0	9.219e-161
URI117H	contig_21	4369	5167	798	renamed_GCF_000008685.2	lp54	52705	53503	798	99.2	6.687e-177
URI117H	contig_22	37	700	663	renamed_GCF_000008685.2	cp32-3	21256	21997	663	99.5	3.258e-145
URI117H	contig_22	740	1283	543	renamed_GCF_000008685.2	cp32-1	21560	22118	543	64.0	6.304e-76
URI117H	contig_22	1295	1832	537	renamed_GCF_000008685.2	cp32-3	22592	23183	537	90.3	2.263e-111
URI117H	contig_22	3702	4128	426	renamed_GCF_000008685.2	cp32-3	25068	25494	426	97.8	1.975e-94
URI117H	contig_25	2766	3051	285	renamed_GCF_000008685.2	lp21	16548	16227	285	98.9	2.097e-62
URI117H	contig_25	3488	3194	294	renamed_GCF_000008685.2	lp21	15790	16084	294	100.0	2.432e-62
URI117H	contig_43	324	678	354	renamed_GCF_000008685.2	lp5	743	1097	354	99.1	7.983e-76
URI117H	contig_49	760	4	756	renamed_GCF_000008685.2	lp54	47228	46472	756	98.0	2.849e-162
URI117H	contig_61	4	388	384	renamed_GCF_000008685.2	cp32-9	5412	5796	384	100.0	2.931e-83
URI117H	contig_1	71680	72982	1302	renamed_GCF_000008685.2	chromosome	513225	514527	1302	99.3	1.946e-284
URI117H	contig_1	72978	74238	1260	renamed_GCF_000008685.2	chromosome	514523	515783	1260	98.3	1.758e-278
URI117H	contig_1	74940	81441	6501	renamed_GCF_000008685.2	chromosome	516492	522993	6501	99.3	0.0
URI117H	contig_1	83001	84702	1701	renamed_GCF_000008685.2	chromosome	524553	526254	1701	99.1	0.0
URI117H	contig_1	124343	126197	1854	renamed_GCF_000008685.2	chromosome	565954	567823	1854	99.6	0.0
URI117H	contig_1	126183	126651	468	renamed_GCF_000008685.2	chromosome	567809	568277	468	100.0	1.969e-101
URI117H	contig_1	126643	127513	870	renamed_GCF_000008685.2	chromosome	568269	569139	870	100.0	1.737e-195
URI117H	contig_1	127650	127911	261	renamed_GCF_000008685.2	chromosome	569277	569538	261	100.0	9.575e-51
URI117H	contig_1	127931	129653	1722	renamed_GCF_000008685.2	chromosome	569558	571280	1722	99.8	0.0
URI117H	contig_1	129655	130225	570	renamed_GCF_000008685.2	chromosome	571282	571852	570	100.0	1.471e-121
URI117H	contig_1	132113	130262	1851	renamed_GCF_000008685.2	chromosome	573740	571889	1851	100.0	0.0
URI117H	contig_1	143252	142562	690	renamed_GCF_000008685.2	chromosome	584880	584190	690	99.1	4.749e-154
URI117H	contig_1	143463	144528	1065	renamed_GCF_000008685.2	chromosome	585079	586156	1065	98.0	9.851e-235
URI117H	contig_1	170414	172352	1938	renamed_GCF_000008685.2	chromosome	612047	613985	1938	99.8	0.0
URI117H	contig_1	174138	172380	1758	renamed_GCF_000008685.2	chromosome	615771	614013	1758	98.9	0.0
URI117H	contig_1	174757	174130	627	renamed_GCF_000008685.2	chromosome	616390	615763	627	99.0	1.402e-131
URI117H	contig_1	176926	174778	2148	renamed_GCF_000008685.2	chromosome	618559	616411	2148	99.8	0.0
URI117H	contig_1	177194	179402	2208	renamed_GCF_000008685.2	chromosome	618827	621035	2208	99.8	0.0
URI117H	contig_1	180320	179411	909	renamed_GCF_000008685.2	chromosome	621953	621044	909	99.0	1.832e-201
URI117H	contig_1	180371	181814	1443	renamed_GCF_000008685.2	chromosome	622004	623447	1443	99.1	0.0
URI117H	contig_1	181817	183374	1557	renamed_GCF_000008685.2	chromosome	623450	625007	1557	98.6	0.0
URI117H	contig_1	196945	198238	1293	renamed_GCF_000008685.2	chromosome	638579	639872	1293	99.5	1.544e-285
URI117H	contig_1	198206	200615	2409	renamed_GCF_000008685.2	chromosome	639858	642249	2409	99.4	0.0
URI117H	contig_1	241783	243328	1545	renamed_GCF_000008685.2	chromosome	683422	684967	1545	99.8	0.0
URI117H	contig_1	244342	243358	984	renamed_GCF_000008685.2	chromosome	685980	684996	984	99.3	1.874e-222
URI117H	contig_1	244869	244338	531	renamed_GCF_000008685.2	chromosome	686507	685976	531	100.0	1.053e-118
URI117H	contig_1	246851	248489	1638	renamed_GCF_000008685.2	chromosome	688489	690127	1638	100.0	0.0
URI117H	contig_1	248554	248851	297	renamed_GCF_000008685.2	chromosome	690192	690489	297	100.0	1.037e-63
URI117H	contig_1	248864	249161	297	renamed_GCF_000008685.2	chromosome	690481	690799	297	98.9	6.955e-60
URI117H	contig_1	249246	251007	1761	renamed_GCF_000008685.2	chromosome	690884	692645	1761	99.4	0.0
URI117H	contig_1	250990	251890	900	renamed_GCF_000008685.2	chromosome	692628	693528	900	99.6	4.423e-190
URI117H	contig_1	251915	253058	1143	renamed_GCF_000008685.2	chromosome	693553	694696	1143	100.0	3.979e-258
URI117H	contig_1	284832	286101	1269	renamed_GCF_000008685.2	chromosome	726457	727753	1269	97.1	1.579e-272
URI117H	contig_1	286084	287023	939	renamed_GCF_000008685.2	chromosome	727736	728675	939	100.0	1.678e-207
URI117H	contig_1	287013	287967	954	renamed_GCF_000008685.2	chromosome	728665	729619	954	98.7	7.929e-210
URI117H	contig_1	287960	288854	894	renamed_GCF_000008685.2	chromosome	729612	730506	894	98.9	3.048e-193
URI117H	contig_1	289447	288979	468	renamed_GCF_000008685.2	chromosome	731099	730631	468	98.0	1.073e-99
URI117H	contig_1	289531	290068	537	renamed_GCF_000008685.2	chromosome	731183	731720	537	100.0	1.936e-121
URI117H	contig_1	292427	293636	1209	renamed_GCF_000008685.2	chromosome	734080	735289	1209	100.0	8.188e-270
URI117H	contig_1	299034	299772	738	renamed_GCF_000008685.2	chromosome	740687	741425	738	100.0	4.772e-162
URI117H	contig_1	301090	302863	1773	renamed_GCF_000008685.2	chromosome	742743	744516	1773	99.3	0.0
URI117H	contig_1	303648	304680	1032	renamed_GCF_000008685.2	chromosome	745301	746333	1032	98.8	6.089e-226
URI117H	contig_1	357305	356345	960	renamed_GCF_000008685.2	chromosome	799016	798056	960	99.6	2.967e-213
URI117H	contig_1	358764	359361	597	renamed_GCF_000008685.2	chromosome	800475	801072	597	99.4	1.402e-126
URI117H	contig_1	371529	370728	801	renamed_GCF_000008685.2	chromosome	813239	812438	801	100.0	9.279e-174
URI117H	contig_1	373017	372009	1008	renamed_GCF_000008685.2	chromosome	814697	813689	1008	99.4	2.823e-213
URI117H	contig_1	374619	373821	798	renamed_GCF_000008685.2	chromosome	816299	815501	798	100.0	1.968e-173
URI117H	contig_1	375715	376276	561	renamed_GCF_000008685.2	chromosome	817395	817956	561	100.0	3.237e-128
URI117H	contig_1	376924	377236	312	renamed_GCF_000008685.2	chromosome	818604	818916	312	100.0	1.086e-65
URI117H	contig_1	377561	377807	246	renamed_GCF_000008685.2	chromosome	819241	819487	246	100.0	8.275e-50
URI117H	contig_1	377861	378848	987	renamed_GCF_000008685.2	chromosome	819541	820528	987	100.0	5.255e-220
URI117H	contig_1	446474	444761	1713	renamed_GCF_000008685.2	chromosome	888179	886469	1713	99.1	0.0
URI117H	contig_1	451423	454864	3441	renamed_GCF_000008685.2	chromosome	893128	896569	3441	98.4	0.0
URI117H	contig_2	6534	5505	1029	renamed_GCF_000008685.2	chromosome	428645	429674	1029	99.1	2.098e-237
URI117H	contig_2	8444	7229	1215	renamed_GCF_000008685.2	chromosome	426735	427950	1215	99.7	1.711e-262
URI117H	contig_2	27899	28331	432	renamed_GCF_000008685.2	chromosome	407292	406860	432	99.3	1.75e-88
URI117H	contig_2	29015	29504	489	renamed_GCF_000008685.2	chromosome	406176	405687	489	99.3	6.125e-101
URI117H	contig_2	33514	37648	4134	renamed_GCF_000008685.2	chromosome	401677	397543	4134	99.7	0.0
URI117H	contig_2	38685	39711	1026	renamed_GCF_000008685.2	chromosome	396506	395480	1026	100.0	3.003e-224
URI117H	contig_2	41130	42150	1020	renamed_GCF_000008685.2	chromosome	394063	393043	1020	100.0	6.665e-223
URI117H	contig_2	117188	117947	759	renamed_GCF_000008685.2	chromosome	318005	317246	759	100.0	1.223e-163
URI117H	contig_2	119050	119887	837	renamed_GCF_000008685.2	chromosome	316143	315306	837	99.6	1.426e-183
URI117H	contig_2	120766	121048	282	renamed_GCF_000008685.2	chromosome	314427	314145	282	100.0	2.699e-59
URI117H	contig_2	121070	122462	1392	renamed_GCF_000008685.2	chromosome	314123	312728	1392	100.0	1.047e-306
URI117H	contig_2	123541	124636	1095	renamed_GCF_000008685.2	chromosome	311617	310558	1095	99.4	1.229e-228
URI117H	contig_2	143598	144135	537	renamed_GCF_000008685.2	chromosome	291595	291058	537	100.0	7.638e-115
URI117H	contig_2	145276	145618	342	renamed_GCF_000008685.2	chromosome	289917	289575	342	100.0	1.077e-70
URI117H	contig_2	146247	147012	765	renamed_GCF_000008685.2	chromosome	288946	288181	765	100.0	2.478e-165
URI117H	contig_2	147316	148105	789	renamed_GCF_000008685.2	chromosome	287877	287088	789	100.0	1.783e-164
URI117H	contig_2	149234	151325	2091	renamed_GCF_000008685.2	chromosome	285962	283868	2091	99.4	0.0
URI117H	contig_2	202864	199948	2916	renamed_GCF_000008685.2	chromosome	232337	235253	2916	99.8	0.0
URI117H	contig_2	203710	204988	1278	renamed_GCF_000008685.2	chromosome	231491	230213	1278	99.7	4.58e-288
URI117H	contig_2	206680	207388	708	renamed_GCF_000008685.2	chromosome	228521	227813	708	100.0	8.763e-159
URI117H	contig_2	208591	210376	1785	renamed_GCF_000008685.2	chromosome	226610	224825	1785	99.4	0.0
URI117H	contig_2	210416	211238	822	renamed_GCF_000008685.2	chromosome	224785	223963	822	100.0	3.638e-179
URI117H	contig_2	226419	226956	537	renamed_GCF_000008685.2	chromosome	208581	208083	537	98.7	3.647e-106
URI117H	contig_2	229967	228995	972	renamed_GCF_000008685.2	chromosome	205174	206044	972	99.6	3.289e-188
URI117H	contig_2	232190	230951	1239	renamed_GCF_000008685.2	chromosome	202849	204088	1239	100.0	5.514e-262
URI117H	contig_2	263942	264320	378	renamed_GCF_000008685.2	chromosome	171097	170719	378	98.4	1.768e-79
URI117H	contig_2	265640	267161	1521	renamed_GCF_000008685.2	chromosome	169399	167878	1521	99.4	0.0
URI117H	contig_2	269152	270139	987	renamed_GCF_000008685.2	chromosome	165887	164900	987	99.6	2.948e-209
URI117H	contig_2	272238	273840	1602	renamed_GCF_000008685.2	chromosome	162801	161199	1602	99.8	0.0
URI117H	contig_2	275672	274997	675	renamed_GCF_000008685.2	chromosome	159367	160042	675	98.6	4.754e-143
URI117H	contig_2	276982	276565	417	renamed_GCF_000008685.2	chromosome	158075	158474	417	100.0	2.72e-81
URI117H	contig_2	278578	277441	1137	renamed_GCF_000008685.2	chromosome	156461	157598	1137	100.0	1.164e-253
URI117H	contig_2	281354	281966	612	renamed_GCF_000008685.2	chromosome	153686	153074	612	100.0	4.712e-141
URI117H	contig_2	282835	282028	807	renamed_GCF_000008685.2	chromosome	152205	153012	807	100.0	9.769e-183
URI117H	contig_4	15412	16168	756	renamed_GCF_000008685.2	cp32-6	22101	22770	756	71.3	8.654e-107
URI117H	contig_4	26679	27447	768	renamed_GCF_000008685.2	cp32-6	2576	3344	768	98.8	8.033e-170
URI117H	contig_4	29506	29890	384	renamed_GCF_000008685.2	cp32-6	5403	5787	384	100.0	2.931e-83
URI117H	contig_4	29877	30267	390	renamed_GCF_000008685.2	cp32-6	5774	6164	390	98.4	7.187e-83
URI117H	contig_5	1537	1183	354	renamed_GCF_000008685.2	cp32-3	16083	16437	354	100.0	1.459e-77
URI117H	contig_5	9391	8935	456	renamed_GCF_000008685.2	cp32-7	8273	8729	456	97.3	4.83e-98
URI117H	contig_5	10963	9850	1113	renamed_GCF_000008685.2	cp32-4	6710	7823	1113	97.5	5.383e-241
URI117H	contig_5	11896	11506	390	renamed_GCF_000008685.2	cp32-9	5783	6173	390	100.0	3.229e-83
URI117H	contig_6	20495	21086	591	renamed_GCF_000008685.2	lp38	12452	11861	591	89.6	1.347e-117
URI117H	contig_7	17035	15928	1107	renamed_GCF_000008685.2	lp28-4	10814	11927	1107	98.9	2.343e-249
URI117H	contig_7	20614	19312	1302	renamed_GCF_000008685.2	lp28-4	7182	8538	1302	96.0	2.563e-281
URI117H	contig_7	22694	22475	219	renamed_GCF_000008685.2	lp28-4	5127	5346	219	100.0	1.443e-47
URI117H	contig_7	25287	24471	816	renamed_GCF_000008685.2	lp28-4	2535	3351	816	100.0	8.08e-178
URI117H	contig_8	2436	1398	1038	renamed_GCF_000008685.2	cp26	6676	7714	1038	99.4	4.211e-231
URI117H	contig_8	4344	3246	1098	renamed_GCF_000008685.2	cp26	4768	5866	1098	100.0	2.035e-249
URI117H	contig_10	18642	18255	387	renamed_GCF_000008685.2	lp28-2	22659	22272	387	72.6	4.416e-63
URI117H	contig_10	19708	19015	693	renamed_GCF_000008685.2	lp28-2	23725	23032	693	83.4	3.937e-131
URI117H	contig_10	20483	21941	1458	renamed_GCF_000008685.2	lp28-2	24488	25955	1458	64.8	1.197e-200
URI117H	contig_10	22509	23046	537	renamed_GCF_000008685.2	lp28-2	26569	27085	537	52.2	3.419e-56
URI117H	contig_12	2246	1493	753	renamed_GCF_000008685.2	lp36	6040	5287	753	99.6	3.6e-159
URI117H	contig_12	5068	4372	696	renamed_GCF_000008685.2	lp36	8859	8163	696	97.8	8.359e-149
URI117H	contig_13	9354	9930	576	renamed_GCF_000008685.2	cp32-7	16551	17139	576	91.2	4.184e-111
URI117H	contig_14	2087	1208	879	renamed_GCF_000008685.2	cp32-7	12831	13710	879	96.5	4.623e-186
URI117H	contig_14	3000	2445	555	renamed_GCF_000008685.2	cp32-6	11929	12484	555	98.3	1.698e-117
URI117H	contig_14	3968	3017	951	renamed_GCF_000008685.2	cp32-6	10961	11912	951	99.0	1.16e-213
URI117H	contig_14	20863	20659	204	renamed_GCF_000008685.2	cp32-1	15214	15418	204	100.0	2.578e-39
URI117H	contig_15	4376	4607	231	renamed_GCF_000008685.2	lp17	16119	15888	231	98.6	8.774e-47
URI117H	contig_15	6423	6153	270	renamed_GCF_000008685.2	lp17	14069	14339	270	100.0	1.489e-55
URI117H	contig_20	568	1075	507	renamed_GCF_000008685.2	lp25	10694	10199	507	96.3	1.122e-105
URI117H	contig_20	1087	1708	621	renamed_GCF_000008685.2	lp25	10187	9566	621	99.0	3.249e-138
URI117H	contig_20	3851	4370	519	renamed_GCF_000008685.2	lp28-4	26359	26914	519	91.3	2.191e-100
URI117H	contig_21	882	90	792	renamed_GCF_000008685.2	lp54	48267	47475	792	99.2	5.269e-170
URI117H	contig_30	15	579	564	renamed_GCF_000008685.2	cp32-6	2009	2573	564	99.4	1.105e-123
URI117H	contig_31	34	904	870	renamed_GCF_000008685.2	lp28-2	1046	1928	870	97.5	3.038e-189
URI117H	contig_31	1079	1583	504	renamed_GCF_000008685.2	lp56	3622	4108	504	93.0	3.962e-83
URI117H	contig_32	579	231	348	renamed_GCF_000008685.2	cp32-6	15437	15785	348	99.1	1.964e-73
URI117H	contig_32	786	582	204	renamed_GCF_000008685.2	cp32-7	15221	15425	204	100.0	2.578e-39
URI117H	contig_34	869	140	729	renamed_GCF_000008685.2	lp25	22677	21945	729	84.3	2.816e-132
URI117H	contig_35	835	46	789	renamed_GCF_000008685.2	lp21	2867	3656	789	99.6	6.373e-176
URI117H	contig_1	44004	44532	528	renamed_GCF_000008685.2	chromosome	485549	486077	528	100.0	1.004e-118
URI117H	contig_1	45171	45993	822	renamed_GCF_000008685.2	chromosome	486746	487538	822	99.6	9.243e-169
URI117H	contig_1	45989	46679	690	renamed_GCF_000008685.2	chromosome	487534	488224	690	99.5	4.749e-154
URI117H	contig_1	46680	47427	747	renamed_GCF_000008685.2	chromosome	488225	488972	747	100.0	3.778e-166
URI117H	contig_1	48187	49009	822	renamed_GCF_000008685.2	chromosome	489732	490554	822	98.9	1.491e-180
URI117H	contig_1	51042	52407	1365	renamed_GCF_000008685.2	chromosome	492587	493952	1365	100.0	1.721e-296
URI117H	contig_1	52997	52604	393	renamed_GCF_000008685.2	chromosome	494539	494149	393	100.0	4.545e-80
URI117H	contig_1	54722	55034	312	renamed_GCF_000008685.2	chromosome	496267	496579	312	100.0	2.953e-63
URI117H	contig_1	55699	56329	630	renamed_GCF_000008685.2	chromosome	497244	497874	630	100.0	4.528e-136
URI117H	contig_1	56667	57501	834	renamed_GCF_000008685.2	chromosome	498212	499046	834	100.0	1.895e-188
URI117H	contig_1	67768	69301	1533	renamed_GCF_000008685.2	chromosome	509313	510846	1533	100.0	0.0
URI117H	contig_1	87645	86550	1095	renamed_GCF_000008685.2	chromosome	529198	528103	1095	99.7	8.741e-250
URI117H	contig_1	90139	89575	564	renamed_GCF_000008685.2	chromosome	531692	531128	564	100.0	2.704e-122
URI117H	contig_1	94048	93625	423	renamed_GCF_000008685.2	chromosome	535600	535177	423	100.0	5.606e-91
URI117H	contig_1	95967	96756	789	renamed_GCF_000008685.2	chromosome	537543	538308	789	98.8	3.287e-166
URI117H	contig_1	100710	101472	762	renamed_GCF_000008685.2	chromosome	542262	543024	762	99.2	1.347e-171
URI117H	contig_1	102279	103053	774	renamed_GCF_000008685.2	chromosome	543831	544605	774	99.6	1.962e-169
URI117H	contig_1	106938	106293	645	renamed_GCF_000008685.2	chromosome	548490	547845	645	100.0	1.056e-137
URI117H	contig_1	108066	107367	699	renamed_GCF_000008685.2	chromosome	549618	548919	699	100.0	1.058e-146
URI117H	contig_1	132225	133620	1395	renamed_GCF_000008685.2	chromosome	573852	575247	1395	99.3	1.406e-312
URI117H	contig_1	135560	134954	606	renamed_GCF_000008685.2	chromosome	577187	576581	606	99.5	4.975e-131
URI117H	contig_1	136321	136633	312	renamed_GCF_000008685.2	chromosome	577949	578261	312	100.0	5.387e-65
URI117H	contig_1	140016	141789	1773	renamed_GCF_000008685.2	chromosome	581644	583417	1773	99.3	0.0
URI117H	contig_1	154897	156958	2061	renamed_GCF_000008685.2	chromosome	596530	598591	2061	100.0	0.0
URI117H	contig_1	157861	159211	1350	renamed_GCF_000008685.2	chromosome	599494	600844	1350	100.0	3.989e-293
URI117H	contig_1	160740	162096	1356	renamed_GCF_000008685.2	chromosome	602373	603729	1356	99.3	5.612e-299
URI117H	contig_1	165350	163145	2205	renamed_GCF_000008685.2	chromosome	606983	604778	2205	99.5	0.0
URI117H	contig_1	321926	322709	783	renamed_GCF_000008685.2	chromosome	763578	764361	783	99.6	1.874e-171
URI117H	contig_1	341120	340442	678	renamed_GCF_000008685.2	chromosome	782829	782151	678	99.1	5.213e-151
URI117H	contig_1	341680	343312	1632	renamed_GCF_000008685.2	chromosome	783389	785021	1632	99.8	0.0
URI117H	contig_1	345150	347253	2103	renamed_GCF_000008685.2	chromosome	786859	788962	2103	99.4	0.0
URI117H	contig_1	349096	348235	861	renamed_GCF_000008685.2	chromosome	790807	789946	861	100.0	1.57e-186
URI117H	contig_1	359299	360067	768	renamed_GCF_000008685.2	chromosome	801118	801778	768	98.1	1.322e-138
URI117H	contig_1	361088	360230	858	renamed_GCF_000008685.2	chromosome	802798	801940	858	99.2	3.799e-176
URI117H	contig_1	361457	361127	330	renamed_GCF_000008685.2	chromosome	803167	802837	330	100.0	2.178e-69
URI117H	contig_1	365213	364064	1149	renamed_GCF_000008685.2	chromosome	806923	805774	1149	99.7	5.42e-247
URI117H	contig_1	366256	365209	1047	renamed_GCF_000008685.2	chromosome	807966	806919	1047	100.0	5.315e-230
URI117H	contig_1	290141	292151	2010	renamed_GCF_000008685.2	chromosome	731793	733803	2010	99.8	0.0
URI117H	contig_1	300975	299742	1233	renamed_GCF_000008685.2	chromosome	742628	741395	1233	99.2	4.064e-273
URI117H	contig_1	302868	303192	324	renamed_GCF_000008685.2	chromosome	744521	744845	324	100.0	1.32e-65
URI117H	contig_1	309538	310507	969	renamed_GCF_000008685.2	chromosome	751190	752159	969	100.0	4.772e-218
URI117H	contig_1	322718	323690	972	renamed_GCF_000008685.2	chromosome	764370	765342	972	99.3	7.249e-214
URI117H	contig_1	370678	369796	882	renamed_GCF_000008685.2	chromosome	812388	811506	882	99.3	2.773e-192
URI117H	contig_1	372026	371681	345	renamed_GCF_000008685.2	chromosome	813706	813385	345	92.0	6.146e-61
URI117H	contig_1	373622	373187	435	renamed_GCF_000008685.2	chromosome	815302	814867	435	100.0	4.611e-95
URI117H	contig_1	375522	374631	891	renamed_GCF_000008685.2	chromosome	817160	816311	891	99.2	1.129e-186
URI117H	contig_1	376337	376868	531	renamed_GCF_000008685.2	chromosome	818017	818548	531	100.0	1.403e-115
URI117H	contig_1	377241	377562	321	renamed_GCF_000008685.2	chromosome	819035	819242	321	97.0	1.267e-41
URI117H	contig_1	378926	379508	582	renamed_GCF_000008685.2	chromosome	820606	821188	582	100.0	9.143e-129
URI117H	contig_1	379504	380689	1185	renamed_GCF_000008685.2	chromosome	821184	822369	1185	99.7	1.177e-261
URI117H	contig_1	381582	382131	549	renamed_GCF_000008685.2	chromosome	823262	823811	549	98.3	4.154e-115
URI117H	contig_1	412064	413132	1068	renamed_GCF_000008685.2	chromosome	853774	854842	1068	100.0	1.362e-231
URI117H	contig_2	29574	29949	375	renamed_GCF_000008685.2	chromosome	405617	405242	375	99.1	2.753e-74
URI117H	contig_2	37715	38090	375	renamed_GCF_000008685.2	chromosome	397476	397101	375	100.0	1.385e-81
URI117H	contig_2	38114	38588	474	renamed_GCF_000008685.2	chromosome	397077	396603	474	100.0	4.822e-101
URI117H	contig_2	40027	41089	1062	renamed_GCF_000008685.2	chromosome	395166	394104	1062	99.7	9.401e-235
URI117H	contig_2	42236	43262	1026	renamed_GCF_000008685.2	chromosome	392957	391931	1026	99.4	6.082e-225
URI117H	contig_2	44852	46217	1365	renamed_GCF_000008685.2	chromosome	390341	388976	1365	99.3	3.579e-288
URI117H	contig_2	46713	47376	663	renamed_GCF_000008685.2	chromosome	388480	387817	663	99.5	1.104e-148
URI117H	contig_2	49035	47856	1179	renamed_GCF_000008685.2	chromosome	386158	387337	1179	99.7	9.776e-263
URI117H	contig_2	50907	49767	1140	renamed_GCF_000008685.2	chromosome	384286	385426	1140	99.4	1.764e-249
URI117H	contig_2	51811	53284	1473	renamed_GCF_000008685.2	chromosome	383382	381909	1473	100.0	0.0
URI117H	contig_2	101584	104389	2805	renamed_GCF_000008685.2	chromosome	333598	330802	2805	99.6	0.0
URI117H	contig_2	105930	105570	360	renamed_GCF_000008685.2	chromosome	329261	329621	360	100.0	1.609e-77
URI117H	contig_2	117977	119054	1077	renamed_GCF_000008685.2	chromosome	317216	316139	1077	99.7	9.003e-238
URI117H	contig_2	119879	120770	891	renamed_GCF_000008685.2	chromosome	315314	314423	891	99.6	4.455e-197
URI117H	contig_2	122479	123535	1056	renamed_GCF_000008685.2	chromosome	312715	311659	1056	100.0	1.239e-230
URI117H	contig_2	124671	125415	744	renamed_GCF_000008685.2	chromosome	310523	309779	744	100.0	5.245e-162
URI117H	contig_2	125414	126656	1242	renamed_GCF_000008685.2	chromosome	309780	308538	1242	100.0	1.368e-269
URI117H	contig_2	144172	145231	1059	renamed_GCF_000008685.2	chromosome	291021	289962	1059	100.0	3.164e-229
URI117H	contig_2	145610	146237	627	renamed_GCF_000008685.2	chromosome	289583	288956	627	99.5	3.117e-131
URI117H	contig_2	147020	147284	264	renamed_GCF_000008685.2	chromosome	288173	287909	264	100.0	2.025e-51
URI117H	contig_2	188606	187100	1506	renamed_GCF_000008685.2	chromosome	246596	248102	1506	100.0	0.0
URI117H	contig_2	189822	190425	603	renamed_GCF_000008685.2	chromosome	245382	244776	603	99.5	7.936e-134
URI117H	contig_2	203581	202879	702	renamed_GCF_000008685.2	chromosome	231620	232322	702	100.0	1.161e-154
URI117H	contig_2	205985	204977	1008	renamed_GCF_000008685.2	chromosome	229216	230224	1008	99.4	2.993e-221
URI117H	contig_2	207374	208592	1218	renamed_GCF_000008685.2	chromosome	227827	226609	1218	99.7	3.023e-265
URI117H	contig_2	228510	226959	1551	renamed_GCF_000008685.2	chromosome	206528	208106	1551	99.8	0.0
URI117H	contig_2	230903	229967	936	renamed_GCF_000008685.2	chromosome	204136	205072	936	100.0	4.7e-204
URI117H	contig_2	232461	233988	1527	renamed_GCF_000008685.2	chromosome	202578	201051	1527	99.6	0.0
URI117H	contig_2	286377	287388	1011	renamed_GCF_000008685.2	chromosome	148659	147648	1011	99.7	2.697e-214
URI117H	contig_2	375997	377005	1008	renamed_GCF_000008685.2	chromosome	58982	58028	1008	99.0	1.313e-204
URI117H	contig_2	377848	378202	354	renamed_GCF_000008685.2	chromosome	57185	56831	354	99.1	6.554e-78
URI117H	contig_2	378285	378753	468	renamed_GCF_000008685.2	chromosome	56748	56280	468	99.3	1.969e-101
URI117H	contig_2	379529	381500	1971	renamed_GCF_000008685.2	chromosome	55504	53533	1971	99.6	0.0
URI117H	contig_2	382599	383781	1182	renamed_GCF_000008685.2	chromosome	52434	51252	1182	99.4	1.623e-257
URI117H	contig_2	406548	407184	636	renamed_GCF_000008685.2	chromosome	28490	27854	636	100.0	8.334e-139
URI117H	contig_2	408640	407590	1050	renamed_GCF_000008685.2	chromosome	26398	27448	1050	100.0	7.794e-235
URI117H	contig_2	409415	410342	927	renamed_GCF_000008685.2	chromosome	25623	24696	927	98.0	3.519e-197
URI117H	contig_2	412220	411080	1140	renamed_GCF_000008685.2	chromosome	22818	23958	1140	97.0	1.113e-254
URI117H	contig_2	431486	429692	1794	renamed_GCF_000008685.2	chromosome	3418	5188	1794	99.4	0.0
URI117H	contig_2	433085	434114	1029	renamed_GCF_000008685.2	chromosome	1796	767	1029	100.0	4.829e-228
URI117H	contig_2	434793	434229	564	renamed_GCF_000008685.2	chromosome	104	677	564	96.2	6.014e-122
URI117H	contig_3	25342	24802	540	renamed_GCF_000008685.2	lp54	21086	21626	540	97.7	2.373e-111
URI117H	contig_3	25711	25516	195	renamed_GCF_000008685.2	lp54	20717	20912	195	100.0	2.214e-39
URI117H	contig_3	27659	26306	1353	renamed_GCF_000008685.2	lp54	18724	20077	1353	99.7	3.386e-304
URI117H	contig_3	28256	27662	594	renamed_GCF_000008685.2	lp54	18127	18721	594	99.4	7.271e-125
URI117H	contig_3	29124	29688	564	renamed_GCF_000008685.2	lp54	17259	16695	564	99.4	2.368e-115
URI117H	contig_3	31036	30604	432	renamed_GCF_000008685.2	lp54	15369	15801	432	97.2	9.777e-95
URI117H	contig_4	14848	15409	561	renamed_GCF_000008685.2	cp9	1891	2452	561	63.4	1.387e-78
URI117H	contig_4	27475	28051	576	renamed_GCF_000008685.2	lp56	6835	7411	576	99.4	1.005e-126
URI117H	contig_4	29051	29507	456	renamed_GCF_000008685.2	cp32-1	4941	5397	456	97.3	1.304e-95
URI117H	contig_5	1079	515	564	renamed_GCF_000008685.2	lp56	20042	20738	564	76.1	3.333e-103
URI117H	contig_5	1865	1529	336	renamed_GCF_000008685.2	lp56	19256	19592	336	100.0	5.348e-69
URI117H	contig_5	9835	9406	429	renamed_GCF_000008685.2	lp56	11296	11725	429	100.0	5.601e-92
URI117H	contig_5	11510	10943	567	renamed_GCF_000008685.2	cp32-9	6169	6736	567	98.4	2.579e-123
URI117H	contig_5	12267	11883	384	renamed_GCF_000008685.2	cp32-4	5406	5790	384	100.0	2.931e-83
URI117H	contig_8	8359	8803	444	renamed_GCF_000008685.2	cp26	751	307	444	99.3	7.305e-100
URI117H	contig_8	10784	9155	1629	renamed_GCF_000008685.2	cp26	24824	26453	1629	100.0	0.0
URI117H	contig_8	12454	13006	552	renamed_GCF_000008685.2	cp26	23154	22602	552	100.0	6.015e-120
URI117H	contig_8	13784	14270	486	renamed_GCF_000008685.2	cp26	21833	21338	486	100.0	3.279e-107
URI117H	contig_8	14822	16178	1356	renamed_GCF_000008685.2	cp26	20786	19430	1356	98.6	2.16e-292
URI117H	contig_9	9097	8341	756	renamed_GCF_000008685.2	lp28-3	17946	18702	756	100.0	8.81e-167
URI117H	contig_9	10573	9628	945	renamed_GCF_000008685.2	lp28-3	16518	17415	945	94.5	4.657e-197
URI117H	contig_9	16576	17245	669	renamed_GCF_000008685.2	lp28-3	10516	9847	669	100.0	5.739e-140
URI117H	contig_9	18889	19093	204	renamed_GCF_000008685.2	lp36	17379	17583	204	83.5	3.933e-35
URI117H	contig_12	21013	20164	849	renamed_GCF_000008685.2	lp36	35443	34594	849	98.2	2.634e-187
URI117H	contig_13	6514	6898	384	renamed_GCF_000008685.2	lp56	8866	9250	384	100.0	2.931e-83
URI117H	contig_13	8231	8579	348	renamed_GCF_000008685.2	cp32-1	15421	15769	348	99.1	4.373e-73
URI117H	contig_13	8568	8904	336	renamed_GCF_000008685.2	cp32-8	15758	16094	336	100.0	5.348e-69
URI117H	contig_15	10474	10768	294	renamed_GCF_000008685.2	lp17	9980	9590	294	95.8	5.989e-61
URI117H	contig_16	7171	6415	756	renamed_GCF_000008685.2	cp32-4	20608	21364	756	98.8	4.353e-166
URI117H	contig_16	10920	10290	630	renamed_GCF_000008685.2	lp56	20843	21455	630	75.4	5.511e-100
URI117H	contig_16	14278	13465	813	renamed_GCF_000008685.2	cp32-8	14323	15139	813	59.5	3.754e-99
URI117H	contig_1	25736	23975	1761	renamed_GCF_000008685.2	chromosome	467278	465517	1761	99.4	0.0
URI117H	contig_1	27845	25739	2106	renamed_GCF_000008685.2	chromosome	469387	467281	2106	99.7	0.0
URI117H	contig_1	28123	27847	276	renamed_GCF_000008685.2	chromosome	469665	469389	276	97.8	9.032e-54
URI117H	contig_1	28429	28135	294	renamed_GCF_000008685.2	chromosome	469971	469677	294	100.0	2.2e-63
URI117H	contig_1	29678	28418	1260	renamed_GCF_000008685.2	chromosome	471220	469960	1260	100.0	2.539e-274
URI117H	contig_1	30933	30228	705	renamed_GCF_000008685.2	chromosome	472358	471770	705	99.4	1.099e-121
URI117H	contig_1	33070	34060	990	renamed_GCF_000008685.2	chromosome	474612	475602	990	99.6	3.939e-215
URI117H	contig_1	36532	34720	1812	renamed_GCF_000008685.2	chromosome	478005	476262	1812	99.4	0.0
URI117H	contig_1	38163	39474	1311	renamed_GCF_000008685.2	chromosome	479708	481019	1311	99.7	3.671e-296
URI117H	contig_1	41054	42737	1683	renamed_GCF_000008685.2	chromosome	482599	484282	1683	99.6	0.0
URI117H	contig_1	43217	43721	504	renamed_GCF_000008685.2	chromosome	484756	485266	504	99.4	1.338e-111
URI117H	contig_1	44528	45224	696	renamed_GCF_000008685.2	chromosome	486073	486769	696	100.0	2.835e-152
URI117H	contig_1	47437	47950	513	renamed_GCF_000008685.2	chromosome	488982	489495	513	100.0	1.545e-111
URI117H	contig_1	47946	48174	228	renamed_GCF_000008685.2	chromosome	489539	489719	228	100.0	1.455e-33
URI117H	contig_1	49098	50382	1284	renamed_GCF_000008685.2	chromosome	490643	491927	1284	100.0	9.564e-281
URI117H	contig_1	53487	54672	1185	renamed_GCF_000008685.2	chromosome	495032	496217	1185	100.0	4.832e-263
URI117H	contig_1	55069	55690	621	renamed_GCF_000008685.2	chromosome	496614	497235	621	100.0	8.732e-136
URI117H	contig_1	56349	56646	297	renamed_GCF_000008685.2	chromosome	497894	498191	297	100.0	5.69e-62
URI117H	contig_1	57510	57789	279	renamed_GCF_000008685.2	chromosome	499055	499334	279	100.0	1.411e-57
URI117H	contig_1	58161	59043	882	renamed_GCF_000008685.2	chromosome	499706	500588	882	100.0	1.248e-192
URI117H	contig_1	59669	59924	255	renamed_GCF_000008685.2	chromosome	501214	501469	255	100.0	1.745e-51
URI117H	contig_1	59951	60320	369	renamed_GCF_000008685.2	chromosome	501496	501865	369	99.1	4.571e-76
URI117H	contig_1	60645	61194	549	renamed_GCF_000008685.2	chromosome	502190	502739	549	99.4	3.776e-116
URI117H	contig_1	61186	61396	210	renamed_GCF_000008685.2	chromosome	502755	502941	210	100.0	1.151e-40
URI117H	contig_1	61820	62363	543	renamed_GCF_000008685.2	chromosome	503365	503908	543	100.0	7.636e-116
URI117H	contig_1	62752	63250	498	renamed_GCF_000008685.2	chromosome	504297	504795	498	99.3	1.965e-106
URI117H	contig_1	63558	63996	438	renamed_GCF_000008685.2	chromosome	505103	505541	438	100.0	1.186e-93
URI117H	contig_1	65325	65439	114	renamed_GCF_000008685.2	chromosome	506864	506984	114	100.0	7.638e-22
URI117H	contig_1	65860	66253	393	renamed_GCF_000008685.2	chromosome	507405	507798	393	100.0	3.073e-84
URI117H	contig_1	67324	67696	372	renamed_GCF_000008685.2	chromosome	508869	509241	372	100.0	8.775e-78
URI117H	contig_1	69290	70079	789	renamed_GCF_000008685.2	chromosome	510835	511624	789	100.0	3.149e-175
URI117H	contig_1	89552	87644	1908	renamed_GCF_000008685.2	chromosome	531105	529197	1908	100.0	0.0
URI117H	contig_1	92748	93603	855	renamed_GCF_000008685.2	chromosome	534300	535155	855	99.6	9.843e-191
URI117H	contig_1	94151	95975	1824	renamed_GCF_000008685.2	chromosome	535703	537527	1824	99.5	0.0
URI117H	contig_1	97723	96775	948	renamed_GCF_000008685.2	chromosome	539275	538327	948	99.3	2.459e-213
URI117H	contig_1	101496	102264	768	renamed_GCF_000008685.2	chromosome	543048	543816	768	99.6	4.167e-177
URI117H	contig_1	103033	105835	2802	renamed_GCF_000008685.2	chromosome	544585	547387	2802	98.8	0.0
URI117H	contig_1	107333	106934	399	renamed_GCF_000008685.2	chromosome	548885	548486	399	99.2	3.385e-84
URI117H	contig_1	110171	108089	2082	renamed_GCF_000008685.2	chromosome	551723	549641	2082	100.0	0.0
URI117H	contig_1	134189	133646	543	renamed_GCF_000008685.2	chromosome	575816	575273	543	100.0	3.121e-117
URI117H	contig_1	134899	134353	546	renamed_GCF_000008685.2	chromosome	576499	575980	546	100.0	1.781e-115
URI117H	contig_1	135766	136309	543	renamed_GCF_000008685.2	chromosome	577394	577937	543	100.0	3.121e-117
URI117H	contig_1	136648	138793	2145	renamed_GCF_000008685.2	chromosome	578276	580421	2145	99.7	0.0
URI117H	contig_1	138857	140015	1158	renamed_GCF_000008685.2	chromosome	580485	581643	1158	100.0	7.971e-253
URI117H	contig_1	141829	142204	375	renamed_GCF_000008685.2	chromosome	583457	583832	375	99.1	1.859e-78
URI117H	contig_1	157743	156954	789	renamed_GCF_000008685.2	chromosome	599376	598587	789	99.2	5.285e-178
URI117H	contig_1	159376	160711	1335	renamed_GCF_000008685.2	chromosome	601009	602344	1335	100.0	3.161e-293
URI117H	contig_1	163136	162092	1044	renamed_GCF_000008685.2	chromosome	604769	603725	1044	99.4	1.577e-234
URI117H	contig_1	165504	166302	798	renamed_GCF_000008685.2	chromosome	607137	607935	798	99.6	4.801e-172
URI117H	contig_1	168273	167427	846	renamed_GCF_000008685.2	chromosome	609906	609060	846	100.0	3.324e-184
URI117H	contig_1	184652	185405	753	renamed_GCF_000008685.2	chromosome	626285	627038	753	100.0	9.23e-166
URI117H	contig_1	189065	187562	1503	renamed_GCF_000008685.2	chromosome	630698	629195	1503	100.0	0.0
URI117H	contig_1	190357	190849	492	renamed_GCF_000008685.2	chromosome	631990	632482	492	100.0	1.786e-106
URI117H	contig_1	192947	194378	1431	renamed_GCF_000008685.2	chromosome	634580	636011	1431	95.3	9.45e-306
URI117H	contig_1	196328	196922	594	renamed_GCF_000008685.2	chromosome	637971	638556	594	99.4	7.271e-125
URI117H	contig_1	212156	208778	3378	renamed_GCF_000008685.2	chromosome	653790	650412	3378	99.8	0.0
URI117H	contig_1	213174	215268	2094	renamed_GCF_000008685.2	chromosome	654862	656902	2094	99.1	0.0
URI117H	contig_1	219881	218009	1872	renamed_GCF_000008685.2	chromosome	661515	659643	1872	99.1	0.0
URI117H	contig_1	221283	220968	315	renamed_GCF_000008685.2	chromosome	662917	662602	315	99.0	2.806e-64
URI117H	contig_1	226883	223373	3510	renamed_GCF_000008685.2	chromosome	668517	665007	3510	99.4	0.0
URI117H	contig_1	231577	230131	1446	renamed_GCF_000008685.2	chromosome	673167	671766	1446	99.1	2.204e-307
URI117H	contig_1	233399	234743	1344	renamed_GCF_000008685.2	chromosome	675034	676378	1344	99.7	1.793e-292
URI117H	contig_1	237299	236252	1047	renamed_GCF_000008685.2	chromosome	678938	677891	1047	100.0	5.633e-238
URI117H	contig_1	238924	238114	810	renamed_GCF_000008685.2	chromosome	680557	679753	810	99.6	5.278e-173
URI117H	contig_1	270558	270042	516	renamed_GCF_000008685.2	chromosome	712207	711691	516	99.4	8.019e-111
URI117H	contig_1	272458	271594	864	renamed_GCF_000008685.2	chromosome	714107	713243	864	100.0	1.134e-190
URI117H	contig_1	274970	276122	1152	renamed_GCF_000008685.2	chromosome	716619	717771	1152	100.0	1.261e-246
URI117H	contig_1	276093	277020	927	renamed_GCF_000008685.2	chromosome	717742	718669	927	100.0	3.519e-197
URI117H	contig_1	282478	281410	1068	renamed_GCF_000008685.2	chromosome	724130	723062	1068	99.7	1.68e-246
URI117H	contig_1	295045	295306	261	renamed_GCF_000008685.2	chromosome	736698	736959	261	100.0	3.165e-54
URI117H	contig_1	295558	296059	501	renamed_GCF_000008685.2	chromosome	737211	737712	501	98.1	2.269e-105
URI117H	contig_1	296752	297118	366	renamed_GCF_000008685.2	chromosome	738405	738771	366	100.0	9.695e-76
URI117H	contig_1	298031	298523	492	renamed_GCF_000008685.2	chromosome	739684	740176	492	99.3	2.164e-104
URI117H	contig_1	298792	299035	243	renamed_GCF_000008685.2	chromosome	740445	740688	243	100.0	1.755e-49
URI117H	contig_1	312415	312898	483	renamed_GCF_000008685.2	chromosome	754067	754550	483	99.3	6.952e-107
URI117H	contig_1	312897	314697	1800	renamed_GCF_000008685.2	chromosome	754636	756349	1800	100.0	0.0
URI117H	contig_1	318549	319995	1446	renamed_GCF_000008685.2	chromosome	760225	761647	1446	99.1	5.737e-314
URI117H	contig_1	336055	337045	990	renamed_GCF_000008685.2	chromosome	777764	778754	990	99.6	1.559e-225
URI117H	contig_1	337048	339676	2628	renamed_GCF_000008685.2	chromosome	778757	781385	2628	98.8	0.0
URI117H	contig_1	341539	341266	273	renamed_GCF_000008685.2	chromosome	783248	782975	273	100.0	3.858e-54
URI117H	contig_1	343347	345045	1698	renamed_GCF_000008685.2	chromosome	785056	786754	1698	99.4	0.0
URI117H	contig_1	347609	348227	618	renamed_GCF_000008685.2	chromosome	789302	789938	618	99.5	3.406e-137
URI117H	contig_1	366754	366265	489	renamed_GCF_000008685.2	chromosome	808464	807975	489	100.0	6.125e-101
URI117H	contig_1	367842	366750	1092	renamed_GCF_000008685.2	chromosome	809552	808460	1092	99.7	8.623e-241
URI117H	contig_1	368785	367990	795	renamed_GCF_000008685.2	chromosome	810495	809700	795	100.0	1.877e-173
URI117H	contig_1	382701	384024	1323	renamed_GCF_000008685.2	chromosome	824381	825704	1323	100.0	8.966e-297
URI117H	contig_1	384020	385940	1920	renamed_GCF_000008685.2	chromosome	825700	827620	1920	100.0	0.0
URI117H	contig_1	385950	387432	1482	renamed_GCF_000008685.2	chromosome	827630	829112	1482	98.9	0.0
URI117H	contig_1	387537	388641	1104	renamed_GCF_000008685.2	chromosome	829217	830321	1104	99.1	5.448e-248
URI117H	contig_1	389261	388637	624	renamed_GCF_000008685.2	chromosome	830941	830317	624	98.5	1.394e-139
URI117H	contig_1	389883	389274	609	renamed_GCF_000008685.2	chromosome	831563	830954	609	100.0	7.938e-135
URI117H	contig_1	394380	396846	2466	renamed_GCF_000008685.2	chromosome	836060	838526	2466	99.6	0.0
URI117H	contig_1	396866	397400	534	renamed_GCF_000008685.2	chromosome	838546	839080	534	100.0	7.282e-115
URI117H	contig_1	397563	400152	2589	renamed_GCF_000008685.2	chromosome	839243	841832	2589	99.5	0.0
URI117H	contig_1	400153	400771	618	renamed_GCF_000008685.2	chromosome	841833	842451	618	100.0	1.393e-138
URI117H	contig_1	400871	401309	438	renamed_GCF_000008685.2	chromosome	842500	842989	438	98.6	2.908e-92
URI117H	contig_1	401322	402771	1449	renamed_GCF_000008685.2	chromosome	843002	844451	1449	99.5	1.877e-318
URI117H	contig_1	402773	405392	2619	renamed_GCF_000008685.2	chromosome	844453	847102	2619	97.7	0.0
URI117H	contig_1	405415	405778	363	renamed_GCF_000008685.2	chromosome	847125	847488	363	99.1	5.052e-74
URI117H	contig_1	405780	406629	849	renamed_GCF_000008685.2	chromosome	847490	848339	849	99.6	1.428e-185
URI117H	contig_1	406827	407094	267	renamed_GCF_000008685.2	chromosome	848537	848804	267	100.0	3.495e-54
URI117H	contig_1	407108	409277	2169	renamed_GCF_000008685.2	chromosome	848836	850987	2169	99.8	0.0
URI117H	contig_1	409283	410804	1521	renamed_GCF_000008685.2	chromosome	850993	852514	1521	99.6	0.0
URI117H	contig_1	410778	412068	1290	renamed_GCF_000008685.2	chromosome	852488	853778	1290	99.7	1.474e-285
URI117H	contig_1	424207	424750	543	renamed_GCF_000008685.2	chromosome	865915	866458	543	98.8	6.309e-118
URI117H	contig_1	424785	424986	201	renamed_GCF_000008685.2	chromosome	866493	866694	201	100.0	2.206e-40
URI117H	contig_1	424972	425893	921	renamed_GCF_000008685.2	chromosome	866680	867601	921	99.3	3.387e-205
URI117H	contig_1	426406	426034	372	renamed_GCF_000008685.2	chromosome	868114	867742	372	99.1	1.771e-78
URI117H	contig_1	426486	427032	546	renamed_GCF_000008685.2	chromosome	868194	868740	546	100.0	1.846e-123
URI117H	contig_1	427807	427024	783	renamed_GCF_000008685.2	chromosome	869380	868732	783	99.5	1.931e-145
URI117H	contig_1	428315	427799	516	renamed_GCF_000008685.2	chromosome	870023	869507	516	100.0	1.621e-111
URI117H	contig_1	430875	428403	2472	renamed_GCF_000008685.2	chromosome	872583	870111	2472	100.0	0.0
URI117H	contig_1	433424	430877	2547	renamed_GCF_000008685.2	chromosome	875132	872585	2547	100.0	0.0
URI117H	contig_1	433498	434740	1242	renamed_GCF_000008685.2	chromosome	875206	876448	1242	98.3	3.236e-277
URI117H	contig_2	9596	8468	1128	renamed_GCF_000008685.2	chromosome	425583	426711	1128	99.7	5.155e-244
URI117H	contig_2	10486	9628	858	renamed_GCF_000008685.2	chromosome	424693	425551	858	100.0	1.579e-194
URI117H	contig_2	10733	11357	624	renamed_GCF_000008685.2	chromosome	424442	423821	624	99.5	4.527e-135
URI117H	contig_2	12124	11344	780	renamed_GCF_000008685.2	chromosome	423054	423834	780	99.6	1.628e-172
URI117H	contig_2	13628	12998	630	renamed_GCF_000008685.2	chromosome	421553	422183	630	98.5	1.533e-139
URI117H	contig_2	13801	15679	1878	renamed_GCF_000008685.2	chromosome	421380	419502	1878	99.5	0.0
URI117H	contig_2	15675	16794	1119	renamed_GCF_000008685.2	chromosome	419506	418387	1119	99.4	1.781e-254
URI117H	contig_2	17458	16846	612	renamed_GCF_000008685.2	chromosome	417723	418335	612	98.5	3.744e-135
URI117H	contig_2	18080	17468	612	renamed_GCF_000008685.2	chromosome	417101	417713	612	100.0	4.975e-132
URI117H	contig_2	18493	18076	417	renamed_GCF_000008685.2	chromosome	416688	417105	417	99.2	1.376e-88
URI117H	contig_2	18658	19336	678	renamed_GCF_000008685.2	chromosome	416478	415845	678	99.5	1.008e-143
URI117H	contig_2	19388	20855	1467	renamed_GCF_000008685.2	chromosome	415793	414326	1467	99.5	0.0
URI117H	contig_2	22069	20866	1203	renamed_GCF_000008685.2	chromosome	413112	414315	1203	99.2	7.009e-262
URI117H	contig_2	22181	23726	1545	renamed_GCF_000008685.2	chromosome	413006	411455	1545	99.2	0.0
URI117H	contig_2	24395	23735	660	renamed_GCF_000008685.2	chromosome	410786	411446	660	98.1	2.462e-139
URI117H	contig_2	24734	25766	1032	renamed_GCF_000008685.2	chromosome	410447	409415	1032	97.3	8.518e-231
URI117H	contig_2	25779	26628	849	renamed_GCF_000008685.2	chromosome	409402	408553	849	99.6	2.186e-189
URI117H	contig_2	26801	26981	180	renamed_GCF_000008685.2	chromosome	408380	408200	180	100.0	2.118e-37
URI117H	contig_2	27099	27270	171	renamed_GCF_000008685.2	chromosome	408092	407921	171	100.0	1.118e-34
URI117H	contig_2	62054	61673	381	renamed_GCF_000008685.2	chromosome	373139	373520	381	100.0	1.683e-80
URI117H	contig_2	64160	62147	2013	renamed_GCF_000008685.2	chromosome	371033	373046	2013	99.7	0.0
URI117H	contig_2	65167	64180	987	renamed_GCF_000008685.2	chromosome	370026	371013	987	99.6	8.057e-224
URI117H	contig_2	66309	65166	1143	renamed_GCF_000008685.2	chromosome	368884	370027	1143	99.4	7.822e-242
URI117H	contig_2	66738	66312	426	renamed_GCF_000008685.2	chromosome	368455	368881	426	98.5	9.562e-86
URI117H	contig_2	68233	68965	732	renamed_GCF_000008685.2	chromosome	366960	366228	732	98.7	5.755e-159
URI117H	contig_2	69590	70079	489	renamed_GCF_000008685.2	chromosome	365603	365114	489	100.0	3.787e-106
URI117H	contig_2	70114	71065	951	renamed_GCF_000008685.2	chromosome	364972	364129	951	99.2	5.797e-187
URI117H	contig_2	83863	84139	276	renamed_GCF_000008685.2	chromosome	351331	351055	276	98.9	1.819e-54
URI117H	contig_2	84146	85595	1449	renamed_GCF_000008685.2	chromosome	351045	349599	1449	99.7	6.4e-322
URI117H	contig_2	85584	87042	1458	renamed_GCF_000008685.2	chromosome	349610	348152	1458	99.5	5e-324
URI117H	contig_2	87034	87844	810	renamed_GCF_000008685.2	chromosome	348160	347350	810	99.6	4.196e-184
URI117H	contig_2	87893	88334	441	renamed_GCF_000008685.2	chromosome	347301	346860	441	100.0	1.706e-98
URI117H	contig_2	88353	88764	411	renamed_GCF_000008685.2	chromosome	346841	346430	411	100.0	6.821e-87
URI117H	contig_2	90132	88830	1302	renamed_GCF_000008685.2	chromosome	345062	346364	1302	99.3	3.283e-287
URI117H	contig_2	91987	91015	972	renamed_GCF_000008685.2	chromosome	343207	344179	972	100.0	3.579e-213
URI117H	contig_2	92860	91987	873	renamed_GCF_000008685.2	chromosome	342334	343207	873	99.6	7.766e-188
URI117H	contig_2	107467	108496	1029	renamed_GCF_000008685.2	chromosome	327757	326698	1029	99.4	1.646e-231
URI117H	contig_2	108905	109958	1053	renamed_GCF_000008685.2	chromosome	326288	325235	1053	99.4	2.184e-232
URI117H	contig_2	109957	111418	1461	renamed_GCF_000008685.2	chromosome	325236	323775	1461	99.7	0.0
URI117H	contig_2	111414	112347	933	renamed_GCF_000008685.2	chromosome	323779	322846	933	99.6	9.082e-205
URI117H	contig_2	112347	113154	807	renamed_GCF_000008685.2	chromosome	322846	322039	807	99.6	2.064e-174
URI117H	contig_2	113842	113155	687	renamed_GCF_000008685.2	chromosome	321351	322038	687	100.0	1.336e-150
URI117H	contig_2	114885	113841	1044	renamed_GCF_000008685.2	chromosome	320308	321352	1044	99.4	3.304e-226
URI117H	contig_2	114935	115514	579	renamed_GCF_000008685.2	chromosome	320249	319679	579	98.9	3.43e-122
URI117H	contig_2	115557	116088	531	renamed_GCF_000008685.2	chromosome	319636	319105	531	100.0	1.699e-113
URI117H	contig_2	116077	116917	840	renamed_GCF_000008685.2	chromosome	319116	318276	840	99.6	1.977e-180
URI117H	contig_2	126677	127877	1200	renamed_GCF_000008685.2	chromosome	308517	307317	1200	100.0	3.302e-261
URI117H	contig_2	127877	128570	693	renamed_GCF_000008685.2	chromosome	307317	306624	693	100.0	2.971e-151
URI117H	contig_2	128576	129524	948	renamed_GCF_000008685.2	chromosome	306615	305670	948	99.6	1.604e-209
URI117H	contig_2	129533	130082	549	renamed_GCF_000008685.2	chromosome	305661	305112	549	100.0	9.24e-115
URI117H	contig_2	130074	131421	1347	renamed_GCF_000008685.2	chromosome	305120	303773	1347	100.0	1.016e-290
URI117H	contig_2	131454	131862	408	renamed_GCF_000008685.2	chromosome	303740	303332	408	99.2	2.649e-88
URI117H	contig_2	131885	132344	459	renamed_GCF_000008685.2	chromosome	303309	302850	459	100.0	4.601e-99
URI117H	contig_2	132355	132691	336	renamed_GCF_000008685.2	chromosome	302839	302503	336	98.1	1.315e-67
URI117H	contig_2	132705	134415	1710	renamed_GCF_000008685.2	chromosome	302489	300779	1710	100.0	0.0
URI117H	contig_2	134430	135465	1035	renamed_GCF_000008685.2	chromosome	300764	299729	1035	100.0	3.255e-216
URI117H	contig_2	135479	136400	921	renamed_GCF_000008685.2	chromosome	299715	298794	921	99.6	2.293e-192
URI117H	contig_2	136418	137729	1311	renamed_GCF_000008685.2	chromosome	298776	297465	1311	99.5	1.7e-287
URI117H	contig_2	168137	167927	210	renamed_GCF_000008685.2	chromosome	267065	267275	210	100.0	4.647e-42
URI117H	contig_2	169096	168151	945	renamed_GCF_000008685.2	chromosome	266106	267051	945	100.0	6.277e-211
URI117H	contig_2	171215	169088	2127	renamed_GCF_000008685.2	chromosome	263987	266114	2127	99.4	0.0
URI117H	contig_2	171490	173911	2421	renamed_GCF_000008685.2	chromosome	263712	261291	2421	100.0	0.0
URI117H	contig_2	178740	176217	2523	renamed_GCF_000008685.2	chromosome	256462	258985	2523	98.9	0.0
URI117H	contig_2	179557	178942	615	renamed_GCF_000008685.2	chromosome	255645	256260	615	99.5	1.275e-130
URI117H	contig_2	190488	191259	771	renamed_GCF_000008685.2	chromosome	244713	243942	771	100.0	4.161e-169
URI117H	contig_2	192764	191198	1566	renamed_GCF_000008685.2	chromosome	242437	244003	1566	98.4	0.0
URI117H	contig_2	192912	194919	2007	renamed_GCF_000008685.2	chromosome	242289	240282	2007	99.4	0.0
URI117H	contig_2	194951	196058	1107	renamed_GCF_000008685.2	chromosome	240250	239143	1107	99.7	3.718e-244
URI117H	contig_2	196073	196901	828	renamed_GCF_000008685.2	chromosome	239128	238300	828	98.9	1.128e-184
URI117H	contig_2	196975	197233	258	renamed_GCF_000008685.2	chromosome	238226	237968	258	100.0	9.113e-51
URI117H	contig_2	197245	197572	327	renamed_GCF_000008685.2	chromosome	237956	237629	327	99.0	4.183e-70
URI117H	contig_2	197572	197980	408	renamed_GCF_000008685.2	chromosome	237629	237221	408	100.0	2.649e-88
URI117H	contig_2	198059	199607	1548	renamed_GCF_000008685.2	chromosome	237142	235594	1548	99.8	0.0
URI117H	contig_2	199667	199913	246	renamed_GCF_000008685.2	chromosome	235534	235288	246	98.7	3.025e-52
URI117H	contig_2	212023	211240	783	renamed_GCF_000008685.2	chromosome	223178	223961	783	99.2	8.433e-172
URI117H	contig_2	213568	212023	1545	renamed_GCF_000008685.2	chromosome	221741	223178	1545	98.3	8.416e-309
URI117H	contig_2	241576	242716	1140	renamed_GCF_000008685.2	chromosome	193463	192323	1140	99.7	9.252e-257
URI117H	contig_2	242712	243522	810	renamed_GCF_000008685.2	chromosome	192327	191517	810	99.6	1.125e-181
URI117H	contig_2	244321	243580	741	renamed_GCF_000008685.2	chromosome	190718	191459	741	99.5	3.597e-157
URI117H	contig_2	244976	244322	654	renamed_GCF_000008685.2	chromosome	190186	190717	654	99.4	1.404e-110
URI117H	contig_2	245180	245741	561	renamed_GCF_000008685.2	chromosome	189859	189298	561	100.0	1.275e-121
URI117H	contig_2	245763	245964	201	renamed_GCF_000008685.2	chromosome	189276	189075	201	98.4	4.922e-40
URI117H	contig_2	288666	289566	900	renamed_GCF_000008685.2	chromosome	146370	145470	900	100.0	6.779e-194
URI117H	contig_2	289578	290451	873	renamed_GCF_000008685.2	chromosome	145458	144585	873	98.9	1.511e-197
URI117H	contig_2	304902	307608	2706	renamed_GCF_000008685.2	chromosome	130132	127426	2706	99.8	0.0
URI117H	contig_2	307621	308719	1098	renamed_GCF_000008685.2	chromosome	127413	126315	1098	100.0	1.369e-236
URI117H	contig_2	308733	309501	768	renamed_GCF_000008685.2	chromosome	126301	125533	768	99.2	8.033e-170
URI117H	contig_2	309487	310237	750	renamed_GCF_000008685.2	chromosome	125547	124797	750	100.0	1.281e-161
URI117H	contig_2	310220	310886	666	renamed_GCF_000008685.2	chromosome	124814	124148	666	100.0	8.347e-144
URI117H	contig_2	310888	312544	1656	renamed_GCF_000008685.2	chromosome	124146	122490	1656	99.2	0.0
URI117H	contig_2	312543	313155	612	renamed_GCF_000008685.2	chromosome	122491	121879	612	97.0	9.656e-125
URI117H	contig_2	313211	313934	723	renamed_GCF_000008685.2	chromosome	121823	121100	723	98.7	4.546e-160
URI117H	contig_2	313952	314231	279	renamed_GCF_000008685.2	chromosome	121082	120803	279	96.7	3.477e-56
URI117H	contig_2	314444	315227	783	renamed_GCF_000008685.2	chromosome	120589	119806	783	99.6	5.024e-169
URI117H	contig_2	323465	323987	522	renamed_GCF_000008685.2	chromosome	111567	111045	522	100.0	1.783e-111
URI117H	contig_2	323990	325358	1368	renamed_GCF_000008685.2	chromosome	111042	109674	1368	100.0	1.976e-295
URI117H	contig_2	326726	325361	1365	renamed_GCF_000008685.2	chromosome	108306	109671	1365	100.0	4.349e-312
URI117H	contig_2	326862	328059	1197	renamed_GCF_000008685.2	chromosome	108170	106973	1197	99.7	1.869e-258
URI117H	contig_2	328138	329149	1011	renamed_GCF_000008685.2	chromosome	106894	105883	1011	100.0	4.14e-218
URI117H	contig_2	329177	329615	438	renamed_GCF_000008685.2	chromosome	105846	105417	438	98.5	1.926e-88
URI117H	contig_2	329601	331269	1668	renamed_GCF_000008685.2	chromosome	105299	103763	1668	99.8	0.0
URI117H	contig_2	331261	332017	756	renamed_GCF_000008685.2	chromosome	103771	103015	756	99.6	2.151e-165
URI117H	contig_2	332083	333508	1425	renamed_GCF_000008685.2	chromosome	102949	101524	1425	100.0	1.009e-312
URI117H	contig_2	333693	334287	594	renamed_GCF_000008685.2	chromosome	101339	100745	594	100.0	6.255e-135
URI117H	contig_2	345224	345833	609	renamed_GCF_000008685.2	chromosome	89808	89199	609	100.0	1.275e-129
URI117H	contig_2	347672	348107	435	renamed_GCF_000008685.2	chromosome	87360	86925	435	100.0	2.772e-92
URI117H	contig_2	348178	349153	975	renamed_GCF_000008685.2	chromosome	86854	85879	975	100.0	4.354e-220
URI117H	contig_2	349312	350992	1680	renamed_GCF_000008685.2	chromosome	85720	84040	1680	100.0	0.0
URI117H	contig_2	351112	352063	951	renamed_GCF_000008685.2	chromosome	83920	82969	951	99.6	3.736e-209
URI117H	contig_2	353628	352092	1536	renamed_GCF_000008685.2	chromosome	81404	82940	1536	100.0	0.0
URI117H	contig_2	354050	353624	426	renamed_GCF_000008685.2	chromosome	80982	81408	426	99.2	2.643e-91
URI117H	contig_2	355528	354259	1269	renamed_GCF_000008685.2	chromosome	79504	80773	1269	100.0	1.4e-282
URI117H	contig_2	355680	356031	351	renamed_GCF_000008685.2	chromosome	79322	79001	351	99.0	3.732e-67
URI117H	contig_2	369744	369282	462	renamed_GCF_000008685.2	chromosome	65290	65752	462	100.0	3.193e-95
URI117H	contig_2	370997	369758	1239	renamed_GCF_000008685.2	chromosome	64037	65276	1239	99.5	1.39e-277
URI117H	contig_2	371888	371006	882	renamed_GCF_000008685.2	chromosome	63146	64028	882	99.6	6.762e-191
URI117H	contig_2	373777	374467	690	renamed_GCF_000008685.2	chromosome	61257	60567	690	98.6	3.759e-148
URI117H	contig_2	374501	374999	498	renamed_GCF_000008685.2	chromosome	60533	60035	498	98.7	8.026e-108
URI117H	contig_2	374995	375934	939	renamed_GCF_000008685.2	chromosome	60039	59100	939	99.3	9.091e-206
URI117H	contig_2	385692	385020	672	renamed_GCF_000008685.2	chromosome	49340	50012	672	100.0	9.591e-152
URI117H	contig_2	385773	386430	657	renamed_GCF_000008685.2	chromosome	49259	48602	657	98.1	5.738e-138
URI117H	contig_2	398420	399173	753	renamed_GCF_000008685.2	chromosome	36609	35856	753	98.0	1.62e-159
URI117H	contig_2	399193	400993	1800	renamed_GCF_000008685.2	chromosome	35836	34036	1800	100.0	0.0
URI117H	contig_2	400992	402873	1881	renamed_GCF_000008685.2	chromosome	34037	32156	1881	100.0	0.0
URI117H	contig_2	402940	403480	540	renamed_GCF_000008685.2	chromosome	32089	31549	540	100.0	3.274e-116
URI117H	contig_2	404009	403550	459	renamed_GCF_000008685.2	chromosome	31026	31479	459	99.3	5.582e-97
URI117H	contig_2	405496	404014	1482	renamed_GCF_000008685.2	chromosome	29542	31015	1482	98.1	0.0
URI117H	contig_2	405566	406547	981	renamed_GCF_000008685.2	chromosome	29472	28491	981	100.0	8.047e-223
URI117H	contig_3	457	1693	1236	renamed_GCF_000008685.2	lp54	45947	44711	1236	99.2	3.647e-266
URI117H	contig_3	1871	2720	849	renamed_GCF_000008685.2	lp54	44533	43684	849	100.0	7.054e-185
URI117H	contig_3	11431	10585	846	renamed_GCF_000008685.2	lp54	34987	35833	846	99.2	3.028e-185
URI117H	contig_3	12034	11470	564	renamed_GCF_000008685.2	lp54	34384	34948	564	99.4	3.599e-119
URI117H	contig_3	13677	13458	219	renamed_GCF_000008685.2	lp54	32741	32960	219	100.0	7.958e-46
URI117H	contig_3	14158	13669	489	renamed_GCF_000008685.2	lp54	32260	32749	489	100.0	3.125e-108
URI117H	contig_3	14639	14216	423	renamed_GCF_000008685.2	lp54	31779	32202	423	100.0	5.086e-92
URI117H	contig_3	15709	14638	1071	renamed_GCF_000008685.2	lp54	30709	31780	1071	99.4	1.082e-234
URI117H	contig_3	16335	15795	540	renamed_GCF_000008685.2	lp54	30093	30633	540	100.0	4.969e-120
URI117H	contig_3	17045	16670	375	renamed_GCF_000008685.2	lp54	29383	29758	375	100.0	1.685e-79
URI117H	contig_3	17494	17041	453	renamed_GCF_000008685.2	lp54	28934	29387	453	100.0	2.51e-96
URI117H	contig_3	18415	17497	918	renamed_GCF_000008685.2	lp54	28013	28931	918	99.6	1.041e-200
URI117H	contig_3	19039	18430	609	renamed_GCF_000008685.2	lp54	27389	27998	609	100.0	2.346e-131
URI117H	contig_3	20976	19734	1242	renamed_GCF_000008685.2	lp54	25467	26694	1242	99.7	3.651e-267
URI117H	contig_3	21931	21325	606	renamed_GCF_000008685.2	lp54	24497	25103	606	99.0	1.616e-126
URI117H	contig_3	22652	22013	639	renamed_GCF_000008685.2	lp54	23776	24415	639	98.1	1.541e-132
URI117H	contig_3	23155	24745	1590	renamed_GCF_000008685.2	lp54	23273	21683	1590	99.6	0.0
URI117H	contig_3	33411	32826	585	renamed_GCF_000008685.2	lp54	12994	13579	585	100.0	1.763e-130
URI117H	contig_4	5220	5766	546	renamed_GCF_000008685.2	cp32-8	11919	12465	546	95.5	5.802e-111
URI117H	contig_4	5795	6128	333	renamed_GCF_000008685.2	cp32-8	12494	12827	333	100.0	8.424e-72
URI117H	contig_4	6124	7000	876	renamed_GCF_000008685.2	cp32-3	12823	13699	876	100.0	5.609e-192
URI117H	contig_4	7009	7615	606	renamed_GCF_000008685.2	cp32-8	13708	14314	606	99.0	1.337e-128
URI117H	contig_4	8513	8717	204	renamed_GCF_000008685.2	lp56	18712	18916	204	100.0	2.578e-39
URI117H	contig_4	17988	18414	426	renamed_GCF_000008685.2	cp32-4	24209	24635	426	98.5	8.877e-95
URI117H	contig_4	19196	18419	777	renamed_GCF_000008685.2	lp56	29506	28729	777	97.6	2.057e-169
URI117H	contig_4	19626	20145	519	renamed_GCF_000008685.2	cp32-8	26381	26903	519	75.6	8.35e-86
URI117H	contig_4	20172	21285	1113	renamed_GCF_000008685.2	cp32-1	26795	27932	1113	94.4	2.739e-231
URI117H	contig_4	21468	22008	540	renamed_GCF_000008685.2	cp32-8	28250	28790	540	100.0	1.472e-116
URI117H	contig_4	22187	22754	567	renamed_GCF_000008685.2	cp32-1	28834	29401	567	95.2	1.117e-115
URI117H	contig_4	22750	24103	1353	renamed_GCF_000008685.2	cp32-8	29532	30885	1353	99.3	6.861e-305
URI117H	contig_4	24168	25392	1224	renamed_GCF_000008685.2	cp32-1	65	1289	1224	100.0	2.096e-270
URI117H	contig_4	25408	26101	693	renamed_GCF_000008685.2	cp32-8	1305	1998	693	100.0	2.582e-144
URI117H	contig_5	2409	2205	204	renamed_GCF_000008685.2	cp32-3	15211	15415	204	100.0	2.578e-39
URI117H	contig_6	24915	23829	1086	renamed_GCF_000008685.2	lp38	26407	25336	1086	71.9	9.594e-160
URI117H	contig_6	26320	26083	237	renamed_GCF_000008685.2	lp28-2	29618	28853	237	71.0	1.432e-27
URI117H	contig_7	191	1085	894	renamed_GCF_000008685.2	lp36	187	1081	894	98.6	8.951e-190
URI117H	contig_7	3833	4700	867	renamed_GCF_000008685.2	lp28-4	25089	24222	867	96.1	1.236e-181
URI117H	contig_11	12637	16456	3819	renamed_GCF_000008685.2	lp28-3	7728	3891	3819	88.4	0.0
URI117H	contig_12	10536	9786	750	renamed_GCF_000008685.2	lp36	14326	13576	750	100.0	1.062e-163
URI117H	contig_12	11051	10511	540	renamed_GCF_000008685.2	lp36	14841	14301	540	100.0	2.234e-120
URI117H	contig_13	11856	12957	1101	renamed_GCF_000008685.2	cp32-6	19068	20169	1101	95.0	1.308e-237
URI117H	contig_13	12966	13533	567	renamed_GCF_000008685.2	cp32-3	20714	21281	567	100.0	2.944e-130
URI117H	contig_13	13508	14258	750	renamed_GCF_000008685.2	cp32-7	20765	21515	750	100.0	2.593e-162
URI117H	contig_13	14297	14819	522	renamed_GCF_000008685.2	cp32-7	21521	22076	522	100.0	1.473e-113
URI117H	contig_13	14830	15403	573	renamed_GCF_000008685.2	cp32-7	22087	22660	573	100.0	7.629e-121
URI117H	contig_14	9752	9194	558	renamed_GCF_000008685.2	cp32-9	26209	26770	558	85.0	3.671e-101
URI117H	contig_14	10182	10959	777	renamed_GCF_000008685.2	cp32-8	25951	25174	777	93.7	3.284e-164
URI117H	contig_14	14402	13841	561	renamed_GCF_000008685.2	cp32-9	21613	22174	561	100.0	6.308e-121
URI117H	contig_15	13910	14489	579	renamed_GCF_000008685.2	lp17	6452	5873	579	99.4	1.16e-125
URI117H	contig_15	15318	14634	684	renamed_GCF_000008685.2	lp17	5055	5739	684	99.5	1.274e-150
URI117H	contig_18	2921	3989	1068	renamed_GCF_000008685.2	lp28-1	15451	14350	1068	96.0	6.722e-231
URI117H	contig_18	4044	4605	561	renamed_GCF_000008685.2	lp28-1	14329	13768	561	98.9	4.739e-124
URI117H	contig_18	4580	5345	765	renamed_GCF_000008685.2	lp28-1	13793	13028	765	99.6	1.871e-168
URI117H	contig_18	5381	5933	552	renamed_GCF_000008685.2	lp28-1	12992	12440	552	97.8	3.273e-118
URI117H	contig_19	540	1233	693	renamed_GCF_000008685.2	cp32-6	27745	27076	693	27.6	2.503e-09
URI117H	contig_19	2036	1334	702	renamed_GCF_000008685.2	cp32-7	26151	26841	702	81.59	3.385e-117
URI117H	contig_21	1741	1516	225	renamed_GCF_000008685.2	lp54	50077	49852	225	97.2	1.083e-43
URI117H	contig_25	3930	3465	465	renamed_GCF_000008685.2	lp21	15348	15813	465	99.3	4.176e-101
URI117H	contig_28	152	863	711	renamed_GCF_000008685.2	lp28-1	26996	28073	711	31.6	3.404e-17
URI117H	contig_37	1037	545	492	renamed_GCF_000008685.2	cp32-4	27675	28203	492	88.9	2.099e-96
URI117H	contig_62	453	135	318	renamed_GCF_000008685.2	cp32-3	16585	16903	318	100.0	2.414e-66
URI117H	contig_64	529	103	426	renamed_GCF_000008685.2	lp56	52608	52134	426	97.7	4.735e-85
URI117H	contig_75	145	382	237	renamed_GCF_000008685.2	cp32-6	8733	8970	237	97.4	8.748e-48
URI117H	contig_1	71594	70847	747	renamed_GCF_000008685.2	chromosome	513139	512392	747	100.0	7.284e-159
URI117H	contig_1	111592	112243	651	renamed_GCF_000008685.2	chromosome	553138	553789	651	99.5	3.256e-143
URI117H	contig_1	112445	113666	1221	renamed_GCF_000008685.2	chromosome	553991	555212	1221	100.0	5.34e-268
URI117H	contig_1	113669	115034	1365	renamed_GCF_000008685.2	chromosome	555215	556580	1365	99.1	1.676e-305
URI117H	contig_1	115814	115016	798	renamed_GCF_000008685.2	chromosome	557423	556562	798	91.2	6.976e-168
URI117H	contig_1	116415	115797	618	renamed_GCF_000008685.2	chromosome	558024	557406	618	99.0	1.47e-129
URI117H	contig_1	119123	116396	2727	renamed_GCF_000008685.2	chromosome	560732	558005	2727	99.7	0.0
URI117H	contig_1	119518	119119	399	renamed_GCF_000008685.2	chromosome	561127	560728	399	96.2	1.01e-80
URI117H	contig_1	119927	119507	420	renamed_GCF_000008685.2	chromosome	561554	561116	420	93.0	2.589e-82
URI117H	contig_1	120316	119935	381	renamed_GCF_000008685.2	chromosome	561943	561562	381	99.2	5.027e-77
URI117H	contig_1	120557	122540	1983	renamed_GCF_000008685.2	chromosome	562184	564167	1983	99.6	0.0
URI117H	contig_1	145402	146254	852	renamed_GCF_000008685.2	chromosome	587030	587882	852	98.5	4.638e-190
URI117H	contig_1	146437	148039	1602	renamed_GCF_000008685.2	chromosome	588065	589667	1602	99.8	0.0
URI117H	contig_1	148580	148055	525	renamed_GCF_000008685.2	chromosome	590208	589683	525	97.7	3.018e-106
URI117H	contig_1	148719	149307	588	renamed_GCF_000008685.2	chromosome	590347	590935	588	99.4	4.112e-130
URI117H	contig_1	149554	150724	1170	renamed_GCF_000008685.2	chromosome	591187	592357	1170	98.9	5.197e-251
URI117H	contig_1	150854	154298	3444	renamed_GCF_000008685.2	chromosome	592445	595931	3444	99.6	0.0
URI117H	contig_1	154309	154888	579	renamed_GCF_000008685.2	chromosome	595942	596521	579	99.4	1.865e-120
URI117H	contig_1	169560	168309	1251	renamed_GCF_000008685.2	chromosome	611193	609942	1251	98.3	2.071e-266
URI117H	contig_1	169675	170389	714	renamed_GCF_000008685.2	chromosome	611308	612022	714	99.5	9.633e-159
URI117H	contig_1	200654	200807	153	renamed_GCF_000008685.2	chromosome	642288	642441	153	98.0	2.814e-30
URI117H	contig_1	201492	200865	627	renamed_GCF_000008685.2	chromosome	643126	642499	627	100.0	8.735e-137
URI117H	contig_1	203016	201660	1356	renamed_GCF_000008685.2	chromosome	644650	643294	1356	99.5	1.919e-302
URI117H	contig_1	203137	203506	369	renamed_GCF_000008685.2	chromosome	644771	645140	369	100.0	1.529e-79
URI117H	contig_1	203967	203502	465	renamed_GCF_000008685.2	chromosome	645601	645136	465	100.0	4.176e-101
URI117H	contig_1	204084	205047	963	renamed_GCF_000008685.2	chromosome	645718	646681	963	99.6	1.275e-214
URI117H	contig_1	206692	205024	1668	renamed_GCF_000008685.2	chromosome	648254	646658	1668	99.4	0.0
URI117H	contig_1	206918	207473	555	renamed_GCF_000008685.2	chromosome	648552	649107	555	99.4	3.12e-119
URI117H	contig_1	240885	240045	840	renamed_GCF_000008685.2	chromosome	682524	681684	840	99.6	3.646e-182
URI117H	contig_1	241039	241738	699	renamed_GCF_000008685.2	chromosome	682678	683377	699	100.0	1.337e-152
URI117H	contig_1	253885	253054	831	renamed_GCF_000008685.2	chromosome	695523	694692	831	99.2	6.41e-183
URI117H	contig_1	253983	255117	1134	renamed_GCF_000008685.2	chromosome	695630	696764	1134	99.2	3.457e-258
URI117H	contig_1	255790	255103	687	renamed_GCF_000008685.2	chromosome	697437	696750	687	100.0	2.97e-150
URI117H	contig_1	255938	256685	747	renamed_GCF_000008685.2	chromosome	697585	698332	747	100.0	1.547e-167
URI117H	contig_1	258318	256752	1566	renamed_GCF_000008685.2	chromosome	699965	698399	1566	99.6	0.0
URI117H	contig_1	259277	258404	873	renamed_GCF_000008685.2	chromosome	700924	700051	873	99.3	1.433e-189
URI117H	contig_1	259381	259738	357	renamed_GCF_000008685.2	chromosome	701028	701385	357	99.1	2.301e-81
URI117H	contig_1	259747	260158	411	renamed_GCF_000008685.2	chromosome	701394	701805	411	98.5	1.377e-87
URI117H	contig_1	260177	260627	450	renamed_GCF_000008685.2	chromosome	701824	702274	450	99.3	2.172e-97
URI117H	contig_1	261319	260635	684	renamed_GCF_000008685.2	chromosome	702951	702282	684	99.5	1.009e-144
URI117H	contig_1	261361	262321	960	renamed_GCF_000008685.2	chromosome	703008	703968	960	100.0	6.008e-214
URI117H	contig_1	262283	263312	1029	renamed_GCF_000008685.2	chromosome	703960	704959	1029	98.7	4.152e-221
URI117H	contig_1	263301	263853	552	renamed_GCF_000008685.2	chromosome	704948	705500	552	96.1	1.619e-117
URI117H	contig_1	263930	264956	1026	renamed_GCF_000008685.2	chromosome	705579	706605	1026	100.0	2.737e-225
URI117H	contig_1	265023	267618	2595	renamed_GCF_000008685.2	chromosome	706672	709267	2595	99.4	0.0
URI117H	contig_1	267624	269025	1401	renamed_GCF_000008685.2	chromosome	709273	710674	1401	98.2	2.931e-305
URI117H	contig_1	269036	269522	486	renamed_GCF_000008685.2	chromosome	710685	711171	486	100.0	5.304e-102
URI117H	contig_1	269561	270002	441	renamed_GCF_000008685.2	chromosome	711210	711651	441	100.0	1.245e-93
URI117H	contig_1	282571	283795	1224	renamed_GCF_000008685.2	chromosome	724223	725447	1224	99.5	3.533e-273
URI117H	contig_1	283778	284843	1065	renamed_GCF_000008685.2	chromosome	725430	726495	1065	98.8	9.851e-235
URI117H	contig_1	306470	308366	1896	renamed_GCF_000008685.2	chromosome	748122	750018	1896	100.0	0.0
URI117H	contig_1	308378	309137	759	renamed_GCF_000008685.2	chromosome	750030	750789	759	100.0	2.255e-165
URI117H	contig_1	310517	311567	1050	renamed_GCF_000008685.2	chromosome	752169	753219	1050	100.0	6.109e-229
URI117H	contig_1	323720	325064	1344	renamed_GCF_000008685.2	chromosome	765372	766716	1344	100.0	2.685e-305
URI117H	contig_1	327818	326426	1392	renamed_GCF_000008685.2	chromosome	769470	768078	1392	100.0	1.696e-292
URI117H	contig_1	329910	329508	402	renamed_GCF_000008685.2	chromosome	771563	771161	402	100.0	3.917e-83
URI117H	contig_1	333023	333809	786	renamed_GCF_000008685.2	chromosome	774676	775462	786	100.0	1.17e-168
URI117H	contig_1	335075	335864	789	renamed_GCF_000008685.2	chromosome	776784	777573	789	98.4	5.027e-170
URI117H	contig_1	350541	350082	459	renamed_GCF_000008685.2	chromosome	792252	791793	459	98.6	5.582e-97
URI117H	contig_1	353144	352130	1014	renamed_GCF_000008685.2	chromosome	794855	793841	1014	98.8	2.27e-225
URI117H	contig_1	380663	381014	351	renamed_GCF_000008685.2	chromosome	822343	822694	351	99.1	1.534e-76
URI117H	contig_1	381129	381423	294	renamed_GCF_000008685.2	chromosome	822809	823103	294	100.0	1.207e-61
URI117H	contig_1	382135	382702	567	renamed_GCF_000008685.2	chromosome	823815	824382	567	100.0	1.275e-122
URI117H	contig_1	413158	414286	1128	renamed_GCF_000008685.2	chromosome	854868	855996	1128	99.4	1.292e-259
URI117H	contig_1	415795	417205	1410	renamed_GCF_000008685.2	chromosome	857505	858915	1410	99.3	7.483e-305
URI117H	contig_1	418730	420065	1335	renamed_GCF_000008685.2	chromosome	860439	861774	1335	99.3	1.013e-288
URI117H	contig_1	421927	423334	1407	renamed_GCF_000008685.2	chromosome	863635	865042	1407	99.5	3.133e-314
URI117H	contig_1	434720	437573	2853	renamed_GCF_000008685.2	chromosome	876491	879281	2853	99.3	0.0
URI117H	contig_1	439383	438558	825	renamed_GCF_000008685.2	chromosome	881091	880266	825	99.6	6.405e-182
URI117H	contig_1	444739	442519	2220	renamed_GCF_000008685.2	chromosome	886447	884227	2220	98.5	0.0
URI117H	contig_2	43374	44799	1425	renamed_GCF_000008685.2	chromosome	391819	390391	1425	99.5	0.0
URI117H	contig_2	46267	46687	420	renamed_GCF_000008685.2	chromosome	388926	388506	420	100.0	9.787e-93
URI117H	contig_2	47860	47386	474	renamed_GCF_000008685.2	chromosome	387333	387807	474	100.0	1.339e-106
URI117H	contig_2	49745	49031	714	renamed_GCF_000008685.2	chromosome	385448	386162	714	100.0	3.427e-153
URI117H	contig_2	51031	51799	768	renamed_GCF_000008685.2	chromosome	384162	383394	768	99.6	9.689e-168
URI117H	contig_2	53301	54639	1338	renamed_GCF_000008685.2	chromosome	381892	380554	1338	100.0	1.408e-311
URI117H	contig_2	54635	55853	1218	renamed_GCF_000008685.2	chromosome	380558	379340	1218	99.2	2.093e-269
URI117H	contig_2	58174	59233	1059	renamed_GCF_000008685.2	chromosome	377019	375960	1059	98.0	1.713e-227
URI117H	contig_2	60917	59540	1377	renamed_GCF_000008685.2	chromosome	374276	375653	1377	99.7	6.3e-310
URI117H	contig_2	71077	72877	1800	renamed_GCF_000008685.2	chromosome	364117	362317	1800	99.8	0.0
URI117H	contig_2	74116	75682	1566	renamed_GCF_000008685.2	chromosome	361078	359512	1566	99.6	0.0
URI117H	contig_2	76737	75996	741	renamed_GCF_000008685.2	chromosome	358457	359198	741	99.5	4.555e-163
URI117H	contig_2	79704	78285	1419	renamed_GCF_000008685.2	chromosome	355490	356909	1419	99.5	1.551e-315
URI117H	contig_2	80558	81755	1197	renamed_GCF_000008685.2	chromosome	354636	353439	1197	100.0	5.312e-264
URI117H	contig_2	93921	92871	1050	renamed_GCF_000008685.2	chromosome	341273	342323	1050	100.0	1.489e-227
URI117H	contig_2	96837	95211	1626	renamed_GCF_000008685.2	chromosome	338357	339983	1626	99.8	0.0
URI117H	contig_2	100667	101564	897	renamed_GCF_000008685.2	chromosome	334515	333618	897	100.0	1.666e-200
URI117H	contig_2	104439	105549	1110	renamed_GCF_000008685.2	chromosome	330752	329642	1110	100.0	1.105e-249
URI117H	contig_2	107163	106026	1137	renamed_GCF_000008685.2	chromosome	328031	329165	1137	99.7	1.4e-251
URI117H	contig_2	152506	153394	888	renamed_GCF_000008685.2	chromosome	282687	281799	888	99.6	8.945e-189
URI117H	contig_2	153882	155787	1905	renamed_GCF_000008685.2	chromosome	281311	279406	1905	100.0	0.0
URI117H	contig_2	156135	156657	522	renamed_GCF_000008685.2	chromosome	279058	278536	522	100.0	3.966e-111
URI117H	contig_2	158636	158129	507	renamed_GCF_000008685.2	chromosome	276671	277064	507	100.0	6.298e-87
URI117H	contig_2	161340	159957	1383	renamed_GCF_000008685.2	chromosome	273856	275236	1383	99.5	1.314e-302
URI117H	contig_2	180258	179553	705	renamed_GCF_000008685.2	chromosome	254944	255649	705	100.0	7.263e-152
URI117H	contig_2	182769	182163	606	renamed_GCF_000008685.2	chromosome	252433	253039	606	100.0	4.115e-133
URI117H	contig_2	183991	184546	555	renamed_GCF_000008685.2	chromosome	251211	250656	555	99.4	1.543e-118
URI117H	contig_2	186676	185113	1563	renamed_GCF_000008685.2	chromosome	248505	250089	1563	99.8	0.0
URI117H	contig_2	189413	188648	765	renamed_GCF_000008685.2	chromosome	245789	246554	765	100.0	7.663e-170
URI117H	contig_2	233989	235075	1086	renamed_GCF_000008685.2	chromosome	201050	199964	1086	99.4	6.528e-243
URI117H	contig_2	246545	246806	261	renamed_GCF_000008685.2	chromosome	188494	188233	261	98.8	1.572e-53
URI117H	contig_2	247208	247862	654	renamed_GCF_000008685.2	chromosome	187831	187177	654	100.0	1.397e-144
URI117H	contig_2	248486	248093	393	renamed_GCF_000008685.2	chromosome	186553	186946	393	100.0	5.626e-86
URI117H	contig_2	252154	251659	495	renamed_GCF_000008685.2	chromosome	182885	183380	495	100.0	9.271e-106
URI117H	contig_2	253634	255500	1866	renamed_GCF_000008685.2	chromosome	181405	179539	1866	99.6	0.0
URI117H	contig_2	256179	257172	993	renamed_GCF_000008685.2	chromosome	178860	177867	993	99.6	2.235e-213
URI117H	contig_2	258065	258971	906	renamed_GCF_000008685.2	chromosome	176974	176068	906	99.6	1.374e-195
URI117H	contig_2	259955	260942	987	renamed_GCF_000008685.2	chromosome	174970	174097	987	99.6	1.701e-189
URI117H	contig_2	261459	263508	2049	renamed_GCF_000008685.2	chromosome	173535	171531	2049	99.2	0.0
URI117H	contig_2	287541	288660	1119	renamed_GCF_000008685.2	chromosome	147495	146376	1119	100.0	3.727e-246
URI117H	contig_2	377775	377058	717	renamed_GCF_000008685.2	chromosome	57258	57975	717	98.7	3.592e-153
URI117H	contig_2	378753	379533	780	renamed_GCF_000008685.2	chromosome	56280	55500	780	99.6	1.628e-172
URI117H	contig_2	381572	382580	1008	renamed_GCF_000008685.2	chromosome	53461	52453	1008	99.7	1.478e-220
URI117H	contig_2	383782	384544	762	renamed_GCF_000008685.2	chromosome	51251	50489	762	99.2	1.282e-163
URI117H	contig_2	384559	384922	363	renamed_GCF_000008685.2	chromosome	50474	50111	363	100.0	4.578e-75
URI117H	contig_2	407173	407605	432	renamed_GCF_000008685.2	chromosome	27865	27433	432	100.0	2.641e-92
URI117H	contig_2	409286	408647	639	renamed_GCF_000008685.2	chromosome	25752	26391	639	99.5	1.211e-143
URI117H	contig_2	410342	411074	732	renamed_GCF_000008685.2	chromosome	24696	23964	732	100.0	2.844e-158
URI117H	contig_2	412299	412893	594	renamed_GCF_000008685.2	chromosome	22739	22145	594	99.4	7.271e-125
URI117H	contig_2	416576	417089	513	renamed_GCF_000008685.2	chromosome	18304	17791	513	99.4	1.872e-109
URI117H	contig_2	419158	419536	378	renamed_GCF_000008685.2	chromosome	15716	15344	378	99.1	3.937e-79
URI117H	contig_2	419535	420156	621	renamed_GCF_000008685.2	chromosome	15345	14724	621	100.0	3.249e-138
URI117H	contig_2	423460	422719	741	renamed_GCF_000008685.2	chromosome	11420	12161	741	99.1	4.555e-163
URI117H	contig_2	424678	424303	375	renamed_GCF_000008685.2	chromosome	10202	10577	375	99.1	8.349e-79
URI117H	contig_2	426454	425683	771	renamed_GCF_000008685.2	chromosome	8426	9197	771	100.0	1.781e-161
URI117H	contig_2	427483	428572	1089	renamed_GCF_000008685.2	chromosome	7397	6308	1089	99.7	9.025e-240
URI117H	contig_3	29807	30371	564	renamed_GCF_000008685.2	lp54	16576	16000	564	91.8	3.333e-103
URI117H	contig_3	32851	32098	753	renamed_GCF_000008685.2	lp54	13554	14307	753	100.0	4.561e-165
URI117H	contig_3	41313	41787	474	renamed_GCF_000008685.2	lp54	5140	4666	474	96.8	1.577e-96
URI117H	contig_3	43559	44408	849	renamed_GCF_000008685.2	lp54	2893	2044	849	99.2	6.426e-186
URI117H	contig_3	45801	45315	486	renamed_GCF_000008685.2	lp28-3	28197	27624	486	47.8	4.56e-45
URI117H	contig_4	1590	2046	456	renamed_GCF_000008685.2	cp32-4	8281	8737	456	96.6	1.075e-97
URI117H	contig_4	9057	9393	336	renamed_GCF_000008685.2	cp32-9	15855	16191	336	100.0	5.348e-69
URI117H	contig_4	10524	10965	441	renamed_GCF_000008685.2	cp32-6	17246	17696	441	83.4	5.327e-78
URI117H	contig_4	14048	14831	783	renamed_GCF_000008685.2	cp32-8	20739	21480	783	79.2	1.084e-134
URI117H	contig_5	12722	12266	456	renamed_GCF_000008685.2	cp32-7	4940	5396	456	97.3	1.304e-95
URI117H	contig_5	24866	23540	1326	renamed_GCF_000008685.2	cp32-7	23134	24460	1326	99.3	1.584e-299
URI117H	contig_5	26446	25867	579	renamed_GCF_000008685.2	cp32-6	21519	22098	579	100.0	5.735e-125
URI117H	contig_6	12241	11203	1038	renamed_GCF_000008685.2	lp38	22042	23008	1038	88.7	1.356e-200
URI117H	contig_6	14900	14204	696	renamed_GCF_000008685.2	lp38	19312	20008	696	94.3	1.108e-145
URI117H	contig_6	16812	16035	777	renamed_GCF_000008685.2	lp38	17387	18170	777	83.3	2.326e-142
URI117H	contig_6	19513	20503	990	renamed_GCF_000008685.2	lp38	13440	12444	990	82.2	3.09e-183
URI117H	contig_8	5029	4681	348	renamed_GCF_000008685.2	cp26	4083	4431	348	99.1	5.329e-71
URI117H	contig_8	6924	8274	1350	renamed_GCF_000008685.2	cp26	2186	836	1350	98.8	9.453e-301
URI117H	contig_8	9065	8786	279	renamed_GCF_000008685.2	cp26	45	324	279	98.9	5.175e-60
URI117H	contig_8	12354	11109	1245	renamed_GCF_000008685.2	cp26	23254	24499	1245	98.5	3.391e-277
URI117H	contig_8	13711	13015	696	renamed_GCF_000008685.2	cp26	21897	22593	696	99.5	6.925e-151
URI117H	contig_8	14244	14751	507	renamed_GCF_000008685.2	cp26	21364	20857	507	100.0	3.123e-111
URI117H	contig_8	16287	17643	1356	renamed_GCF_000008685.2	cp26	19321	17965	1356	99.5	4.378e-293
URI117H	contig_9	8246	7616	630	renamed_GCF_000008685.2	lp28-3	18797	19427	630	100.0	1.007e-135
URI117H	contig_9	9636	9069	567	renamed_GCF_000008685.2	lp28-3	17407	17974	567	99.4	9.584e-126
URI117H	contig_12	6510	8157	1647	renamed_GCF_000008685.2	lp36	10300	11947	1647	99.8	0.0
URI117H	contig_12	19224	18882	342	renamed_GCF_000008685.2	lp28-3	8017	8431	342	61.5	0.0002439
URI117H	contig_13	5080	6040	960	renamed_GCF_000008685.2	cp32-1	3962	4922	960	99.3	3.255e-212
URI117H	contig_13	8024	8228	204	renamed_GCF_000008685.2	cp32-8	15214	15418	204	100.0	2.578e-39
URI117H	contig_15	8955	9618	663	renamed_GCF_000008685.2	lp17	11646	10983	663	100.0	1.005e-149
URI117H	contig_16	6365	5819	546	renamed_GCF_000008685.2	cp32-4	21414	21960	546	100.0	3.273e-117
URI117H	contig_16	8820	7722	1098	renamed_GCF_000008685.2	cp32-4	18959	20057	1098	97.8	6.545e-245
URI117H	contig_16	13389	13185	204	renamed_GCF_000008685.2	cp32-9	15311	15515	204	100.0	2.578e-39
URI117H	contig_16	16106	15773	333	renamed_GCF_000008685.2	cp32-9	12592	12925	333	100.0	1.876e-71
URI117H	contig_17	2259	3444	1185	renamed_GCF_000008685.2	chromosome	908406	909591	1185	100.0	8.142e-266
URI117H	contig_22	4910	4133	777	renamed_GCF_000008685.2	cp32-3	26276	25499	777	98.8	7.674e-172
URI117H	contig_23	1341	1845	504	renamed_GCF_000008685.2	lp25	15545	15041	504	94.0	7.29e-110
URI117H	contig_23	2413	3499	1086	renamed_GCF_000008685.2	lp25	14530	13402	1086	93.0	2.375e-228
URI117H	contig_23	3508	4072	564	renamed_GCF_000008685.2	lp25	13393	12829	564	94.6	2.975e-121
URI117H	contig_23	4047	4806	759	renamed_GCF_000008685.2	lp25	12854	12095	759	98.4	5.504e-164
URI117H	contig_24	2	326	324	renamed_GCF_000008685.2	lp28-3	1044	1368	324	99.0	8.87e-70
URI117H	contig_24	1940	1217	723	renamed_GCF_000008685.2	lp28-3	2970	2259	723	94.5	2.04e-143
URI117H	contig_25	1345	913	432	renamed_GCF_000008685.2	lp5	4387	4819	432	99.3	2.641e-92
URI117H	contig_25	2393	1400	993	renamed_GCF_000008685.2	lp5	3339	4332	993	100.0	1.858e-215
URI117H	contig_1	1706	1145	561	renamed_GCF_000008685.2	chromosome	443248	442687	561	99.4	1.054e-123
URI117H	contig_1	5333	4784	549	renamed_GCF_000008685.2	chromosome	446875	446326	549	98.9	2.344e-121
URI117H	contig_1	6313	6631	318	renamed_GCF_000008685.2	chromosome	447854	448172	318	98.0	4.406e-68
URI117H	contig_1	7163	7769	606	renamed_GCF_000008685.2	chromosome	448707	449310	606	99.5	2.46e-130
URI117H	contig_1	10380	9597	783	renamed_GCF_000008685.2	chromosome	451921	451138	783	99.2	5.024e-169
URI117H	contig_1	14847	12942	1905	renamed_GCF_000008685.2	chromosome	456388	454483	1905	99.8	0.0
URI117H	contig_1	17983	18283	300	renamed_GCF_000008685.2	chromosome	459524	459824	300	95.9	4.432e-57
URI117H	contig_1	18510	18870	360	renamed_GCF_000008685.2	chromosome	460051	460411	360	99.1	5.311e-73
URI117H	contig_1	20503	21232	729	renamed_GCF_000008685.2	chromosome	462044	462773	729	98.7	1.34e-157
URI117H	contig_1	22511	23591	1080	renamed_GCF_000008685.2	chromosome	464052	465132	1080	99.7	2.027e-246
URI117H	contig_1	30214	29680	534	renamed_GCF_000008685.2	chromosome	471756	471222	534	100.0	8.816e-113
URI117H	contig_1	31023	31866	843	renamed_GCF_000008685.2	chromosome	472565	473408	843	100.0	5.328e-187
URI117H	contig_1	33014	31862	1152	renamed_GCF_000008685.2	chromosome	474556	473404	1152	100.0	7.714e-261
URI117H	contig_1	34063	34669	606	renamed_GCF_000008685.2	chromosome	475605	476211	606	100.0	1.006e-131
URI117H	contig_1	40512	39798	714	renamed_GCF_000008685.2	chromosome	482057	481343	714	100.0	3.944e-160
URI117H	contig_1	42741	43041	300	renamed_GCF_000008685.2	chromosome	484286	484586	300	98.9	2.966e-61
URI117H	contig_1	57795	58158	363	renamed_GCF_000008685.2	chromosome	499340	499703	363	100.0	3.407e-78
URI117H	contig_1	59047	59464	417	renamed_GCF_000008685.2	chromosome	500592	501009	417	100.0	2.778e-89
URI117H	contig_1	59466	59667	201	renamed_GCF_000008685.2	chromosome	501014	501212	201	98.4	1.098e-39
URI117H	contig_1	60334	60640	306	renamed_GCF_000008685.2	chromosome	501879	502185	306	100.0	2.959e-62
URI117H	contig_1	61405	61804	399	renamed_GCF_000008685.2	chromosome	502950	503349	399	100.0	3.071e-85
URI117H	contig_1	62380	62740	360	renamed_GCF_000008685.2	chromosome	503925	504285	360	99.1	4.361e-75
URI117H	contig_1	63253	63559	306	renamed_GCF_000008685.2	chromosome	504798	505104	306	99.0	3.271e-61
URI117H	contig_1	64008	65313	1305	renamed_GCF_000008685.2	chromosome	505553	506858	1305	100.0	4.133e-285
URI117H	contig_1	65456	65834	378	renamed_GCF_000008685.2	chromosome	507001	507379	378	100.0	8.763e-79
URI117H	contig_1	66268	67303	1035	renamed_GCF_000008685.2	chromosome	507813	508848	1035	100.0	4.156e-222
URI117H	contig_1	183373	184627	1254	renamed_GCF_000008685.2	chromosome	625006	626260	1254	100.0	1.925e-276
URI117H	contig_1	187315	185458	1857	renamed_GCF_000008685.2	chromosome	628948	627091	1857	100.0	0.0
URI117H	contig_1	189135	190353	1218	renamed_GCF_000008685.2	chromosome	630795	631986	1218	99.4	4.366e-261
URI117H	contig_1	190851	192831	1980	renamed_GCF_000008685.2	chromosome	632484	634464	1980	99.2	0.0
URI117H	contig_1	194958	196323	1365	renamed_GCF_000008685.2	chromosome	636592	637957	1365	99.3	1.721e-296
URI117H	contig_1	208753	207535	1218	renamed_GCF_000008685.2	chromosome	650387	649169	1218	99.7	6.126e-266
URI117H	contig_1	212252	213215	963	renamed_GCF_000008685.2	chromosome	653886	654849	963	100.0	5.23e-216
URI117H	contig_1	217263	217989	726	renamed_GCF_000008685.2	chromosome	658897	659623	726	100.0	3.429e-155
URI117H	contig_1	219971	220895	924	renamed_GCF_000008685.2	chromosome	661605	662529	924	99.6	1.144e-200
URI117H	contig_1	223377	221544	1833	renamed_GCF_000008685.2	chromosome	665011	663178	1833	100.0	0.0
URI117H	contig_1	231706	233143	1437	renamed_GCF_000008685.2	chromosome	673341	674778	1437	99.3	0.0
URI117H	contig_1	234832	236221	1389	renamed_GCF_000008685.2	chromosome	676471	677860	1389	100.0	1.442e-302
URI117H	contig_1	238111	237319	792	renamed_GCF_000008685.2	chromosome	679750	678958	792	99.2	7.656e-166
URI117H	contig_1	239967	238923	1044	renamed_GCF_000008685.2	chromosome	681606	680562	1044	100.0	8.539e-233
URI117H	contig_1	271601	270554	1047	renamed_GCF_000008685.2	chromosome	713250	712203	1047	100.0	4.165e-224
URI117H	contig_1	273117	272454	663	renamed_GCF_000008685.2	chromosome	714766	714103	663	98.1	3.581e-144
URI117H	contig_1	273359	274970	1611	renamed_GCF_000008685.2	chromosome	715008	716619	1611	99.8	0.0
URI117H	contig_1	277177	279436	2259	renamed_GCF_000008685.2	chromosome	718826	721088	2259	99.7	0.0
URI117H	contig_1	279466	281368	1902	renamed_GCF_000008685.2	chromosome	721118	723020	1902	99.8	0.0
URI117H	contig_1	293698	295033	1335	renamed_GCF_000008685.2	chromosome	735351	736686	1335	99.5	6.578e-285
URI117H	contig_1	295306	295555	249	renamed_GCF_000008685.2	chromosome	736959	737208	249	100.0	2.148e-48
URI117H	contig_1	296055	296775	720	renamed_GCF_000008685.2	chromosome	737708	738428	720	99.5	4.764e-159
URI117H	contig_1	297490	298030	540	renamed_GCF_000008685.2	chromosome	739143	739683	540	100.0	2.458e-119
URI117H	contig_1	298586	298769	183	renamed_GCF_000008685.2	chromosome	740239	740422	183	100.0	1.805e-39
URI117H	contig_1	311570	312416	846	renamed_GCF_000008685.2	chromosome	753291	754068	846	99.6	1.473e-167
URI117H	contig_1	314701	316018	1317	renamed_GCF_000008685.2	chromosome	756353	757670	1317	99.7	1.293e-291
URI117H	contig_1	317933	318563	630	renamed_GCF_000008685.2	chromosome	759585	760215	630	99.5	1.853e-137
URI117H	contig_1	326412	325080	1332	renamed_GCF_000008685.2	chromosome	768064	766732	1332	98.6	1.788e-290
URI117H	contig_1	329486	327893	1593	renamed_GCF_000008685.2	chromosome	771139	769546	1593	99.0	0.0
URI117H	contig_1	332715	329916	2799	renamed_GCF_000008685.2	chromosome	774368	771569	2799	99.6	0.0
URI117H	contig_1	334970	333956	1014	renamed_GCF_000008685.2	chromosome	776679	775665	1014	99.7	8.011e-220
URI117H	contig_1	350076	349095	981	renamed_GCF_000008685.2	chromosome	791787	790806	981	99.6	2.843e-217
URI117H	contig_1	350639	351914	1275	renamed_GCF_000008685.2	chromosome	792350	793625	1275	98.1	4.931e-278
URI117H	contig_1	356337	355407	930	renamed_GCF_000008685.2	chromosome	798048	797118	930	100.0	3.063e-199
URI117H	contig_1	358564	357496	1068	renamed_GCF_000008685.2	chromosome	800275	799207	1068	99.4	9.097e-245
URI117H	contig_1	369800	368759	1041	renamed_GCF_000008685.2	chromosome	811510	810469	1041	99.7	3.047e-235
URI117H	contig_1	414278	415799	1521	renamed_GCF_000008685.2	chromosome	855988	857509	1521	99.8	0.0
URI117H	contig_1	418401	417228	1173	renamed_GCF_000008685.2	chromosome	860111	858938	1173	99.2	1.547e-256
URI117H	contig_1	420990	421938	948	renamed_GCF_000008685.2	chromosome	862698	863646	948	100.0	4.292e-207
URI117H	contig_1	423353	424211	858	renamed_GCF_000008685.2	chromosome	865052	865919	858	99.6	3.329e-186
URI117H	contig_1	437606	438542	936	renamed_GCF_000008685.2	chromosome	879314	880250	936	99.6	1.601e-207
URI117H	contig_1	442505	439376	3129	renamed_GCF_000008685.2	chromosome	884213	881084	3129	99.7	0.0
URI117H	contig_1	448616	451469	2853	renamed_GCF_000008685.2	chromosome	890321	893174	2853	99.5	0.0
URI117H	contig_1	455419	454873	546	renamed_GCF_000008685.2	chromosome	897127	896578	546	97.7	8.009e-116
URI117H	contig_1	455987	455387	600	renamed_GCF_000008685.2	chromosome	897695	897095	600	99.4	6.881e-135
URI117H	contig_1	457612	455995	1617	renamed_GCF_000008685.2	chromosome	899320	897703	1617	99.6	0.0
URI117H	contig_1	457790	459023	1233	renamed_GCF_000008685.2	chromosome	899498	900731	1233	100.0	1.522e-275
URI117H	contig_1	459090	460074	984	renamed_GCF_000008685.2	chromosome	900798	901782	984	100.0	5.014e-220
URI117H	contig_1	460125	461550	1425	renamed_GCF_000008685.2	chromosome	901833	903258	1425	99.7	2.69e-310
URI117H	contig_2	76	4561	4485	renamed_GCF_000008685.2	chromosome	435103	430618	4485	98.1	0.0
URI117H	contig_2	4563	5487	924	renamed_GCF_000008685.2	chromosome	430616	429692	924	98.0	2.542e-200
URI117H	contig_2	7193	6557	636	renamed_GCF_000008685.2	chromosome	427986	428622	636	99.5	1.686e-139
URI117H	contig_2	27293	27848	555	renamed_GCF_000008685.2	chromosome	407898	407343	555	99.4	1.275e-120
URI117H	contig_2	28330	29011	681	renamed_GCF_000008685.2	chromosome	406861	406180	681	100.0	2.702e-150
URI117H	contig_2	55863	58155	2292	renamed_GCF_000008685.2	chromosome	379258	377038	2292	98.2	0.0
URI117H	contig_2	59533	59254	279	renamed_GCF_000008685.2	chromosome	375660	375939	279	100.0	3.143e-57
URI117H	contig_2	61042	61627	585	renamed_GCF_000008685.2	chromosome	374151	373566	585	99.4	4.742e-128
URI117H	contig_2	73995	72873	1122	renamed_GCF_000008685.2	chromosome	361187	362321	1122	99.4	1.215e-250
URI117H	contig_2	75699	75978	279	renamed_GCF_000008685.2	chromosome	359495	359216	279	98.9	6.331e-58
URI117H	contig_2	78188	76754	1434	renamed_GCF_000008685.2	chromosome	357006	358440	1434	99.7	4.764e-314
URI117H	contig_2	79896	80547	651	renamed_GCF_000008685.2	chromosome	355298	354647	651	100.0	1.769e-141
URI117H	contig_2	81754	83854	2100	renamed_GCF_000008685.2	chromosome	353437	351340	2100	98.1	0.0
URI117H	contig_2	94854	93933	921	renamed_GCF_000008685.2	chromosome	340340	341261	921	98.6	3.516e-196
URI117H	contig_2	100246	98674	1572	renamed_GCF_000008685.2	chromosome	334936	336508	1572	99.6	0.0
URI117H	contig_2	148104	149223	1119	renamed_GCF_000008685.2	chromosome	287089	285970	1119	100.0	9.957e-244
URI117H	contig_2	151328	152495	1167	renamed_GCF_000008685.2	chromosome	283865	282698	1167	100.0	1.172e-258
URI117H	contig_2	153400	153880	480	renamed_GCF_000008685.2	chromosome	281793	281313	480	99.3	5.307e-101
URI117H	contig_2	155813	156116	303	renamed_GCF_000008685.2	chromosome	279380	279077	303	96.0	6.277e-62
URI117H	contig_2	156634	158104	1470	renamed_GCF_000008685.2	chromosome	278559	277089	1470	99.7	4.387e-321
URI117H	contig_2	158697	159951	1254	renamed_GCF_000008685.2	chromosome	276496	275242	1254	99.5	5.471e-282
URI117H	contig_2	161546	162569	1023	renamed_GCF_000008685.2	chromosome	273647	272633	1023	98.5	8.403e-221
URI117H	contig_2	182044	180271	1773	renamed_GCF_000008685.2	chromosome	253158	254931	1773	99.3	0.0
URI117H	contig_2	182965	183991	1026	renamed_GCF_000008685.2	chromosome	252237	251211	1026	99.4	1.351e-224
URI117H	contig_2	184532	185027	495	renamed_GCF_000008685.2	chromosome	250670	250175	495	100.0	5.051e-104
URI117H	contig_2	246802	247216	414	renamed_GCF_000008685.2	chromosome	188237	187823	414	100.0	2.918e-88
URI117H	contig_2	248091	247845	246	renamed_GCF_000008685.2	chromosome	186948	187194	246	100.0	9.168e-49
URI117H	contig_2	252237	253632	1395	renamed_GCF_000008685.2	chromosome	182802	181407	1395	100.0	4.219e-300
URI117H	contig_2	255496	256123	627	renamed_GCF_000008685.2	chromosome	179543	178916	627	98.0	7.618e-130
URI117H	contig_2	257186	258062	876	renamed_GCF_000008685.2	chromosome	177853	176977	876	100.0	9.427e-195
URI117H	contig_2	260923	261511	588	renamed_GCF_000008685.2	chromosome	174116	173528	588	99.4	1.682e-131
URI117H	contig_2	263789	263555	234	renamed_GCF_000008685.2	chromosome	171262	171484	234	97.2	1.134e-44
URI117H	contig_2	265501	264331	1170	renamed_GCF_000008685.2	chromosome	169562	170708	1170	99.7	6.062e-258
URI117H	contig_2	267280	269125	1845	renamed_GCF_000008685.2	chromosome	167759	165914	1845	99.1	0.0
URI117H	contig_2	270219	271968	1749	renamed_GCF_000008685.2	chromosome	164820	163071	1749	99.1	0.0
URI117H	contig_2	272162	271994	168	renamed_GCF_000008685.2	chromosome	162877	163045	168	100.0	5.294e-34
URI117H	contig_2	274950	273831	1119	renamed_GCF_000008685.2	chromosome	160089	161208	1119	99.7	1.16e-250
URI117H	contig_2	276412	275695	717	renamed_GCF_000008685.2	chromosome	158627	159344	717	97.0	3.592e-153
URI117H	contig_2	277413	276978	435	renamed_GCF_000008685.2	chromosome	157626	158061	435	99.3	1.372e-91
URI117H	contig_2	278640	281340	2700	renamed_GCF_000008685.2	chromosome	156400	153700	2700	100.0	0.0
URI117H	contig_2	284067	282861	1206	renamed_GCF_000008685.2	chromosome	150973	152179	1206	99.7	1.095e-274
URI117H	contig_2	412937	413981	1044	renamed_GCF_000008685.2	chromosome	22101	21057	1044	100.0	6.693e-227
URI117H	contig_2	419036	418076	960	renamed_GCF_000008685.2	chromosome	15994	16804	960	98.5	5.872e-171
URI117H	contig_2	422135	420152	1983	renamed_GCF_000008685.2	chromosome	12745	14728	1983	99.8	0.0
URI117H	contig_2	422727	422127	600	renamed_GCF_000008685.2	chromosome	12153	12753	600	98.9	1.006e-130
URI117H	contig_2	424300	423460	840	renamed_GCF_000008685.2	chromosome	10580	11420	840	100.0	7.775e-191
URI117H	contig_2	425679	424674	1005	renamed_GCF_000008685.2	chromosome	9201	10206	1005	99.4	1.861e-217
URI117H	contig_2	426565	427423	858	renamed_GCF_000008685.2	chromosome	8315	7457	858	100.0	6.472e-196
URI117H	contig_2	428574	429630	1056	renamed_GCF_000008685.2	chromosome	6306	5250	1056	99.4	3.853e-235
URI117H	contig_3	32068	31522	546	renamed_GCF_000008685.2	lp54	14337	14883	546	100.0	1.338e-118
URI117H	contig_3	41140	40804	336	renamed_GCF_000008685.2	lp54	5313	5649	336	100.0	1.784e-72
URI117H	contig_3	42196	43450	1254	renamed_GCF_000008685.2	lp54	4256	3002	1254	100.0	3.245e-279
URI117H	contig_3	44993	44483	510	renamed_GCF_000008685.2	lp54	1460	1970	510	100.0	8.829e-109
URI117H	contig_4	18	1131	1113	renamed_GCF_000008685.2	cp32-7	6702	7815	1113	96.4	1.311e-239
URI117H	contig_4	2042	2279	237	renamed_GCF_000008685.2	cp32-7	8725	8962	237	97.4	1.95e-47
URI117H	contig_4	10353	9876	477	renamed_GCF_000008685.2	cp32-6	17075	16592	477	73.1	1.666e-71
URI117H	contig_4	12012	11001	1011	renamed_GCF_000008685.2	cp32-7	18728	17711	1011	96.1	1.699e-219
URI117H	contig_4	13506	14073	567	renamed_GCF_000008685.2	cp32-4	20066	20633	567	100.0	2.944e-130
URI117H	contig_5	23488	23062	426	renamed_GCF_000008685.2	cp32-6	24618	25044	426	100.0	8.056e-96
URI117H	contig_5	27245	26495	750	renamed_GCF_000008685.2	cp32-6	20720	21470	750	99.5	9.67e-165
URI117H	contig_5	29270	30218	948	renamed_GCF_000008685.2	cp32-6	18680	17732	948	98.7	2.042e-215
URI117H	contig_6	10153	9916	237	renamed_GCF_000008685.2	lp28-3	27445	26977	237	88.8	6.121e-36
URI117H	contig_6	12990	12264	726	renamed_GCF_000008685.2	lp38	21222	21948	726	92.5	2.708e-149
URI117H	contig_6	14212	12982	1230	renamed_GCF_000008685.2	lp38	20000	21230	1230	94.8	1.685e-256
URI117H	contig_6	15993	14958	1035	renamed_GCF_000008685.2	lp38	18213	19254	1035	87.8	3.062e-208
URI117H	contig_6	17674	16864	810	renamed_GCF_000008685.2	lp38	16519	17329	810	86.2	2.571e-155
URI117H	contig_7	15932	15377	555	renamed_GCF_000008685.2	lp28-4	11923	12478	555	100.0	3.559e-126
URI117H	contig_8	1277	347	930	renamed_GCF_000008685.2	cp26	7835	8765	930	97.7	1.145e-201
URI117H	contig_8	4673	4355	318	renamed_GCF_000008685.2	cp26	4481	4757	318	97.8	1.616e-54
URI117H	contig_8	5314	6637	1323	renamed_GCF_000008685.2	cp26	3798	2475	1323	99.5	7.001e-291
URI117H	contig_10	19016	18644	372	renamed_GCF_000008685.2	lp28-2	23033	22658	372	80.4	3.483e-63
URI117H	contig_10	20114	19700	414	renamed_GCF_000008685.2	lp28-2	24108	23721	414	55.6	1.931e-43
URI117H	contig_10	21965	22358	393	renamed_GCF_000008685.2	lp28-2	25979	26390	393	83.8	4.469e-72
URI117H	contig_12	2580	2856	276	renamed_GCF_000008685.2	lp36	6365	6650	276	98.9	6.026e-58
URI117H	contig_12	5581	5986	405	renamed_GCF_000008685.2	lp36	9372	9999	405	99.1	1.226e-79
URI117H	contig_12	8811	9447	636	renamed_GCF_000008685.2	lp36	12601	13237	636	99.5	7.582e-140
URI117H	contig_14	2416	2083	333	renamed_GCF_000008685.2	cp32-3	12494	12827	333	100.0	8.424e-72
URI117H	contig_14	4655	3971	684	renamed_GCF_000008685.2	lp56	13754	14438	684	95.5	5.476e-143
URI117H	contig_14	5966	4676	1290	renamed_GCF_000008685.2	cp32-4	8977	10273	1290	81.49	7.054e-224
URI117H	contig_15	36	777	741	renamed_GCF_000008685.2	lp17	13338	14079	741	100.0	7.64e-166