QUERY_ID	QUERY_NAME	QUERY_START	QUERY_END	QUERY_LENGTH	REF_ID	REF_NAME	REF_START	REF_END	REF_LENGTH	IDENTITY	EVALUE
URI89H	contig_1	42484	41443	1041	renamed_GCF_000008685.2	chromosome	42483	41442	1041	100.0	8.938e-232
URI89H	contig_1	45355	42907	2448	renamed_GCF_000008685.2	chromosome	45354	42906	2448	100.0	0.0
URI89H	contig_1	46380	46011	369	renamed_GCF_000008685.2	chromosome	46379	46010	369	100.0	3.085e-80
URI89H	contig_1	47905	48607	702	renamed_GCF_000008685.2	chromosome	47916	48606	702	100.0	4.54e-148
URI89H	contig_1	49341	50013	672	renamed_GCF_000008685.2	chromosome	49340	50012	672	100.0	9.591e-152
URI89H	contig_1	51252	50490	762	renamed_GCF_000008685.2	chromosome	51251	50489	762	100.0	1.168e-164
URI89H	contig_1	53462	52454	1008	renamed_GCF_000008685.2	chromosome	53461	52453	1008	100.0	6.65e-221
URI89H	contig_1	56281	55501	780	renamed_GCF_000008685.2	chromosome	56280	55500	780	99.6	1.628e-172
URI89H	contig_1	57259	57976	717	renamed_GCF_000008685.2	chromosome	57258	57975	717	100.0	1.471e-154
URI89H	contig_1	70173	71220	1047	renamed_GCF_000008685.2	chromosome	70141	71219	1047	100.0	1.295e-228
URI89H	contig_1	75773	76454	681	renamed_GCF_000008685.2	chromosome	75773	76454	681	100.0	3.584e-147
URI89H	contig_1	79009	77710	1299	renamed_GCF_000008685.2	chromosome	79009	77710	1299	100.0	8.363e-285
URI89H	contig_1	79504	80773	1269	renamed_GCF_000008685.2	chromosome	79504	80773	1269	100.0	1.4e-282
URI89H	contig_1	94032	93432	600	renamed_GCF_000008685.2	chromosome	94032	93432	600	100.0	1.47e-126
URI89H	contig_1	96953	94610	2343	renamed_GCF_000008685.2	chromosome	96953	94610	2343	100.0	0.0
URI89H	contig_1	98648	97862	786	renamed_GCF_000008685.2	chromosome	98648	97862	786	100.0	2.735e-176
URI89H	contig_1	100227	100749	522	renamed_GCF_000008685.2	chromosome	100227	100749	522	100.0	2.976e-114
URI89H	contig_1	102949	101524	1425	renamed_GCF_000008685.2	chromosome	102949	101524	1425	100.0	1.009e-312
URI89H	contig_1	114603	112908	1695	renamed_GCF_000008685.2	chromosome	114603	112908	1695	100.0	0.0
URI89H	contig_1	152207	153014	807	renamed_GCF_000008685.2	chromosome	152205	153012	807	100.0	9.769e-183
URI89H	contig_1	156402	153702	2700	renamed_GCF_000008685.2	chromosome	156400	153700	2700	100.0	0.0
URI89H	contig_1	157628	158063	435	renamed_GCF_000008685.2	chromosome	157626	158061	435	100.0	6.167e-92
URI89H	contig_1	171099	170721	378	renamed_GCF_000008685.2	chromosome	171097	170719	378	100.0	1.603e-80
URI89H	contig_1	173582	171533	2049	renamed_GCF_000008685.2	chromosome	173535	171531	2049	99.8	0.0
URI89H	contig_1	175086	174099	987	renamed_GCF_000008685.2	chromosome	174970	174097	987	100.0	1.551e-190
URI89H	contig_1	177855	176979	876	renamed_GCF_000008685.2	chromosome	177853	176977	876	100.0	9.427e-195
URI89H	contig_1	179545	178918	627	renamed_GCF_000008685.2	chromosome	179543	178916	627	100.0	1.275e-132
URI89H	contig_1	189278	189077	201	renamed_GCF_000008685.2	chromosome	189276	189075	201	100.0	9.889e-41
URI89H	contig_1	349613	348155	1458	renamed_GCF_000008685.2	chromosome	349610	348152	1458	100.0	0.0
URI89H	contig_1	351051	349602	1449	renamed_GCF_000008685.2	chromosome	351045	349599	1449	99.7	6.4e-322
URI89H	contig_1	351334	351058	276	renamed_GCF_000008685.2	chromosome	351331	351055	276	100.0	8.162e-55
URI89H	contig_1	374154	373569	585	renamed_GCF_000008685.2	chromosome	374151	373566	585	100.0	4.312e-129
URI89H	contig_1	374279	375656	1377	renamed_GCF_000008685.2	chromosome	374276	375653	1377	100.0	1.277e-310
URI89H	contig_1	375663	375942	279	renamed_GCF_000008685.2	chromosome	375660	375939	279	100.0	3.143e-57
URI89H	contig_1	377022	375963	1059	renamed_GCF_000008685.2	chromosome	377019	375960	1059	100.0	5.328e-232
URI89H	contig_1	379333	377041	2292	renamed_GCF_000008685.2	chromosome	379258	377038	2292	99.8	0.0
URI89H	contig_1	380561	379343	1218	renamed_GCF_000008685.2	chromosome	380558	379340	1218	100.0	1.741e-271
URI89H	contig_1	381895	380557	1338	renamed_GCF_000008685.2	chromosome	381892	380554	1338	100.0	1.408e-311
URI89H	contig_1	383385	381912	1473	renamed_GCF_000008685.2	chromosome	383382	381909	1473	100.0	0.0
URI89H	contig_1	384165	383397	768	renamed_GCF_000008685.2	chromosome	384162	383394	768	100.0	1.961e-168
URI89H	contig_1	384289	385429	1140	renamed_GCF_000008685.2	chromosome	384286	385426	1140	100.0	7.242e-251
URI89H	contig_1	385451	386165	714	renamed_GCF_000008685.2	chromosome	385448	386162	714	100.0	3.427e-153
URI89H	contig_1	386161	387340	1179	renamed_GCF_000008685.2	chromosome	386158	387337	1179	100.0	1.981e-263
URI89H	contig_1	387336	387810	474	renamed_GCF_000008685.2	chromosome	387333	387807	474	100.0	1.339e-106
URI89H	contig_1	388483	387820	663	renamed_GCF_000008685.2	chromosome	388480	387817	663	100.0	4.965e-149
URI89H	contig_1	388929	388509	420	renamed_GCF_000008685.2	chromosome	388926	388506	420	100.0	9.787e-93
URI89H	contig_1	390344	388979	1365	renamed_GCF_000008685.2	chromosome	390341	388976	1365	99.5	7.255e-289
URI89H	contig_1	391822	390397	1425	renamed_GCF_000008685.2	chromosome	391819	390391	1425	100.0	0.0
URI89H	contig_1	392960	391934	1026	renamed_GCF_000008685.2	chromosome	392957	391931	1026	100.0	1.232e-225
URI89H	contig_1	394066	393046	1020	renamed_GCF_000008685.2	chromosome	394063	393043	1020	100.0	6.665e-223
URI89H	contig_1	395169	394107	1062	renamed_GCF_000008685.2	chromosome	395166	394104	1062	100.0	1.904e-235
URI89H	contig_1	408383	408203	180	renamed_GCF_000008685.2	chromosome	408380	408200	180	100.0	2.118e-37
URI89H	contig_1	409405	408556	849	renamed_GCF_000008685.2	chromosome	409402	408553	849	100.0	9.834e-190
URI89H	contig_1	410450	409418	1032	renamed_GCF_000008685.2	chromosome	410447	409415	1032	100.0	9.895e-238
URI89H	contig_1	410789	411449	660	renamed_GCF_000008685.2	chromosome	410786	411446	660	100.0	1.008e-140
URI89H	contig_1	413003	411458	1545	renamed_GCF_000008685.2	chromosome	413006	411455	1545	99.8	0.0
URI89H	contig_1	413115	414318	1203	renamed_GCF_000008685.2	chromosome	413112	414315	1203	100.0	6.394e-263
URI89H	contig_1	415796	414329	1467	renamed_GCF_000008685.2	chromosome	415793	414326	1467	100.0	0.0
URI89H	contig_1	416526	415848	678	renamed_GCF_000008685.2	chromosome	416478	415845	678	99.5	1.008e-143
URI89H	contig_1	416691	417108	417	renamed_GCF_000008685.2	chromosome	416688	417105	417	100.0	1.248e-89
URI89H	contig_1	417104	417716	612	renamed_GCF_000008685.2	chromosome	417101	417713	612	100.0	4.975e-132
URI89H	contig_1	427991	428627	636	renamed_GCF_000008685.2	chromosome	427986	428622	636	100.0	3.41e-140
URI89H	contig_1	428650	429679	1029	renamed_GCF_000008685.2	chromosome	428645	429674	1029	100.0	3.872e-239
URI89H	contig_1	430621	429697	924	renamed_GCF_000008685.2	chromosome	430616	429692	924	100.0	4.275e-203
URI89H	contig_1	435108	430623	4485	renamed_GCF_000008685.2	chromosome	435103	430618	4485	100.0	0.0
URI89H	contig_1	442557	441717	840	renamed_GCF_000008685.2	chromosome	442552	441712	840	100.0	1.361e-184
URI89H	contig_1	443253	442692	561	renamed_GCF_000008685.2	chromosome	443248	442687	561	100.0	1.054e-123
URI89H	contig_1	446880	446331	549	renamed_GCF_000008685.2	chromosome	446875	446326	549	100.0	4.738e-122
URI89H	contig_1	447765	446973	792	renamed_GCF_000008685.2	chromosome	447736	446968	792	99.6	3.782e-165
URI89H	contig_1	447859	448177	318	renamed_GCF_000008685.2	chromosome	447854	448172	318	100.0	8.883e-69
URI89H	contig_1	448596	448206	390	renamed_GCF_000008685.2	chromosome	448591	448201	390	100.0	7.926e-82
URI89H	contig_1	448709	449315	606	renamed_GCF_000008685.2	chromosome	448707	449310	606	100.0	1.106e-130
URI89H	contig_1	449423	450176	753	renamed_GCF_000008685.2	chromosome	449418	450171	753	100.0	3.278e-160
URI89H	contig_1	451926	451143	783	renamed_GCF_000008685.2	chromosome	451921	451138	783	100.0	1.017e-169
URI89H	contig_1	454477	452044	2433	renamed_GCF_000008685.2	chromosome	454472	452039	2433	100.0	0.0
URI89H	contig_1	456393	454488	1905	renamed_GCF_000008685.2	chromosome	456388	454483	1905	100.0	0.0
URI89H	contig_1	487539	488229	690	renamed_GCF_000008685.2	chromosome	487534	488224	690	100.0	9.609e-155
URI89H	contig_1	488230	488977	747	renamed_GCF_000008685.2	chromosome	488225	488972	747	100.0	3.778e-166
URI89H	contig_1	488987	489500	513	renamed_GCF_000008685.2	chromosome	488982	489495	513	100.0	1.545e-111
URI89H	contig_1	498217	499051	834	renamed_GCF_000008685.2	chromosome	498212	499046	834	100.0	1.895e-188
URI89H	contig_1	499060	499339	279	renamed_GCF_000008685.2	chromosome	499055	499334	279	100.0	1.411e-57
URI89H	contig_1	499345	499708	363	renamed_GCF_000008685.2	chromosome	499340	499703	363	100.0	3.407e-78
URI89H	contig_1	499711	500593	882	renamed_GCF_000008685.2	chromosome	499706	500588	882	100.0	1.248e-192
URI89H	contig_1	500597	501014	417	renamed_GCF_000008685.2	chromosome	500592	501009	417	100.0	2.778e-89
URI89H	contig_1	501016	501217	201	renamed_GCF_000008685.2	chromosome	501014	501212	201	98.4	1.098e-39
URI89H	contig_1	501219	501474	255	renamed_GCF_000008685.2	chromosome	501214	501469	255	100.0	1.745e-51
URI89H	contig_1	501501	501870	369	renamed_GCF_000008685.2	chromosome	501496	501865	369	100.0	9.223e-77
URI89H	contig_1	501884	502190	306	renamed_GCF_000008685.2	chromosome	501879	502185	306	100.0	2.959e-62
URI89H	contig_1	502195	502744	549	renamed_GCF_000008685.2	chromosome	502190	502739	549	100.0	1.698e-116
URI89H	contig_1	502760	502946	186	renamed_GCF_000008685.2	chromosome	502755	502941	186	100.0	7.664e-41
URI89H	contig_1	502955	503354	399	renamed_GCF_000008685.2	chromosome	502950	503349	399	100.0	3.071e-85
URI89H	contig_1	503370	503913	543	renamed_GCF_000008685.2	chromosome	503365	503908	543	100.0	7.636e-116
URI89H	contig_1	503930	504290	360	renamed_GCF_000008685.2	chromosome	503925	504285	360	100.0	4.361e-75
URI89H	contig_1	504302	504800	498	renamed_GCF_000008685.2	chromosome	504297	504795	498	100.0	1.785e-107
URI89H	contig_1	504803	505109	306	renamed_GCF_000008685.2	chromosome	504798	505104	306	100.0	1.468e-61
URI89H	contig_1	505108	505546	438	renamed_GCF_000008685.2	chromosome	505103	505541	438	100.0	1.186e-93
URI89H	contig_1	531692	531128	564	renamed_GCF_000008685.2	chromosome	531692	531128	564	100.0	2.704e-122
URI89H	contig_1	534301	535156	855	renamed_GCF_000008685.2	chromosome	534300	535155	855	100.0	8.967e-192
URI89H	contig_1	544586	547388	2802	renamed_GCF_000008685.2	chromosome	544585	547387	2802	99.8	0.0
URI89H	contig_1	548491	547846	645	renamed_GCF_000008685.2	chromosome	548490	547845	645	100.0	1.056e-137
URI89H	contig_1	548886	548487	399	renamed_GCF_000008685.2	chromosome	548885	548486	399	100.0	1.521e-84
URI89H	contig_1	549619	548920	699	renamed_GCF_000008685.2	chromosome	549618	548919	699	100.0	1.058e-146
URI89H	contig_1	551724	549642	2082	renamed_GCF_000008685.2	chromosome	551723	549641	2082	100.0	0.0
URI89H	contig_1	576526	575980	546	renamed_GCF_000008685.2	chromosome	576499	575980	546	100.0	1.781e-115
URI89H	contig_1	577187	576581	606	renamed_GCF_000008685.2	chromosome	577187	576581	606	100.0	4.975e-131
URI89H	contig_1	577394	577937	543	renamed_GCF_000008685.2	chromosome	577394	577937	543	100.0	3.121e-117
URI89H	contig_1	590208	589683	525	renamed_GCF_000008685.2	chromosome	590208	589683	525	100.0	5.037e-109
URI89H	contig_1	590347	590935	588	renamed_GCF_000008685.2	chromosome	590347	590935	588	100.0	4.112e-130
URI89H	contig_1	591187	592357	1170	renamed_GCF_000008685.2	chromosome	591187	592357	1170	100.0	9.606e-253
URI89H	contig_1	592487	595931	3444	renamed_GCF_000008685.2	chromosome	592445	595931	3444	100.0	0.0
URI89H	contig_1	595942	596521	579	renamed_GCF_000008685.2	chromosome	595942	596521	579	100.0	3.772e-121
URI89H	contig_1	596530	598591	2061	renamed_GCF_000008685.2	chromosome	596530	598591	2061	100.0	0.0
URI89H	contig_1	599376	598587	789	renamed_GCF_000008685.2	chromosome	599376	598587	789	100.0	1.07e-178
URI89H	contig_1	599494	600844	1350	renamed_GCF_000008685.2	chromosome	599494	600844	1350	100.0	3.989e-293
URI89H	contig_1	601009	602344	1335	renamed_GCF_000008685.2	chromosome	601009	602344	1335	100.0	3.161e-293
URI89H	contig_1	602373	603729	1356	renamed_GCF_000008685.2	chromosome	602373	603729	1356	100.0	2.305e-300
URI89H	contig_1	618559	616411	2148	renamed_GCF_000008685.2	chromosome	618559	616411	2148	100.0	0.0
URI89H	contig_1	618827	621035	2208	renamed_GCF_000008685.2	chromosome	618827	621035	2208	100.0	0.0
URI89H	contig_1	621953	621044	909	renamed_GCF_000008685.2	chromosome	621953	621044	909	100.0	1.521e-203
URI89H	contig_1	622004	623447	1443	renamed_GCF_000008685.2	chromosome	622004	623447	1443	100.0	0.0
URI89H	contig_1	623450	625007	1557	renamed_GCF_000008685.2	chromosome	623450	625007	1557	100.0	0.0
URI89H	contig_1	625006	626260	1254	renamed_GCF_000008685.2	chromosome	625006	626260	1254	100.0	1.925e-276
URI89H	contig_1	626285	627038	753	renamed_GCF_000008685.2	chromosome	626285	627038	753	100.0	9.23e-166
URI89H	contig_1	653885	654848	963	renamed_GCF_000008685.2	chromosome	653886	654849	963	100.0	5.23e-216
URI89H	contig_1	654807	656901	2094	renamed_GCF_000008685.2	chromosome	654862	656902	2094	99.8	0.0
URI89H	contig_1	705577	706603	1026	renamed_GCF_000008685.2	chromosome	705579	706605	1026	100.0	2.737e-225
URI89H	contig_1	706670	709265	2595	renamed_GCF_000008685.2	chromosome	706672	709267	2595	100.0	0.0
URI89H	contig_1	709271	710672	1401	renamed_GCF_000008685.2	chromosome	709273	710674	1401	100.0	3.758e-311
URI89H	contig_1	710683	711169	486	renamed_GCF_000008685.2	chromosome	710685	711171	486	100.0	5.304e-102
URI89H	contig_1	711208	711649	441	renamed_GCF_000008685.2	chromosome	711210	711651	441	100.0	1.245e-93
URI89H	contig_1	712205	711689	516	renamed_GCF_000008685.2	chromosome	712207	711691	516	100.0	1.621e-111
URI89H	contig_1	713248	712201	1047	renamed_GCF_000008685.2	chromosome	713250	712203	1047	100.0	1.709e-225
URI89H	contig_1	726454	727750	1296	renamed_GCF_000008685.2	chromosome	726457	727753	1296	100.0	7.283e-286
URI89H	contig_1	727733	728672	939	renamed_GCF_000008685.2	chromosome	727736	728675	939	100.0	1.678e-207
URI89H	contig_1	728662	729616	954	renamed_GCF_000008685.2	chromosome	728665	729619	954	100.0	1.334e-212
URI89H	contig_1	738402	738768	366	renamed_GCF_000008685.2	chromosome	738405	738771	366	100.0	9.695e-76
URI89H	contig_1	739140	739680	540	renamed_GCF_000008685.2	chromosome	739143	739683	540	100.0	2.458e-119
URI89H	contig_1	739681	740173	492	renamed_GCF_000008685.2	chromosome	739684	740176	492	100.0	4.374e-105
URI89H	contig_1	740236	740419	183	renamed_GCF_000008685.2	chromosome	740239	740422	183	100.0	1.805e-39
URI89H	contig_1	740442	740685	243	renamed_GCF_000008685.2	chromosome	740445	740688	243	100.0	1.755e-49
URI89H	contig_1	740684	741422	738	renamed_GCF_000008685.2	chromosome	740687	741425	738	100.0	4.772e-162
URI89H	contig_1	742625	741392	1233	renamed_GCF_000008685.2	chromosome	742628	741395	1233	100.0	3.707e-274
URI89H	contig_1	742740	744513	1773	renamed_GCF_000008685.2	chromosome	742743	744516	1773	100.0	0.0
URI89H	contig_1	744518	744842	324	renamed_GCF_000008685.2	chromosome	744521	744845	324	100.0	1.32e-65
URI89H	contig_1	745298	746330	1032	renamed_GCF_000008685.2	chromosome	745301	746333	1032	100.0	2.498e-227
URI89H	contig_1	759583	760213	630	renamed_GCF_000008685.2	chromosome	759585	760215	630	100.0	3.747e-138
URI89H	contig_1	760199	761645	1446	renamed_GCF_000008685.2	chromosome	760225	761647	1446	99.7	9.686e-317
URI89H	contig_1	763576	764359	783	renamed_GCF_000008685.2	chromosome	763578	764361	783	100.0	1.874e-171
URI89H	contig_1	764368	765340	972	renamed_GCF_000008685.2	chromosome	764370	765342	972	100.0	2.973e-215
URI89H	contig_1	765370	766714	1344	renamed_GCF_000008685.2	chromosome	765372	766716	1344	100.0	2.685e-305
URI89H	contig_1	792348	793623	1275	renamed_GCF_000008685.2	chromosome	792350	793625	1275	100.0	1.279e-284
URI89H	contig_1	794853	793839	1014	renamed_GCF_000008685.2	chromosome	794855	793841	1014	100.0	1.719e-228
URI89H	contig_1	798046	797116	930	renamed_GCF_000008685.2	chromosome	798048	797118	930	100.0	3.063e-199
URI89H	contig_1	799014	798054	960	renamed_GCF_000008685.2	chromosome	799016	798056	960	100.0	6.008e-214
URI89H	contig_1	800273	799205	1068	renamed_GCF_000008685.2	chromosome	800275	799207	1068	100.0	8.292e-246
URI89H	contig_1	800473	801070	597	renamed_GCF_000008685.2	chromosome	800475	801072	597	100.0	2.836e-127
URI89H	contig_1	801008	801776	768	renamed_GCF_000008685.2	chromosome	801118	801778	768	99.5	4.938e-141
URI89H	contig_1	802797	801939	858	renamed_GCF_000008685.2	chromosome	802798	801940	858	100.0	3.462e-177
URI89H	contig_1	813238	812437	801	renamed_GCF_000008685.2	chromosome	813239	812438	801	100.0	9.279e-174
URI89H	contig_1	813714	813384	330	renamed_GCF_000008685.2	chromosome	813706	813385	330	97.2	1.608e-64
URI89H	contig_1	814705	813697	1008	renamed_GCF_000008685.2	chromosome	814697	813689	1008	100.0	5.214e-215
URI89H	contig_1	815310	814875	435	renamed_GCF_000008685.2	chromosome	815302	814867	435	100.0	4.611e-95
URI89H	contig_1	816307	815509	798	renamed_GCF_000008685.2	chromosome	816299	815501	798	100.0	1.968e-173
URI89H	contig_1	817210	816319	891	renamed_GCF_000008685.2	chromosome	817160	816311	891	99.6	1.029e-187
URI89H	contig_1	817403	817964	561	renamed_GCF_000008685.2	chromosome	817395	817956	561	100.0	3.237e-128
URI89H	contig_1	818025	818556	531	renamed_GCF_000008685.2	chromosome	818017	818548	531	100.0	1.403e-115
URI89H	contig_1	818612	818924	312	renamed_GCF_000008685.2	chromosome	818604	818916	312	100.0	1.086e-65
URI89H	contig_1	818929	819250	321	renamed_GCF_000008685.2	chromosome	819035	819242	321	98.5	2.552e-42
URI89H	contig_1	827638	829120	1482	renamed_GCF_000008685.2	chromosome	827630	829112	1482	100.0	0.0
URI89H	contig_1	829225	830329	1104	renamed_GCF_000008685.2	chromosome	829217	830321	1104	100.0	4.529e-250
URI89H	contig_1	830949	830325	624	renamed_GCF_000008685.2	chromosome	830941	830317	624	100.0	5.187e-142
URI89H	contig_1	831571	830962	609	renamed_GCF_000008685.2	chromosome	831563	830954	609	100.0	7.938e-135
URI89H	contig_1	836068	838534	2466	renamed_GCF_000008685.2	chromosome	836060	838526	2466	100.0	0.0
URI89H	contig_1	838554	839088	534	renamed_GCF_000008685.2	chromosome	838546	839080	534	100.0	7.282e-115
URI89H	contig_1	839251	841840	2589	renamed_GCF_000008685.2	chromosome	839243	841832	2589	100.0	0.0
URI89H	contig_1	841841	842459	618	renamed_GCF_000008685.2	chromosome	841833	842451	618	100.0	1.393e-138
URI89H	contig_1	842559	842997	438	renamed_GCF_000008685.2	chromosome	842500	842989	438	99.3	1.307e-92
URI89H	contig_1	843010	844459	1449	renamed_GCF_000008685.2	chromosome	843002	844451	1449	100.0	7.712e-320
URI89H	contig_1	844461	847110	2649	renamed_GCF_000008685.2	chromosome	844453	847102	2649	100.0	0.0
URI89H	contig_1	847133	847496	363	renamed_GCF_000008685.2	chromosome	847125	847488	363	100.0	2.269e-74
URI89H	contig_1	847498	848347	849	renamed_GCF_000008685.2	chromosome	847490	848339	849	100.0	6.426e-186
URI89H	contig_1	848545	848812	267	renamed_GCF_000008685.2	chromosome	848537	848804	267	100.0	3.495e-54
URI89H	contig_1	848826	850995	2169	renamed_GCF_000008685.2	chromosome	848836	850987	2169	99.8	0.0
URI89H	contig_1	851001	852522	1521	renamed_GCF_000008685.2	chromosome	850993	852514	1521	100.0	0.0
URI89H	contig_1	852496	853786	1290	renamed_GCF_000008685.2	chromosome	852488	853778	1290	100.0	6.634e-286
URI89H	contig_1	853782	854850	1068	renamed_GCF_000008685.2	chromosome	853774	854842	1068	100.0	1.362e-231
URI89H	contig_1	854876	856004	1128	renamed_GCF_000008685.2	chromosome	854868	855996	1128	100.0	2.385e-261
URI89H	contig_1	881100	880275	825	renamed_GCF_000008685.2	chromosome	881091	880266	825	100.0	2.882e-182
URI89H	contig_1	884222	881093	3129	renamed_GCF_000008685.2	chromosome	884213	881084	3129	100.0	0.0
URI89H	contig_1	886456	884236	2220	renamed_GCF_000008685.2	chromosome	886447	884227	2220	100.0	0.0
URI89H	contig_1	904909	903937	972	renamed_GCF_000008685.2	chromosome	904900	903928	972	100.0	2.334e-209
URI89H	contig_1	908415	909600	1185	renamed_GCF_000008685.2	chromosome	908406	909591	1185	100.0	8.142e-266
URI89H	contig_2	967	169	798	renamed_GCF_000008685.2	lp54	52705	53503	798	100.0	3.008e-177
URI89H	contig_2	1967	1193	774	renamed_GCF_000008685.2	lp54	51705	52479	774	100.0	9.219e-161
URI89H	contig_2	2496	3387	891	renamed_GCF_000008685.2	lp54	51176	50285	891	100.0	3.698e-199
URI89H	contig_2	3577	3820	243	renamed_GCF_000008685.2	lp54	50077	49852	243	98.6	5.904e-45
URI89H	contig_2	22957	21886	1071	renamed_GCF_000008685.2	lp54	30709	31780	1071	100.0	2.191e-235
URI89H	contig_2	23573	23033	540	renamed_GCF_000008685.2	lp54	30093	30633	540	100.0	4.969e-120
URI89H	contig_2	24283	23908	375	renamed_GCF_000008685.2	lp54	29383	29758	375	100.0	1.685e-79
URI89H	contig_2	24732	24279	453	renamed_GCF_000008685.2	lp54	28934	29387	453	100.0	2.51e-96
URI89H	contig_2	25653	24735	918	renamed_GCF_000008685.2	lp54	28013	28931	918	100.0	2.109e-201
URI89H	contig_2	26277	25668	609	renamed_GCF_000008685.2	lp54	27389	27998	609	100.0	2.346e-131
URI89H	contig_2	28214	26972	1242	renamed_GCF_000008685.2	lp54	25467	26694	1242	100.0	1.5e-268
URI89H	contig_2	29169	28563	606	renamed_GCF_000008685.2	lp54	24497	25103	606	100.0	6.612e-128
URI89H	contig_2	29890	29251	639	renamed_GCF_000008685.2	lp54	23776	24415	639	100.0	9.606e-138
URI89H	contig_2	30393	31983	1590	renamed_GCF_000008685.2	lp54	23273	21683	1590	100.0	0.0
URI89H	contig_2	32580	32040	540	renamed_GCF_000008685.2	lp54	21086	21626	540	100.0	8.011e-115
URI89H	contig_2	43379	42488	891	renamed_GCF_000008685.2	lp54	10287	11178	891	100.0	1.898e-189
URI89H	contig_2	44210	43388	822	renamed_GCF_000008685.2	lp54	9456	10278	822	100.0	5.801e-174
URI89H	contig_2	45225	44799	426	renamed_GCF_000008685.2	lp54	8441	8867	426	100.0	3.21e-89
URI89H	contig_2	45401	45221	180	renamed_GCF_000008685.2	lp54	8265	8445	180	100.0	1.452e-33
URI89H	contig_2	46458	45423	1035	renamed_GCF_000008685.2	lp54	7208	8243	1035	100.0	8.138e-232
URI89H	contig_3	8511	9198	687	renamed_GCF_000008685.2	lp38	35591	34904	687	100.0	9.164e-155
URI89H	contig_3	9434	9731	297	renamed_GCF_000008685.2	lp38	34668	34371	297	100.0	2.824e-61
URI89H	contig_3	11605	10882	723	renamed_GCF_000008685.2	lp38	32497	33220	723	100.0	6.027e-157
URI89H	contig_3	26719	25936	783	renamed_GCF_000008685.2	lp38	17387	18170	783	100.0	3.455e-173
URI89H	contig_3	27587	26777	810	renamed_GCF_000008685.2	lp38	16519	17329	810	100.0	3.013e-179
URI89H	contig_3	30665	31661	996	renamed_GCF_000008685.2	lp38	13440	12444	996	100.0	8.455e-225
URI89H	contig_3	31653	32244	591	renamed_GCF_000008685.2	lp38	12452	11861	591	100.0	1.604e-132
URI89H	contig_3	32216	32954	738	renamed_GCF_000008685.2	lp38	11889	11151	738	100.0	8.004e-165
URI89H	contig_3	33000	33588	588	renamed_GCF_000008685.2	lp38	11105	10517	588	100.0	1.006e-128
URI89H	contig_4	25073	25628	555	renamed_GCF_000008685.2	lp36	25102	25657	555	100.0	3.12e-119
URI89H	contig_4	26329	25783	546	renamed_GCF_000008685.2	lp36	26358	25812	546	100.0	8.009e-116
URI89H	contig_4	26774	26555	219	renamed_GCF_000008685.2	lp36	26803	26584	219	100.0	9.792e-44
URI89H	contig_4	28259	27353	906	renamed_GCF_000008685.2	lp36	28288	27382	906	100.0	5.634e-197
URI89H	contig_4	31556	30689	867	renamed_GCF_000008685.2	lp36	31585	30718	867	100.0	3.181e-188
URI89H	contig_4	32793	31797	996	renamed_GCF_000008685.2	lp36	32822	31826	996	100.0	2.481e-221
URI89H	contig_4	34050	33051	999	renamed_GCF_000008685.2	lp36	34079	33080	999	100.0	2.04e-215
URI89H	contig_5	1469	890	579	renamed_GCF_000008685.2	cp32-6	21519	22098	579	100.0	5.735e-125
URI89H	contig_5	10146	9270	876	renamed_GCF_000008685.2	cp32-6	12842	13718	876	99.6	6.156e-191
URI89H	contig_5	10475	10142	333	renamed_GCF_000008685.2	cp32-8	12494	12827	333	100.0	8.424e-72
URI89H	contig_5	12714	12030	684	renamed_GCF_000008685.2	cp32-8	10264	10948	684	100.0	3.113e-149
URI89H	contig_5	14707	14251	456	renamed_GCF_000008685.2	cp32-6	8281	8737	456	100.0	1.971e-99
URI89H	contig_5	16278	15165	1113	renamed_GCF_000008685.2	cp32-6	6710	7823	1113	100.0	1.393e-247
URI89H	contig_5	16828	16258	570	renamed_GCF_000008685.2	cp32-6	6160	6730	570	100.0	2.235e-125
URI89H	contig_5	17585	17201	384	renamed_GCF_000008685.2	cp32-6	5403	5787	384	100.0	2.931e-83
URI89H	contig_8	12049	12655	606	renamed_GCF_000008685.2	lp56	17207	17813	606	100.0	5.47e-130
URI89H	contig_8	13554	13758	204	renamed_GCF_000008685.2	cp32-1	15214	15418	204	100.0	2.578e-39
URI89H	contig_8	20645	21167	522	renamed_GCF_000008685.2	cp32-7	21521	22076	522	100.0	1.473e-113
URI89H	contig_9	319	703	384	renamed_GCF_000008685.2	cp32-7	5395	5779	384	100.0	2.931e-83
URI89H	contig_9	2753	3182	429	renamed_GCF_000008685.2	cp32-6	7837	8266	429	100.0	5.601e-92
URI89H	contig_10	19694	19127	567	renamed_GCF_000008685.2	cp32-1	28834	29401	567	94.1	1.228e-114
URI89H	contig_10	22445	21737	708	renamed_GCF_000008685.2	cp32-7	26151	26841	708	83.9	2.557e-121
URI89H	contig_10	29470	28372	1098	renamed_GCF_000008685.2	cp32-7	19116	20214	1098	96.7	8.634e-242
URI89H	contig_11	335	725	390	renamed_GCF_000008685.2	cp32-9	5783	6173	390	100.0	3.229e-83
URI89H	contig_11	2396	2825	429	renamed_GCF_000008685.2	cp32-9	7844	8273	429	100.0	5.601e-92
URI89H	contig_11	3293	3530	237	renamed_GCF_000008685.2	cp32-9	8741	8978	237	100.0	1.76e-48
URI89H	contig_12	237	804	567	renamed_GCF_000008685.2	cp32-4	6163	6730	567	100.0	1.054e-124
URI89H	contig_12	8350	9166	816	renamed_GCF_000008685.2	cp32-4	14276	15092	816	100.0	1.49e-179
URI89H	contig_12	9447	9795	348	renamed_GCF_000008685.2	cp32-1	15421	15769	348	100.0	3.962e-74
URI89H	contig_12	9784	10120	336	renamed_GCF_000008685.2	lp56	19256	19592	336	100.0	5.348e-69
URI89H	contig_12	10570	11071	501	renamed_GCF_000008685.2	cp32-4	16496	16997	501	100.0	5.048e-105
URI89H	contig_12	12657	11646	1011	renamed_GCF_000008685.2	cp32-4	18583	17572	1011	100.0	1.362e-230
URI89H	contig_12	14140	14707	567	renamed_GCF_000008685.2	cp32-4	20066	20633	567	100.0	2.944e-130
URI89H	contig_12	23020	24373	1353	renamed_GCF_000008685.2	cp32-4	28946	30299	1353	100.0	2.818e-306
URI89H	contig_13	22992	22566	426	renamed_GCF_000008685.2	cp32-3	25068	25494	426	100.0	3.62e-96
URI89H	contig_13	25468	24877	591	renamed_GCF_000008685.2	cp32-3	22592	23183	591	100.0	1.16e-127
URI89H	contig_13	26804	26063	741	renamed_GCF_000008685.2	cp32-3	21256	21997	741	100.0	5.003e-162
URI89H	contig_13	28456	27355	1101	renamed_GCF_000008685.2	cp32-3	19604	20705	1101	100.0	1.773e-251
URI89H	contig_13	30219	29811	408	renamed_GCF_000008685.2	cp32-3	17802	18249	408	100.0	1.978e-91
URI89H	contig_14	1169	2051	882	renamed_GCF_000008685.2	lp28-2	1046	1928	882	100.0	1.741e-197
URI89H	contig_14	5500	6073	573	renamed_GCF_000008685.2	lp28-2	5377	5950	573	100.0	1.602e-129
URI89H	contig_14	6859	7411	552	renamed_GCF_000008685.2	lp28-2	6736	7288	552	100.0	2.704e-120
URI89H	contig_14	11614	11185	429	renamed_GCF_000008685.2	lp28-2	11491	11062	429	100.0	3.057e-90
URI89H	contig_14	12875	12431	444	renamed_GCF_000008685.2	lp28-2	12752	12308	444	100.0	8.866e-98
URI89H	contig_14	13618	13279	339	renamed_GCF_000008685.2	lp28-2	13495	13156	339	100.0	3.422e-74
URI89H	contig_14	24611	26078	1467	renamed_GCF_000008685.2	lp28-2	24488	25955	1467	100.0	0.0
URI89H	contig_14	27235	28063	828	renamed_GCF_000008685.2	lp28-2	27112	27940	828	100.0	3.316e-181
URI89H	contig_14	28153	28954	801	renamed_GCF_000008685.2	lp28-2	28030	28831	801	100.0	3.29e-168
URI89H	contig_15	605	17	588	renamed_GCF_000008685.2	cp32-7	16551	17139	588	100.0	7.272e-124
URI89H	contig_15	1391	1055	336	renamed_GCF_000008685.2	cp32-7	15765	16101	336	98.1	5.906e-68
URI89H	contig_15	8435	8198	237	renamed_GCF_000008685.2	cp32-6	8733	8970	237	100.0	7.893e-49
URI89H	contig_15	9331	8902	429	renamed_GCF_000008685.2	cp32-1	7827	8256	429	100.0	5.601e-92
URI89H	contig_25	191	743	552	renamed_GCF_000008685.2	lp56	855	1407	552	100.0	4.97e-122
URI89H	contig_1	22102	21058	1044	renamed_GCF_000008685.2	chromosome	22101	21057	1044	100.0	6.693e-227
URI89H	contig_1	22740	22146	594	renamed_GCF_000008685.2	chromosome	22739	22145	594	100.0	3.27e-125
URI89H	contig_1	22819	23959	1140	renamed_GCF_000008685.2	chromosome	22818	23958	1140	100.0	2.624e-262
URI89H	contig_1	24697	23965	732	renamed_GCF_000008685.2	chromosome	24696	23964	732	100.0	2.844e-158
URI89H	contig_1	25624	24697	927	renamed_GCF_000008685.2	chromosome	25623	24696	927	100.0	1.199e-200
URI89H	contig_1	25753	26392	639	renamed_GCF_000008685.2	chromosome	25752	26391	639	100.0	1.211e-143
URI89H	contig_1	26399	27449	1050	renamed_GCF_000008685.2	chromosome	26398	27448	1050	100.0	7.794e-235
URI89H	contig_1	27866	27434	432	renamed_GCF_000008685.2	chromosome	27865	27433	432	100.0	2.641e-92
URI89H	contig_1	60040	59101	939	renamed_GCF_000008685.2	chromosome	60039	59100	939	100.0	4.091e-206
URI89H	contig_1	61258	60568	690	renamed_GCF_000008685.2	chromosome	61257	60567	690	100.0	1.401e-150
URI89H	contig_1	64038	65277	1239	renamed_GCF_000008685.2	chromosome	64037	65276	1239	100.0	5.707e-279
URI89H	contig_1	112338	111888	450	renamed_GCF_000008685.2	chromosome	112338	111888	450	100.0	4.387e-98
URI89H	contig_1	122491	121879	612	renamed_GCF_000008685.2	chromosome	122491	121879	612	100.0	3.269e-128
URI89H	contig_1	124814	124148	666	renamed_GCF_000008685.2	chromosome	124814	124148	666	100.0	8.347e-144
URI89H	contig_1	126301	125533	768	renamed_GCF_000008685.2	chromosome	126301	125533	768	100.0	3.291e-171
URI89H	contig_1	130132	127426	2706	renamed_GCF_000008685.2	chromosome	130132	127426	2706	100.0	0.0
URI89H	contig_1	131297	132425	1128	renamed_GCF_000008685.2	chromosome	131297	132425	1128	100.0	3.566e-248
URI89H	contig_1	159369	160044	675	renamed_GCF_000008685.2	chromosome	159367	160042	675	100.0	1.946e-144
URI89H	contig_1	162803	161201	1602	renamed_GCF_000008685.2	chromosome	162801	161199	1602	100.0	0.0
URI89H	contig_1	164822	163073	1749	renamed_GCF_000008685.2	chromosome	164820	163071	1749	100.0	0.0
URI89H	contig_1	167761	165916	1845	renamed_GCF_000008685.2	chromosome	167759	165914	1845	100.0	0.0
URI89H	contig_1	169540	170710	1170	renamed_GCF_000008685.2	chromosome	169562	170708	1170	99.7	6.062e-258
URI89H	contig_1	272682	270489	2193	renamed_GCF_000008685.2	chromosome	272641	270487	2193	100.0	0.0
URI89H	contig_1	276498	275244	1254	renamed_GCF_000008685.2	chromosome	276496	275242	1254	100.0	4.99e-283
URI89H	contig_1	278561	277091	1470	renamed_GCF_000008685.2	chromosome	278559	277089	1470	100.0	8.9e-322
URI89H	contig_1	279382	279079	303	renamed_GCF_000008685.2	chromosome	279380	279077	303	100.0	2.087e-65
URI89H	contig_1	281795	281315	480	renamed_GCF_000008685.2	chromosome	281793	281313	480	100.0	1.072e-101
URI89H	contig_1	300766	299731	1035	renamed_GCF_000008685.2	chromosome	300764	299729	1035	100.0	3.255e-216
URI89H	contig_1	302838	302505	333	renamed_GCF_000008685.2	chromosome	302839	302503	333	99.0	1.253e-67
URI89H	contig_1	303742	303334	408	renamed_GCF_000008685.2	chromosome	303740	303332	408	100.0	2.649e-88
URI89H	contig_1	305122	303775	1347	renamed_GCF_000008685.2	chromosome	305120	303773	1347	100.0	1.016e-290
URI89H	contig_1	305663	305114	549	renamed_GCF_000008685.2	chromosome	305661	305112	549	100.0	9.24e-115
URI89H	contig_1	306620	305672	948	renamed_GCF_000008685.2	chromosome	306615	305670	948	100.0	3.249e-210
URI89H	contig_1	307319	306626	693	renamed_GCF_000008685.2	chromosome	307317	306624	693	100.0	2.971e-151
URI89H	contig_1	308519	307319	1200	renamed_GCF_000008685.2	chromosome	308517	307317	1200	100.0	3.302e-261
URI89H	contig_1	319119	318279	840	renamed_GCF_000008685.2	chromosome	319116	318276	840	99.6	1.977e-180
URI89H	contig_1	319639	319108	531	renamed_GCF_000008685.2	chromosome	319636	319105	531	100.0	1.699e-113
URI89H	contig_1	320261	319682	579	renamed_GCF_000008685.2	chromosome	320249	319679	579	99.4	6.936e-123
URI89H	contig_1	320311	321355	1044	renamed_GCF_000008685.2	chromosome	320308	321352	1044	100.0	3.013e-227
URI89H	contig_1	321354	322041	687	renamed_GCF_000008685.2	chromosome	321351	322038	687	100.0	1.336e-150
URI89H	contig_1	322849	322042	807	renamed_GCF_000008685.2	chromosome	322846	322039	807	99.6	2.064e-174
URI89H	contig_1	359498	359219	279	renamed_GCF_000008685.2	chromosome	359495	359216	279	100.0	2.841e-58
URI89H	contig_1	361081	359515	1566	renamed_GCF_000008685.2	chromosome	361078	359512	1566	100.0	0.0
URI89H	contig_1	361202	362324	1122	renamed_GCF_000008685.2	chromosome	361187	362321	1122	100.0	1.01e-252
URI89H	contig_1	364120	362320	1800	renamed_GCF_000008685.2	chromosome	364117	362317	1800	100.0	0.0
URI89H	contig_1	365083	364132	951	renamed_GCF_000008685.2	chromosome	364972	364129	951	99.6	1.174e-187
URI89H	contig_1	365606	365117	489	renamed_GCF_000008685.2	chromosome	365603	365114	489	100.0	3.787e-106
URI89H	contig_1	366963	366231	732	renamed_GCF_000008685.2	chromosome	366960	366228	732	100.0	5.239e-160
URI89H	contig_1	368458	368884	426	renamed_GCF_000008685.2	chromosome	368455	368881	426	100.0	3.899e-87
URI89H	contig_1	368887	370030	1143	renamed_GCF_000008685.2	chromosome	368884	370027	1143	100.0	3.212e-243
URI89H	contig_1	370029	371016	987	renamed_GCF_000008685.2	chromosome	370026	371013	987	100.0	7.343e-225
URI89H	contig_1	371036	373049	2013	renamed_GCF_000008685.2	chromosome	371033	373046	2013	100.0	0.0
URI89H	contig_1	373142	373523	381	renamed_GCF_000008685.2	chromosome	373139	373520	381	100.0	1.683e-80
URI89H	contig_1	396509	395483	1026	renamed_GCF_000008685.2	chromosome	396506	395480	1026	100.0	3.003e-224
URI89H	contig_1	397080	396606	474	renamed_GCF_000008685.2	chromosome	397077	396603	474	100.0	4.822e-101
URI89H	contig_1	397479	397104	375	renamed_GCF_000008685.2	chromosome	397476	397101	375	100.0	1.385e-81
URI89H	contig_1	401680	397546	4134	renamed_GCF_000008685.2	chromosome	401677	397543	4134	100.0	0.0
URI89H	contig_1	405620	405245	375	renamed_GCF_000008685.2	chromosome	405617	405242	375	100.0	5.555e-75
URI89H	contig_1	424451	423827	624	renamed_GCF_000008685.2	chromosome	424442	423821	624	100.0	2.036e-135
URI89H	contig_1	424698	425556	858	renamed_GCF_000008685.2	chromosome	424693	425551	858	100.0	1.579e-194
URI89H	contig_1	425588	426716	1128	renamed_GCF_000008685.2	chromosome	425583	426711	1128	100.0	1.044e-244
URI89H	contig_1	426740	427955	1215	renamed_GCF_000008685.2	chromosome	426735	427950	1215	100.0	1.711e-262
URI89H	contig_1	459920	460076	156	renamed_GCF_000008685.2	chromosome	459915	460071	156	100.0	2.965e-30
URI89H	contig_1	460056	460416	360	renamed_GCF_000008685.2	chromosome	460051	460411	360	100.0	4.812e-74
URI89H	contig_1	462049	462778	729	renamed_GCF_000008685.2	chromosome	462044	462773	729	100.0	2.248e-160
URI89H	contig_1	462823	463891	1068	renamed_GCF_000008685.2	chromosome	462818	463886	1068	100.0	4.491e-244
URI89H	contig_1	464057	465137	1080	renamed_GCF_000008685.2	chromosome	464052	465132	1080	100.0	9.122e-247
URI89H	contig_1	475610	476216	606	renamed_GCF_000008685.2	chromosome	475605	476211	606	100.0	1.006e-131
URI89H	contig_1	478079	476267	1812	renamed_GCF_000008685.2	chromosome	478005	476262	1812	100.0	0.0
URI89H	contig_1	479713	481024	1311	renamed_GCF_000008685.2	chromosome	479708	481019	1311	100.0	7.438e-297
URI89H	contig_1	489496	489724	228	renamed_GCF_000008685.2	chromosome	489539	489719	228	100.0	1.455e-33
URI89H	contig_1	489737	490559	822	renamed_GCF_000008685.2	chromosome	489732	490554	822	99.6	6.708e-181
URI89H	contig_1	490648	491932	1284	renamed_GCF_000008685.2	chromosome	490643	491927	1284	100.0	9.564e-281
URI89H	contig_1	492592	493957	1365	renamed_GCF_000008685.2	chromosome	492587	493952	1365	100.0	1.721e-296
URI89H	contig_1	494547	494154	393	renamed_GCF_000008685.2	chromosome	494539	494149	393	100.0	4.545e-80
URI89H	contig_1	495037	496222	1185	renamed_GCF_000008685.2	chromosome	495032	496217	1185	100.0	4.832e-263
URI89H	contig_1	513230	514532	1302	renamed_GCF_000008685.2	chromosome	513225	514527	1302	100.0	1.62e-286
URI89H	contig_1	535704	537528	1824	renamed_GCF_000008685.2	chromosome	535703	537527	1824	100.0	0.0
URI89H	contig_1	537520	538309	789	renamed_GCF_000008685.2	chromosome	537543	538308	789	99.6	2.994e-167
URI89H	contig_1	543049	543817	768	renamed_GCF_000008685.2	chromosome	543048	543816	768	100.0	8.433e-178
URI89H	contig_1	557423	556562	861	renamed_GCF_000008685.2	chromosome	557423	556562	861	100.0	5.864e-189
URI89H	contig_1	560732	558005	2727	renamed_GCF_000008685.2	chromosome	560732	558005	2727	100.0	0.0
URI89H	contig_1	561554	561116	438	renamed_GCF_000008685.2	chromosome	561554	561116	438	100.0	1.44e-91
URI89H	contig_1	562184	564167	1983	renamed_GCF_000008685.2	chromosome	562184	564167	1983	100.0	0.0
URI89H	contig_1	565969	567823	1854	renamed_GCF_000008685.2	chromosome	565954	567823	1854	99.8	0.0
URI89H	contig_1	577949	578261	312	renamed_GCF_000008685.2	chromosome	577949	578261	312	100.0	5.387e-65
URI89H	contig_1	580485	581643	1158	renamed_GCF_000008685.2	chromosome	580485	581643	1158	100.0	7.971e-253
URI89H	contig_1	583457	583832	375	renamed_GCF_000008685.2	chromosome	583457	583832	375	100.0	8.349e-79
URI89H	contig_1	585091	586156	1065	renamed_GCF_000008685.2	chromosome	585079	586156	1065	99.7	1.659e-237
URI89H	contig_1	588065	589667	1602	renamed_GCF_000008685.2	chromosome	588065	589667	1602	100.0	0.0
URI89H	contig_1	606983	604778	2205	renamed_GCF_000008685.2	chromosome	606983	604778	2205	100.0	0.0
URI89H	contig_1	665010	663177	1833	renamed_GCF_000008685.2	chromosome	665011	663178	1833	100.0	0.0
URI89H	contig_1	673210	671764	1446	renamed_GCF_000008685.2	chromosome	673167	671766	1446	100.0	1.676e-310
URI89H	contig_1	675032	676376	1344	renamed_GCF_000008685.2	chromosome	675034	676378	1344	100.0	3.635e-293
URI89H	contig_1	678936	677889	1047	renamed_GCF_000008685.2	chromosome	678938	677891	1047	100.0	5.633e-238
URI89H	contig_1	680561	679751	810	renamed_GCF_000008685.2	chromosome	680557	679753	810	99.6	5.278e-173
URI89H	contig_1	682522	681682	840	renamed_GCF_000008685.2	chromosome	682524	681684	840	100.0	1.641e-182
URI89H	contig_1	683420	684965	1545	renamed_GCF_000008685.2	chromosome	683422	684967	1545	100.0	0.0
URI89H	contig_1	686505	685974	531	renamed_GCF_000008685.2	chromosome	686507	685976	531	100.0	1.053e-118
URI89H	contig_1	688487	690125	1638	renamed_GCF_000008685.2	chromosome	688489	690127	1638	100.0	0.0
URI89H	contig_1	748120	750016	1896	renamed_GCF_000008685.2	chromosome	748122	750018	1896	100.0	0.0
URI89H	contig_1	751188	752157	969	renamed_GCF_000008685.2	chromosome	751190	752159	969	100.0	4.772e-218
URI89H	contig_1	753220	754066	846	renamed_GCF_000008685.2	chromosome	753291	754068	846	100.0	1.342e-168
URI89H	contig_1	754547	756347	1800	renamed_GCF_000008685.2	chromosome	754636	756349	1800	100.0	0.0
URI89H	contig_1	771561	771159	402	renamed_GCF_000008685.2	chromosome	771563	771161	402	100.0	3.917e-83
URI89H	contig_1	774674	775460	786	renamed_GCF_000008685.2	chromosome	774676	775462	786	100.0	1.17e-168
URI89H	contig_1	776782	777571	789	renamed_GCF_000008685.2	chromosome	776784	777573	789	100.0	8.439e-173
URI89H	contig_1	782827	782149	678	renamed_GCF_000008685.2	chromosome	782829	782151	678	100.0	4.744e-152
URI89H	contig_1	860447	861782	1335	renamed_GCF_000008685.2	chromosome	860439	861774	1335	100.0	8.434e-291
URI89H	contig_1	863644	865051	1407	renamed_GCF_000008685.2	chromosome	863635	865042	1407	100.0	1.287e-315
URI89H	contig_1	865070	865928	858	renamed_GCF_000008685.2	chromosome	865052	865919	858	100.0	6.741e-187
URI89H	contig_1	866689	867610	921	renamed_GCF_000008685.2	chromosome	866680	867601	921	100.0	3.086e-206
URI89H	contig_1	868203	868749	546	renamed_GCF_000008685.2	chromosome	868194	868740	546	100.0	1.846e-123
URI89H	contig_1	888188	886478	1710	renamed_GCF_000008685.2	chromosome	888179	886469	1710	100.0	0.0
URI89H	contig_1	890330	893183	2853	renamed_GCF_000008685.2	chromosome	890321	893174	2853	100.0	0.0
URI89H	contig_1	897136	896587	549	renamed_GCF_000008685.2	chromosome	897127	896578	549	100.0	1.159e-120
URI89H	contig_1	899329	897712	1617	renamed_GCF_000008685.2	chromosome	899320	897703	1617	100.0	0.0
URI89H	contig_2	40112	39359	753	renamed_GCF_000008685.2	lp54	13554	14307	753	100.0	4.561e-165
URI89H	contig_2	48526	49000	474	renamed_GCF_000008685.2	lp54	5140	4666	474	100.0	5.31e-100
URI89H	contig_2	50773	51622	849	renamed_GCF_000008685.2	lp54	2893	2044	849	100.0	5.332e-188
URI89H	contig_3	12880	11962	918	renamed_GCF_000008685.2	lp38	31219	32140	918	99.6	1.1e-208
URI89H	contig_3	16049	16760	711	renamed_GCF_000008685.2	lp38	28053	26994	711	100.0	1.615e-152
URI89H	contig_3	22136	21098	1038	renamed_GCF_000008685.2	lp38	22042	23008	1038	99.6	1.164e-219
URI89H	contig_3	24106	22876	1230	renamed_GCF_000008685.2	lp38	20000	21230	1230	100.0	1.496e-266
URI89H	contig_5	7551	7203	348	renamed_GCF_000008685.2	cp32-8	15421	15769	348	100.0	8.822e-74
URI89H	contig_5	7758	7554	204	renamed_GCF_000008685.2	cp32-7	15221	15425	204	100.0	2.578e-39
URI89H	contig_5	25660	25087	573	renamed_GCF_000008685.2	lp56	31167	31710	573	100.0	2.482e-116
URI89H	contig_5	27291	28068	777	renamed_GCF_000008685.2	lp56	29506	28729	777	99.6	1.553e-172
URI89H	contig_6	9494	9752	258	renamed_GCF_000008685.2	lp28-1	8771	9029	258	100.0	1.351e-54
URI89H	contig_6	14516	13751	765	renamed_GCF_000008685.2	lp28-1	13793	13028	765	100.0	1.871e-168
URI89H	contig_6	16174	15073	1101	renamed_GCF_000008685.2	lp28-1	15451	14350	1101	100.0	2.133e-249
URI89H	contig_8	7142	7379	237	renamed_GCF_000008685.2	cp32-4	8733	8970	237	100.0	1.76e-48
URI89H	contig_9	6854	7400	546	renamed_GCF_000008685.2	cp32-7	11927	12473	546	100.0	8.009e-116
URI89H	contig_9	7758	8637	879	renamed_GCF_000008685.2	cp32-7	12831	13710	879	99.6	3.187e-190
URI89H	contig_9	9257	10073	816	renamed_GCF_000008685.2	cp32-8	14323	15139	816	100.0	1.636e-178
URI89H	contig_9	10355	10703	348	renamed_GCF_000008685.2	cp32-9	15518	15866	348	100.0	8.822e-74
URI89H	contig_10	15768	15210	558	renamed_GCF_000008685.2	cp32-7	2009	2567	558	100.0	1.105e-122
URI89H	contig_11	5592	6543	951	renamed_GCF_000008685.2	cp32-9	11040	11991	951	100.0	9.63e-216
URI89H	contig_11	7144	7477	333	renamed_GCF_000008685.2	cp32-9	12592	12925	333	100.0	1.876e-71
URI89H	contig_11	16735	17275	540	renamed_GCF_000008685.2	cp32-9	22183	22723	540	100.0	1.782e-114
URI89H	contig_11	19123	19549	426	renamed_GCF_000008685.2	cp32-9	24571	24997	426	100.0	1.627e-96
URI89H	contig_11	20761	21322	561	renamed_GCF_000008685.2	cp32-9	26209	26770	561	100.0	4.739e-124
URI89H	contig_11	22577	23096	519	renamed_GCF_000008685.2	cp32-9	28025	28544	519	99.4	3.122e-113
URI89H	contig_11	23850	25203	1353	renamed_GCF_000008685.2	cp32-9	29298	30651	1353	100.0	6.259e-306
URI89H	contig_12	2355	2811	456	renamed_GCF_000008685.2	cp32-4	8281	8737	456	100.0	1.971e-99
URI89H	contig_12	3051	4347	1296	renamed_GCF_000008685.2	cp32-4	8977	10273	1296	100.0	2.13e-282
URI89H	contig_12	4969	5920	951	renamed_GCF_000008685.2	cp32-4	10895	11846	951	100.0	4.333e-216
URI89H	contig_12	5937	6492	555	renamed_GCF_000008685.2	cp32-4	11863	12418	555	100.0	3.12e-119
URI89H	contig_12	6850	7726	876	renamed_GCF_000008685.2	cp32-4	12776	13652	876	100.0	5.609e-192
URI89H	contig_13	4129	3523	606	renamed_GCF_000008685.2	cp32-8	13708	14314	606	100.0	5.47e-130
URI89H	contig_13	12070	11680	390	renamed_GCF_000008685.2	cp32-4	5777	6167	390	100.0	3.229e-83
URI89H	contig_13	12896	12440	456	renamed_GCF_000008685.2	cp32-1	4941	5397	456	100.0	1.075e-97
URI89H	contig_13	15263	14498	765	renamed_GCF_000008685.2	cp32-7	2573	3338	765	99.6	3.139e-171
URI89H	contig_13	16532	15839	693	renamed_GCF_000008685.2	cp32-1	1305	1998	693	100.0	2.582e-144
URI89H	contig_13	19190	17837	1353	renamed_GCF_000008685.2	cp32-3	28870	30223	1353	99.7	1.39e-305
URI89H	contig_14	16605	15579	1026	renamed_GCF_000008685.2	lp28-2	16482	15456	1026	100.0	1.723e-230
URI89H	contig_14	18142	17803	339	renamed_GCF_000008685.2	lp28-2	18019	17680	339	100.0	5.085e-70
URI89H	contig_14	19742	18959	783	renamed_GCF_000008685.2	lp28-2	19619	18836	783	100.0	1.354e-183
URI89H	contig_15	19261	19930	669	renamed_GCF_000008685.2	cp32-6	27745	27076	669	100.0	4.521e-151
URI89H	contig_15	21180	21957	777	renamed_GCF_000008685.2	cp32-7	25720	24943	777	100.0	1.414e-173
URI89H	contig_17	6131	7649	1518	renamed_GCF_000008685.2	lp28-4	7182	8538	1518	89.3	3.728e-287
URI89H	contig_17	11034	11589	555	renamed_GCF_000008685.2	lp28-4	11923	12478	555	100.0	3.559e-126
URI89H	contig_17	12375	12948	573	renamed_GCF_000008685.2	lp28-4	13264	13837	573	100.0	2.579e-124
URI89H	contig_17	22042	21205	837	renamed_GCF_000008685.2	lp28-4	22931	22094	837	100.0	1.426e-183
URI89H	contig_17	24200	23333	867	renamed_GCF_000008685.2	lp28-4	25089	24222	867	100.0	1.188e-190
URI89H	contig_17	25147	24904	243	renamed_GCF_000008685.2	lp28-4	26036	25793	243	100.0	2.599e-53
URI89H	contig_18	144	651	507	renamed_GCF_000008685.2	cp26	21364	20857	507	100.0	3.123e-111
URI89H	contig_18	722	2078	1356	renamed_GCF_000008685.2	cp26	20786	19430	1356	100.0	1.798e-294
URI89H	contig_18	17069	16751	318	renamed_GCF_000008685.2	cp26	4481	4757	318	100.0	7.253e-55
URI89H	contig_18	17710	19033	1323	renamed_GCF_000008685.2	cp26	3798	2475	1323	100.0	1.419e-291
URI89H	contig_18	20757	21201	444	renamed_GCF_000008685.2	cp26	751	307	444	100.0	2.98e-101
URI89H	contig_18	23182	21553	1629	renamed_GCF_000008685.2	cp26	24824	26453	1629	100.0	0.0
URI89H	contig_1	11421	12162	741	renamed_GCF_000008685.2	chromosome	11420	12161	741	100.0	4.147e-164
URI89H	contig_1	12154	12754	600	renamed_GCF_000008685.2	chromosome	12153	12753	600	100.0	4.114e-132
URI89H	contig_1	12746	14729	1983	renamed_GCF_000008685.2	chromosome	12745	14728	1983	100.0	0.0
URI89H	contig_1	15346	14725	621	renamed_GCF_000008685.2	chromosome	15345	14724	621	100.0	3.249e-138
URI89H	contig_1	15723	15345	378	renamed_GCF_000008685.2	chromosome	15716	15344	378	100.0	1.768e-79
URI89H	contig_1	15995	16805	810	renamed_GCF_000008685.2	chromosome	15994	16804	810	100.0	1.068e-173
URI89H	contig_1	29473	28492	981	renamed_GCF_000008685.2	chromosome	29472	28491	981	100.0	8.047e-223
URI89H	contig_1	31027	31480	453	renamed_GCF_000008685.2	chromosome	31026	31479	453	100.0	2.279e-97
URI89H	contig_1	34038	32157	1881	renamed_GCF_000008685.2	chromosome	34037	32156	1881	100.0	0.0
URI89H	contig_1	41433	40761	672	renamed_GCF_000008685.2	chromosome	41432	40760	672	100.0	1.856e-144
URI89H	contig_1	42882	42480	402	renamed_GCF_000008685.2	chromosome	42881	42479	402	100.0	2.405e-88
URI89H	contig_1	45446	45992	546	renamed_GCF_000008685.2	chromosome	45445	45991	546	100.0	3.273e-117
URI89H	contig_1	47167	47842	675	renamed_GCF_000008685.2	chromosome	47166	47841	675	100.0	3.937e-145
URI89H	contig_1	49260	48603	657	renamed_GCF_000008685.2	chromosome	49259	48602	657	100.0	2.137e-140
URI89H	contig_1	50475	50112	363	renamed_GCF_000008685.2	chromosome	50474	50111	363	100.0	4.578e-75
URI89H	contig_1	52435	51253	1182	renamed_GCF_000008685.2	chromosome	52434	51252	1182	100.0	6.664e-259
URI89H	contig_1	55505	53534	1971	renamed_GCF_000008685.2	chromosome	55504	53533	1971	100.0	0.0
URI89H	contig_1	56749	56281	468	renamed_GCF_000008685.2	chromosome	56748	56280	468	100.0	3.979e-102
URI89H	contig_1	57186	56832	354	renamed_GCF_000008685.2	chromosome	57185	56831	354	100.0	1.322e-78
URI89H	contig_1	101339	100745	594	renamed_GCF_000008685.2	chromosome	101339	100745	594	100.0	6.255e-135
URI89H	contig_1	112769	112349	420	renamed_GCF_000008685.2	chromosome	112769	112349	420	100.0	6.488e-89
URI89H	contig_1	114806	115508	702	renamed_GCF_000008685.2	chromosome	114806	115508	702	100.0	2.35e-155
URI89H	contig_1	118929	118374	555	renamed_GCF_000008685.2	chromosome	118929	118374	555	100.0	1.543e-118
URI89H	contig_1	120589	119806	783	renamed_GCF_000008685.2	chromosome	120589	119806	783	100.0	5.024e-169
URI89H	contig_1	133842	132471	1371	renamed_GCF_000008685.2	chromosome	133842	132471	1371	100.0	2.422e-302
URI89H	contig_1	133974	135864	1890	renamed_GCF_000008685.2	chromosome	133974	135864	1890	100.0	0.0
URI89H	contig_1	138745	138433	312	renamed_GCF_000008685.2	chromosome	138745	138433	312	100.0	1.981e-67
URI89H	contig_1	144268	142945	1323	renamed_GCF_000008685.2	chromosome	144230	142943	1323	99.7	1.75e-280
URI89H	contig_1	178862	177869	993	renamed_GCF_000008685.2	chromosome	178860	177867	993	100.0	4.528e-214
URI89H	contig_1	189861	189300	561	renamed_GCF_000008685.2	chromosome	189859	189298	561	100.0	1.275e-121
URI89H	contig_1	190720	191461	741	renamed_GCF_000008685.2	chromosome	190718	191459	741	100.0	7.281e-158
URI89H	contig_1	193465	192325	1140	renamed_GCF_000008685.2	chromosome	193463	192323	1140	100.0	4.164e-257
URI89H	contig_1	194877	195738	861	renamed_GCF_000008685.2	chromosome	194875	195736	861	99.6	3.179e-187
URI89H	contig_1	211302	212070	768	renamed_GCF_000008685.2	chromosome	211300	212068	768	100.0	8.822e-169
URI89H	contig_1	215428	217261	1833	renamed_GCF_000008685.2	chromosome	215426	217259	1833	100.0	0.0
URI89H	contig_1	219080	218426	654	renamed_GCF_000008685.2	chromosome	219078	218424	654	100.0	1.052e-147
URI89H	contig_1	219801	220641	840	renamed_GCF_000008685.2	chromosome	219799	220639	840	100.0	1.641e-182
URI89H	contig_1	221635	223180	1545	renamed_GCF_000008685.2	chromosome	221741	223178	1545	99.7	1.424e-311
URI89H	contig_1	237144	235596	1548	renamed_GCF_000008685.2	chromosome	237142	235594	1548	100.0	0.0
URI89H	contig_1	237958	237631	327	renamed_GCF_000008685.2	chromosome	237956	237629	327	100.0	8.435e-71
URI89H	contig_1	239130	238302	828	renamed_GCF_000008685.2	chromosome	239128	238300	828	100.0	9.354e-187
URI89H	contig_1	242291	240284	2007	renamed_GCF_000008685.2	chromosome	242289	240282	2007	100.0	0.0
URI89H	contig_1	244715	243944	771	renamed_GCF_000008685.2	chromosome	244713	243942	771	100.0	4.161e-169
URI89H	contig_1	245791	246556	765	renamed_GCF_000008685.2	chromosome	245789	246554	765	100.0	7.663e-170
URI89H	contig_1	246598	248104	1506	renamed_GCF_000008685.2	chromosome	246596	248102	1506	100.0	0.0
URI89H	contig_1	251213	250658	555	renamed_GCF_000008685.2	chromosome	251211	250656	555	100.0	3.12e-119
URI89H	contig_1	252435	253041	606	renamed_GCF_000008685.2	chromosome	252433	253039	606	100.0	4.115e-133
URI89H	contig_1	298778	297467	1311	renamed_GCF_000008685.2	chromosome	298776	297465	1311	100.0	6.981e-289
URI89H	contig_1	309782	308540	1242	renamed_GCF_000008685.2	chromosome	309780	308538	1242	100.0	1.368e-269
URI89H	contig_1	311655	310560	1095	renamed_GCF_000008685.2	chromosome	311617	310558	1095	99.7	2.491e-229
URI89H	contig_1	314430	314148	282	renamed_GCF_000008685.2	chromosome	314427	314145	282	100.0	2.699e-59
URI89H	contig_1	316146	315309	837	renamed_GCF_000008685.2	chromosome	316143	315306	837	100.0	2.887e-184
URI89H	contig_1	318008	317249	759	renamed_GCF_000008685.2	chromosome	318005	317246	759	100.0	1.223e-163
URI89H	contig_1	329264	329624	360	renamed_GCF_000008685.2	chromosome	329261	329621	360	100.0	1.609e-77
URI89H	contig_4	30434	29447	987	renamed_GCF_000008685.2	lp36	30463	29476	987	100.0	5.255e-220
URI89H	contig_5	887	218	669	renamed_GCF_000008685.2	cp32-6	22101	22770	669	100.0	2.138e-142
URI89H	contig_6	8634	8076	558	renamed_GCF_000008685.2	lp28-1	7869	7353	558	100.0	3.959e-117
URI89H	contig_6	28875	29949	1074	renamed_GCF_000008685.2	lp28-1	26996	28073	1074	90.7	1.394e-197
URI89H	contig_7	14091	14712	621	renamed_GCF_000008685.2	lp25	10187	9566	621	100.0	1.329e-139
URI89H	contig_8	19856	20606	750	renamed_GCF_000008685.2	cp32-7	20765	21515	750	100.0	2.593e-162
URI89H	contig_9	690	1080	390	renamed_GCF_000008685.2	cp32-6	5774	6164	390	100.0	1.451e-83
URI89H	contig_9	3197	3653	456	renamed_GCF_000008685.2	cp32-7	8273	8729	456	98.0	2.171e-98
URI89H	contig_9	3893	5231	1338	renamed_GCF_000008685.2	cp32-7	8969	10304	1338	97.0	1.193e-278
URI89H	contig_9	13658	12641	1017	renamed_GCF_000008685.2	cp32-1	18728	17714	1017	84.6	5.985e-189
URI89H	contig_10	21686	20594	1092	renamed_GCF_000008685.2	cp32-7	26892	27984	1092	65.8	3.036e-147
URI89H	contig_11	721	1288	567	renamed_GCF_000008685.2	cp32-9	6169	6736	567	100.0	2.131e-125
URI89H	contig_11	3537	4812	1275	renamed_GCF_000008685.2	cp32-9	8985	10260	1275	100.0	5.405e-277
URI89H	contig_11	10407	10743	336	renamed_GCF_000008685.2	cp32-8	15758	16094	336	100.0	5.348e-69
URI89H	contig_11	11853	12282	429	renamed_GCF_000008685.2	cp32-9	17301	17730	429	100.0	2.284e-93
URI89H	contig_11	13715	14816	1101	renamed_GCF_000008685.2	cp32-9	19163	20264	1101	100.0	3.592e-252
URI89H	contig_11	15368	16124	756	renamed_GCF_000008685.2	cp32-9	20816	21572	756	100.0	2.151e-165
URI89H	contig_11	25268	26495	1227	renamed_GCF_000008685.2	cp32-9	65	1292	1227	99.7	1.084e-269
URI89H	contig_11	27215	27782	567	renamed_GCF_000008685.2	lp56	35818	36385	567	99.4	4.74e-125
URI89H	contig_11	30160	30616	456	renamed_GCF_000008685.2	cp32-9	4957	5413	456	100.0	4.83e-98
URI89H	contig_12	784	1897	1113	renamed_GCF_000008685.2	cp32-4	6710	7823	1113	100.0	1.393e-247
URI89H	contig_12	9240	9444	204	renamed_GCF_000008685.2	lp56	18712	18916	204	100.0	2.578e-39
URI89H	contig_13	10010	9581	429	renamed_GCF_000008685.2	cp32-7	7829	8258	429	100.0	5.601e-92
URI89H	contig_13	11684	11117	567	renamed_GCF_000008685.2	cp32-3	6153	6720	567	100.0	9.584e-126
URI89H	contig_13	20651	20141	510	renamed_GCF_000008685.2	cp32-3	27409	27919	510	100.0	3.969e-109
URI89H	contig_13	21784	22561	777	renamed_GCF_000008685.2	cp32-3	26276	25499	777	100.0	3.144e-173
URI89H	contig_13	24370	23044	1326	renamed_GCF_000008685.2	cp32-3	23690	25016	1326	100.0	1.445e-300
URI89H	contig_13	27346	26779	567	renamed_GCF_000008685.2	cp32-3	20714	21281	567	100.0	2.944e-130
URI89H	contig_13	28832	29774	942	renamed_GCF_000008685.2	cp32-3	19228	18286	942	100.0	4.129e-215
URI89H	contig_14	238	1132	894	renamed_GCF_000008685.2	lp28-2	115	1009	894	100.0	3.048e-193
URI89H	contig_14	26779	27208	429	renamed_GCF_000008685.2	lp28-2	26569	27085	429	100.0	3.799e-96
URI89H	contig_14	29741	28976	765	renamed_GCF_000008685.2	lp28-2	29618	28853	765	100.0	1.703e-169
URI89H	contig_15	1063	709	354	renamed_GCF_000008685.2	cp32-7	16093	16447	354	99.1	3.249e-77
URI89H	contig_15	8887	8431	456	renamed_GCF_000008685.2	cp32-1	8271	8727	456	100.0	1.971e-99
URI89H	contig_15	13199	12239	960	renamed_GCF_000008685.2	cp32-6	3969	4929	960	100.0	6.008e-214
URI89H	contig_18	4841	6377	1536	renamed_GCF_000008685.2	cp26	16667	15131	1536	100.0	0.0
URI89H	contig_18	9495	7902	1593	renamed_GCF_000008685.2	cp26	12013	13606	1593	100.0	0.0
URI89H	contig_18	11405	10856	549	renamed_GCF_000008685.2	cp26	10103	10652	549	100.0	6.94e-118
URI89H	contig_18	14832	13794	1038	renamed_GCF_000008685.2	cp26	6676	7714	1038	100.0	8.529e-232
URI89H	contig_18	26109	25413	696	renamed_GCF_000008685.2	cp26	21897	22593	696	100.0	1.401e-151
URI89H	contig_19	1806	2595	789	renamed_GCF_000008685.2	lp21	2867	3656	789	99.6	6.373e-176
URI89H	contig_19	4246	4777	531	renamed_GCF_000008685.2	cp9	4377	3852	531	66.4	4.169e-70
URI89H	contig_19	6198	7314	1116	renamed_GCF_000008685.2	cp9	162	1272	1116	88.3	1.916e-218
URI89H	contig_19	7441	7882	441	renamed_GCF_000008685.2	cp9	1281	1839	441	98.6	4.183e-97
URI89H	contig_19	16453	16168	285	renamed_GCF_000008685.2	lp21	16548	16227	285	98.9	2.097e-62
URI89H	contig_19	16826	17819	993	renamed_GCF_000008685.2	lp5	3339	4332	993	100.0	1.858e-215
URI89H	contig_19	19564	19132	432	renamed_GCF_000008685.2	lp5	4387	4819	432	99.3	2.641e-92
URI89H	contig_19	22149	21684	465	renamed_GCF_000008685.2	lp21	15348	15813	465	99.3	4.176e-101
URI89H	contig_20	60	801	741	renamed_GCF_000008685.2	lp17	13338	14079	741	100.0	7.64e-166
URI89H	contig_22	1198	238	960	renamed_GCF_000008685.2	lp56	7432	8392	960	100.0	6.008e-214
URI89H	contig_22	2291	2828	537	renamed_GCF_000008685.2	lp56	6339	5802	537	100.0	1.599e-123
URI89H	contig_22	3644	4382	738	renamed_GCF_000008685.2	lp56	4986	4248	738	100.0	1.779e-164
URI89H	contig_22	5008	4522	486	renamed_GCF_000008685.2	lp56	3622	4108	486	100.0	4.376e-104
URI89H	contig_23	841	208	633	renamed_GCF_000008685.2	cp32-1	22130	22763	633	100.0	1.275e-133
URI89H	contig_23	2206	1465	741	renamed_GCF_000008685.2	cp32-1	20765	21506	741	100.0	1.112e-161
URI89H	contig_24	774	1386	612	renamed_GCF_000008685.2	lp56	20843	21455	612	100.0	1.152e-139
URI89H	contig_26	282	648	366	renamed_GCF_000008685.2	lp21	252	618	366	100.0	7.218e-79
URI89H	contig_1	89808	89199	609	renamed_GCF_000008685.2	chromosome	89808	89199	609	100.0	1.275e-129
URI89H	contig_1	103771	103015	756	renamed_GCF_000008685.2	chromosome	103771	103015	756	100.0	4.353e-166
URI89H	contig_1	105846	105417	429	renamed_GCF_000008685.2	chromosome	105846	105417	429	100.0	3.057e-90
URI89H	contig_1	108170	106973	1197	renamed_GCF_000008685.2	chromosome	108170	106973	1197	100.0	8.414e-259
URI89H	contig_1	111042	109674	1368	renamed_GCF_000008685.2	chromosome	111042	109674	1368	100.0	1.976e-295
URI89H	contig_1	111875	111584	291	renamed_GCF_000008685.2	chromosome	111875	111584	291	100.0	1.894e-64
URI89H	contig_1	121823	121100	723	renamed_GCF_000008685.2	chromosome	121823	121100	723	100.0	1.695e-162
URI89H	contig_1	124146	122490	1656	renamed_GCF_000008685.2	chromosome	124146	122490	1656	100.0	0.0
URI89H	contig_1	125547	124797	750	renamed_GCF_000008685.2	chromosome	125547	124797	750	100.0	1.281e-161
URI89H	contig_1	127413	126315	1098	renamed_GCF_000008685.2	chromosome	127413	126315	1098	100.0	1.369e-236
URI89H	contig_1	131114	130169	945	renamed_GCF_000008685.2	chromosome	131114	130169	945	100.0	6.888e-210
URI89H	contig_1	158629	159346	717	renamed_GCF_000008685.2	chromosome	158627	159344	717	100.0	1.01e-158
URI89H	contig_1	160091	161210	1119	renamed_GCF_000008685.2	chromosome	160089	161208	1119	100.0	2.349e-251
URI89H	contig_1	162879	163047	168	renamed_GCF_000008685.2	chromosome	162877	163045	168	100.0	5.294e-34
URI89H	contig_1	165889	164902	987	renamed_GCF_000008685.2	chromosome	165887	164900	987	100.0	2.687e-210
URI89H	contig_1	169401	167880	1521	renamed_GCF_000008685.2	chromosome	169399	167878	1521	100.0	0.0
URI89H	contig_1	181407	179541	1866	renamed_GCF_000008685.2	chromosome	181405	179539	1866	100.0	0.0
URI89H	contig_1	182804	181409	1395	renamed_GCF_000008685.2	chromosome	182802	181407	1395	100.0	4.219e-300
URI89H	contig_1	182887	183382	495	renamed_GCF_000008685.2	chromosome	182885	183380	495	100.0	9.271e-106
URI89H	contig_1	202851	204090	1239	renamed_GCF_000008685.2	chromosome	202849	204088	1239	100.0	5.514e-262
URI89H	contig_1	204138	205074	936	renamed_GCF_000008685.2	chromosome	204136	205072	936	100.0	4.7e-204
URI89H	contig_1	205074	206046	972	renamed_GCF_000008685.2	chromosome	205174	206044	972	99.6	3.289e-188
URI89H	contig_1	206530	208108	1578	renamed_GCF_000008685.2	chromosome	206528	208106	1578	100.0	0.0
URI89H	contig_1	208622	208085	537	renamed_GCF_000008685.2	chromosome	208581	208083	537	99.3	7.373e-107
URI89H	contig_1	224787	223965	822	renamed_GCF_000008685.2	chromosome	224785	223963	822	100.0	3.638e-179
URI89H	contig_1	226612	224827	1785	renamed_GCF_000008685.2	chromosome	226610	224825	1785	100.0	0.0
URI89H	contig_1	227829	226611	1218	renamed_GCF_000008685.2	chromosome	227827	226609	1218	100.0	6.126e-266
URI89H	contig_1	263714	261293	2421	renamed_GCF_000008685.2	chromosome	263712	261291	2421	100.0	0.0
URI89H	contig_1	263989	266116	2127	renamed_GCF_000008685.2	chromosome	263987	266114	2127	100.0	0.0
URI89H	contig_1	266108	267053	945	renamed_GCF_000008685.2	chromosome	266106	267051	945	100.0	6.277e-211
URI89H	contig_1	267067	267277	210	renamed_GCF_000008685.2	chromosome	267065	267275	210	100.0	4.647e-42
URI89H	contig_1	270475	269674	801	renamed_GCF_000008685.2	chromosome	270473	269672	801	100.0	6.66e-169
URI89H	contig_1	273649	272635	1014	renamed_GCF_000008685.2	chromosome	273647	272633	1014	100.0	5.532e-224
URI89H	contig_1	273855	275238	1383	renamed_GCF_000008685.2	chromosome	273856	275236	1383	99.7	2.662e-303
URI89H	contig_1	276559	277066	507	renamed_GCF_000008685.2	chromosome	276671	277064	507	100.0	6.298e-87
URI89H	contig_1	279060	278538	522	renamed_GCF_000008685.2	chromosome	279058	278536	522	100.0	3.966e-111
URI89H	contig_1	543832	544606	774	renamed_GCF_000008685.2	chromosome	543831	544605	774	100.0	1.787e-170
URI89H	contig_1	558024	557406	618	renamed_GCF_000008685.2	chromosome	558024	557406	618	100.0	1.216e-131
URI89H	contig_1	561127	560728	399	renamed_GCF_000008685.2	chromosome	561127	560728	399	100.0	7.535e-84
URI89H	contig_1	561943	561562	381	renamed_GCF_000008685.2	chromosome	561943	561562	381	100.0	2.258e-77
URI89H	contig_1	567809	568277	468	renamed_GCF_000008685.2	chromosome	567809	568277	468	100.0	1.969e-101
URI89H	contig_1	578276	580421	2145	renamed_GCF_000008685.2	chromosome	578276	580421	2145	100.0	0.0
URI89H	contig_1	581644	583417	1773	renamed_GCF_000008685.2	chromosome	581644	583417	1773	100.0	0.0
URI89H	contig_1	584880	584190	690	renamed_GCF_000008685.2	chromosome	584880	584190	690	100.0	9.609e-155
URI89H	contig_1	587030	587882	852	renamed_GCF_000008685.2	chromosome	587030	587882	852	100.0	3.506e-193
URI89H	contig_1	661514	659642	1872	renamed_GCF_000008685.2	chromosome	661515	659643	1872	100.0	0.0
URI89H	contig_1	662916	662601	315	renamed_GCF_000008685.2	chromosome	662917	662602	315	100.0	5.657e-65
URI89H	contig_1	668516	665006	3510	renamed_GCF_000008685.2	chromosome	668517	665007	3510	100.0	0.0
URI89H	contig_1	673339	674776	1437	renamed_GCF_000008685.2	chromosome	673341	674778	1437	100.0	0.0
URI89H	contig_1	676469	677858	1389	renamed_GCF_000008685.2	chromosome	676471	677860	1389	100.0	1.442e-302
URI89H	contig_1	679748	678956	792	renamed_GCF_000008685.2	chromosome	679750	678958	792	100.0	1.55e-166
URI89H	contig_1	681604	680560	1044	renamed_GCF_000008685.2	chromosome	681606	680562	1044	100.0	8.539e-233
URI89H	contig_1	682676	683375	699	renamed_GCF_000008685.2	chromosome	682678	683377	699	100.0	1.337e-152
URI89H	contig_1	685978	684994	984	renamed_GCF_000008685.2	chromosome	685980	684996	984	100.0	1.708e-223
URI89H	contig_1	703006	703966	960	renamed_GCF_000008685.2	chromosome	703008	703968	960	100.0	6.008e-214
URI89H	contig_1	703928	704957	1029	renamed_GCF_000008685.2	chromosome	703960	704959	1029	99.6	3.451e-223
URI89H	contig_1	729609	730503	894	renamed_GCF_000008685.2	chromosome	729612	730506	894	100.0	2.531e-195
URI89H	contig_1	731180	731717	537	renamed_GCF_000008685.2	chromosome	731183	731720	537	100.0	1.936e-121
URI89H	contig_1	734077	735286	1209	renamed_GCF_000008685.2	chromosome	734080	735289	1209	100.0	8.188e-270
URI89H	contig_1	736695	736956	261	renamed_GCF_000008685.2	chromosome	736698	736959	261	100.0	3.165e-54
URI89H	contig_1	736956	737205	249	renamed_GCF_000008685.2	chromosome	736959	737208	249	100.0	2.148e-48
URI89H	contig_1	737705	738425	720	renamed_GCF_000008685.2	chromosome	737708	738428	720	100.0	9.639e-160
URI89H	contig_1	750028	750787	759	renamed_GCF_000008685.2	chromosome	750030	750789	759	100.0	2.255e-165
URI89H	contig_1	752167	753217	1050	renamed_GCF_000008685.2	chromosome	752169	753219	1050	100.0	6.109e-229
URI89H	contig_1	754065	754548	483	renamed_GCF_000008685.2	chromosome	754067	754550	483	100.0	1.405e-107
URI89H	contig_1	756351	757668	1317	renamed_GCF_000008685.2	chromosome	756353	757670	1317	100.0	1.293e-291
URI89H	contig_1	774366	771567	2799	renamed_GCF_000008685.2	chromosome	774368	771569	2799	100.0	0.0
URI89H	contig_1	776677	775663	1014	renamed_GCF_000008685.2	chromosome	776679	775665	1014	100.0	1.623e-220
URI89H	contig_1	777762	778752	990	renamed_GCF_000008685.2	chromosome	777764	778754	990	100.0	1.559e-225
URI89H	contig_1	778755	781383	2628	renamed_GCF_000008685.2	chromosome	778757	781385	2628	100.0	0.0
URI89H	contig_1	783246	782973	273	renamed_GCF_000008685.2	chromosome	783248	782975	273	100.0	3.858e-54
URI89H	contig_1	862707	863655	948	renamed_GCF_000008685.2	chromosome	862698	863646	948	100.0	4.292e-207
URI89H	contig_1	865924	866467	543	renamed_GCF_000008685.2	chromosome	865915	866458	543	100.0	2.343e-120
URI89H	contig_2	32949	32754	195	renamed_GCF_000008685.2	lp54	20717	20912	195	100.0	2.214e-39
URI89H	contig_2	35539	34945	594	renamed_GCF_000008685.2	lp54	18127	18721	594	100.0	1.47e-125
URI89H	contig_2	37090	37666	576	renamed_GCF_000008685.2	lp54	16576	16000	576	100.0	1.337e-123
URI89H	contig_2	39329	38783	546	renamed_GCF_000008685.2	lp54	14337	14883	546	100.0	1.338e-118
URI89H	contig_2	40672	40087	585	renamed_GCF_000008685.2	lp54	12994	13579	585	100.0	1.763e-130
URI89H	contig_2	49410	50664	1254	renamed_GCF_000008685.2	lp54	4256	3002	1254	100.0	3.245e-279
URI89H	contig_2	52206	51696	510	renamed_GCF_000008685.2	lp54	1460	1970	510	100.0	8.829e-109
URI89H	contig_3	2650	2035	615	renamed_GCF_000008685.2	lp38	36248	35633	615	100.0	2.836e-130
URI89H	contig_3	17699	18770	1071	renamed_GCF_000008685.2	lp38	26407	25336	1071	100.0	4.439e-236
URI89H	contig_3	20741	20018	723	renamed_GCF_000008685.2	lp38	23365	24088	723	100.0	6.027e-157
URI89H	contig_3	22884	22158	726	renamed_GCF_000008685.2	lp38	21222	21948	726	100.0	1.164e-158
URI89H	contig_3	24794	24098	696	renamed_GCF_000008685.2	lp38	19312	20008	696	100.0	6.303e-152
URI89H	contig_4	9343	9970	627	renamed_GCF_000008685.2	lp36	9372	9999	627	100.0	1.942e-136
URI89H	contig_4	12572	13208	636	renamed_GCF_000008685.2	lp36	12601	13237	636	100.0	3.41e-140
URI89H	contig_5	28499	28073	426	renamed_GCF_000008685.2	lp56	28298	28724	426	100.0	8.877e-95
URI89H	contig_5	30908	30371	537	renamed_GCF_000008685.2	lp56	25889	26426	537	100.0	1.544e-115
URI89H	contig_6	11714	11420	294	renamed_GCF_000008685.2	lp28-1	10895	10697	294	100.0	9.155e-41
URI89H	contig_6	13715	13163	552	renamed_GCF_000008685.2	lp28-1	12992	12440	552	100.0	6.015e-120
URI89H	contig_6	15052	14491	561	renamed_GCF_000008685.2	lp28-1	14329	13768	561	100.0	4.308e-125
URI89H	contig_7	8700	9237	537	renamed_GCF_000008685.2	lp25	15545	15041	537	99.4	7.638e-115
URI89H	contig_7	11424	12183	759	renamed_GCF_000008685.2	lp25	12854	12095	759	100.0	2.255e-165
URI89H	contig_8	1785	2361	576	renamed_GCF_000008685.2	cp32-6	3372	3948	576	100.0	4.521e-127
URI89H	contig_8	3361	3817	456	renamed_GCF_000008685.2	cp32-6	4948	5404	456	100.0	1.075e-97
URI89H	contig_8	5120	6233	1113	renamed_GCF_000008685.2	lp56	10170	11283	1113	99.4	1.675e-245
URI89H	contig_8	21178	21751	573	renamed_GCF_000008685.2	cp32-7	22087	22660	573	100.0	7.629e-121
URI89H	contig_9	24295	25648	1353	renamed_GCF_000008685.2	cp32-7	29447	30800	1353	98.6	7.521e-304
URI89H	contig_9	25713	26937	1224	renamed_GCF_000008685.2	cp32-6	65	1289	1224	100.0	2.096e-270
URI89H	contig_9	26953	27646	693	renamed_GCF_000008685.2	cp32-8	1305	1998	693	100.0	2.582e-144
URI89H	contig_12	19509	18714	795	renamed_GCF_000008685.2	cp32-4	25435	24640	795	100.0	5.809e-178
URI89H	contig_12	20078	20894	816	renamed_GCF_000008685.2	cp32-4	26004	26820	816	100.0	2.075e-184
URI89H	contig_12	29779	30163	384	renamed_GCF_000008685.2	cp32-9	5412	5796	384	100.0	2.931e-83
URI89H	contig_13	1252	934	318	renamed_GCF_000008685.2	cp32-3	16585	16903	318	100.0	2.414e-66
URI89H	contig_13	2082	1746	336	renamed_GCF_000008685.2	cp32-3	15755	16091	336	100.0	5.348e-69
URI89H	contig_13	2626	2422	204	renamed_GCF_000008685.2	cp32-3	15211	15415	204	100.0	2.578e-39
URI89H	contig_13	5014	4138	876	renamed_GCF_000008685.2	cp32-3	12823	13699	876	100.0	5.609e-192
URI89H	contig_13	12441	12057	384	renamed_GCF_000008685.2	cp32-1	5396	5780	384	100.0	2.931e-83
URI89H	contig_13	13875	12915	960	renamed_GCF_000008685.2	cp32-1	3962	4922	960	100.0	6.593e-213
URI89H	contig_13	15827	15269	558	renamed_GCF_000008685.2	cp32-3	2010	2568	558	100.0	1.105e-122
URI89H	contig_15	6894	6210	684	renamed_GCF_000008685.2	cp32-6	10274	10958	684	100.0	3.113e-149
URI89H	contig_15	15159	14595	564	renamed_GCF_000008685.2	cp32-6	2009	2573	564	100.0	2.235e-124
URI89H	contig_15	17103	15879	1224	renamed_GCF_000008685.2	cp32-1	65	1289	1224	100.0	2.096e-270
URI89H	contig_15	19084	18517	567	renamed_GCF_000008685.2	cp32-6	27922	28489	567	100.0	2.836e-122
URI89H	contig_15	20750	19991	759	renamed_GCF_000008685.2	cp32-6	26256	27015	759	100.0	2.986e-162
URI89H	contig_15	22388	21962	426	renamed_GCF_000008685.2	cp32-6	24618	25044	426	100.0	8.056e-96
URI89H	contig_17	9925	11038	1113	renamed_GCF_000008685.2	lp28-4	10814	11927	1113	100.0	3.951e-253
URI89H	contig_17	11564	12317	753	renamed_GCF_000008685.2	lp28-4	12453	13206	753	100.0	4.561e-165
URI89H	contig_17	14462	15641	1179	renamed_GCF_000008685.2	lp28-4	15351	16530	1179	100.0	4.972e-253
URI89H	contig_17	18294	17628	666	renamed_GCF_000008685.2	lp28-4	19183	18517	666	100.0	3.109e-146
URI89H	contig_19	7934	8495	561	renamed_GCF_000008685.2	cp9	1891	2452	561	96.2	1.697e-118
URI89H	contig_19	11210	11750	540	renamed_GCF_000008685.2	cp9	6808	6280	540	87.1	4.907e-95
URI89H	contig_19	14588	15176	588	renamed_GCF_000008685.2	lp21	14647	15235	588	100.0	4.973e-128
URI89H	contig_19	15731	16025	294	renamed_GCF_000008685.2	lp21	15790	16084	294	100.0	2.432e-62
URI89H	contig_1	113	677	564	renamed_GCF_000008685.2	chromosome	104	677	564	100.0	4.108e-126
URI89H	contig_1	18305	17792	513	renamed_GCF_000008685.2	chromosome	18304	17791	513	100.0	1.701e-110
URI89H	contig_1	29543	31016	1473	renamed_GCF_000008685.2	chromosome	29542	31015	1473	99.7	0.0
URI89H	contig_1	32090	31550	540	renamed_GCF_000008685.2	chromosome	32089	31549	540	100.0	3.274e-116
URI89H	contig_1	35837	34037	1800	renamed_GCF_000008685.2	chromosome	35836	34036	1800	100.0	0.0
URI89H	contig_1	36610	35857	753	renamed_GCF_000008685.2	chromosome	36609	35856	753	100.0	1.343e-161
URI89H	contig_1	39639	38136	1503	renamed_GCF_000008685.2	chromosome	39638	38135	1503	100.0	0.0
URI89H	contig_1	39826	40678	852	renamed_GCF_000008685.2	chromosome	39825	40677	852	100.0	1.031e-189
URI89H	contig_1	116806	115504	1302	renamed_GCF_000008685.2	chromosome	116806	115504	1302	100.0	1.776e-285
URI89H	contig_1	118370	117677	693	renamed_GCF_000008685.2	chromosome	118370	117677	693	100.0	4.532e-155
URI89H	contig_1	119803	118963	840	renamed_GCF_000008685.2	chromosome	119803	118963	840	100.0	4.393e-180
URI89H	contig_1	121082	120803	279	renamed_GCF_000008685.2	chromosome	121082	120803	279	100.0	1.411e-57
URI89H	contig_1	137766	135873	1893	renamed_GCF_000008685.2	chromosome	137766	135873	1893	100.0	0.0
URI89H	contig_1	142934	141980	954	renamed_GCF_000008685.2	chromosome	142932	141978	954	100.0	1.517e-202
URI89H	contig_1	145460	144587	873	renamed_GCF_000008685.2	chromosome	145458	144585	873	100.0	2.787e-199
URI89H	contig_1	147497	146378	1119	renamed_GCF_000008685.2	chromosome	147495	146376	1119	100.0	3.727e-246
URI89H	contig_1	190065	190719	654	renamed_GCF_000008685.2	chromosome	190186	190717	654	100.0	6.314e-111
URI89H	contig_1	192329	191519	810	renamed_GCF_000008685.2	chromosome	192327	191517	810	100.0	2.276e-182
URI89H	contig_1	195694	197698	2004	renamed_GCF_000008685.2	chromosome	195692	197696	2004	100.0	0.0
URI89H	contig_1	217282	218314	1032	renamed_GCF_000008685.2	chromosome	217277	218312	1032	100.0	9.666e-221
URI89H	contig_1	219636	219057	579	renamed_GCF_000008685.2	chromosome	219634	219055	579	100.0	8.388e-121
URI89H	contig_1	220730	221639	909	renamed_GCF_000008685.2	chromosome	220728	221637	909	100.0	9.393e-192
URI89H	contig_1	223180	223963	783	renamed_GCF_000008685.2	chromosome	223178	223961	783	100.0	3.455e-173
URI89H	contig_1	235536	235290	246	renamed_GCF_000008685.2	chromosome	235534	235288	246	100.0	3.025e-52
URI89H	contig_1	237631	237223	408	renamed_GCF_000008685.2	chromosome	237629	237221	408	100.0	2.649e-88
URI89H	contig_1	238228	237970	258	renamed_GCF_000008685.2	chromosome	238226	237968	258	100.0	9.113e-51
URI89H	contig_1	240252	239145	1107	renamed_GCF_000008685.2	chromosome	240250	239143	1107	100.0	3.718e-244
URI89H	contig_1	242439	244005	1566	renamed_GCF_000008685.2	chromosome	242437	244003	1566	100.0	0.0
URI89H	contig_1	245381	244778	603	renamed_GCF_000008685.2	chromosome	245382	244776	603	99.5	7.936e-134
URI89H	contig_1	248528	250091	1563	renamed_GCF_000008685.2	chromosome	248505	250089	1563	100.0	0.0
URI89H	contig_1	250672	250177	495	renamed_GCF_000008685.2	chromosome	250670	250175	495	100.0	5.051e-104
URI89H	contig_1	252239	251213	1026	renamed_GCF_000008685.2	chromosome	252237	251211	1026	100.0	5.545e-226
URI89H	contig_1	253160	254933	1773	renamed_GCF_000008685.2	chromosome	253158	254931	1773	100.0	0.0
URI89H	contig_1	285961	283870	2091	renamed_GCF_000008685.2	chromosome	285962	283868	2091	99.8	0.0
URI89H	contig_1	287879	287090	789	renamed_GCF_000008685.2	chromosome	287877	287088	789	100.0	1.783e-164
URI89H	contig_1	288948	288183	765	renamed_GCF_000008685.2	chromosome	288946	288181	765	100.0	2.478e-165
URI89H	contig_1	289919	289577	342	renamed_GCF_000008685.2	chromosome	289917	289575	342	100.0	1.077e-70
URI89H	contig_1	291597	291060	537	renamed_GCF_000008685.2	chromosome	291595	291058	537	100.0	7.638e-115
URI89H	contig_1	293210	292427	783	renamed_GCF_000008685.2	chromosome	293208	292425	783	100.0	6.057e-167
URI89H	contig_1	294782	293453	1329	renamed_GCF_000008685.2	chromosome	294780	293451	1329	100.0	2.397e-295
URI89H	contig_1	296422	295243	1179	renamed_GCF_000008685.2	chromosome	296420	295241	1179	100.0	1.072e-261
URI89H	contig_1	297471	297039	432	renamed_GCF_000008685.2	chromosome	297469	297037	432	100.0	1.974e-95
URI89H	contig_1	299717	298796	921	renamed_GCF_000008685.2	chromosome	299715	298794	921	100.0	4.644e-193
URI89H	contig_1	310525	309781	744	renamed_GCF_000008685.2	chromosome	310523	309779	744	100.0	5.245e-162
URI89H	contig_1	312717	311661	1056	renamed_GCF_000008685.2	chromosome	312715	311659	1056	100.0	1.239e-230
URI89H	contig_1	314126	312734	1392	renamed_GCF_000008685.2	chromosome	314123	312728	1392	100.0	1.047e-306
URI89H	contig_1	315317	314426	891	renamed_GCF_000008685.2	chromosome	315314	314423	891	100.0	4.455e-197
URI89H	contig_1	317219	316142	1077	renamed_GCF_000008685.2	chromosome	317216	316139	1077	100.0	1.824e-238
URI89H	contig_1	328034	329168	1134	renamed_GCF_000008685.2	chromosome	328031	329165	1134	100.0	5.485e-253
URI89H	contig_1	330755	329645	1110	renamed_GCF_000008685.2	chromosome	330752	329642	1110	100.0	1.105e-249
URI89H	contig_1	333601	330805	2796	renamed_GCF_000008685.2	chromosome	333598	330802	2796	100.0	0.0
URI89H	contig_1	334518	333621	897	renamed_GCF_000008685.2	chromosome	334515	333618	897	100.0	1.666e-200
URI89H	contig_1	334939	336511	1572	renamed_GCF_000008685.2	chromosome	334936	336508	1572	100.0	0.0
URI89H	contig_1	338360	339986	1626	renamed_GCF_000008685.2	chromosome	338357	339983	1626	100.0	0.0
URI89H	contig_1	340343	341264	921	renamed_GCF_000008685.2	chromosome	340340	341261	921	100.0	2.92e-198
URI89H	contig_1	341276	342326	1050	renamed_GCF_000008685.2	chromosome	341273	342323	1050	100.0	1.489e-227
URI89H	contig_1	342337	343210	873	renamed_GCF_000008685.2	chromosome	342334	343207	873	100.0	1.573e-188
URI89H	contig_1	343210	344182	972	renamed_GCF_000008685.2	chromosome	343207	344179	972	100.0	3.579e-213
URI89H	contig_1	345065	346367	1302	renamed_GCF_000008685.2	chromosome	345062	346364	1302	100.0	6.07e-289
URI89H	contig_1	346844	346433	411	renamed_GCF_000008685.2	chromosome	346841	346430	411	100.0	6.821e-87
URI89H	contig_1	347304	346863	441	renamed_GCF_000008685.2	chromosome	347301	346860	441	100.0	1.706e-98
URI89H	contig_1	348163	347353	810	renamed_GCF_000008685.2	chromosome	348160	347350	810	100.0	1.888e-184
URI89H	contig_1	456580	458041	1461	renamed_GCF_000008685.2	chromosome	456575	458036	1461	100.0	0.0
URI89H	contig_1	458281	459439	1158	renamed_GCF_000008685.2	chromosome	458276	459434	1158	100.0	2.482e-257
URI89H	contig_1	459529	459829	300	renamed_GCF_000008685.2	chromosome	459524	459824	300	100.0	7.304e-60
URI89H	contig_1	482062	481348	714	renamed_GCF_000008685.2	chromosome	482057	481343	714	100.0	3.944e-160
URI89H	contig_1	482604	484287	1683	renamed_GCF_000008685.2	chromosome	482599	484282	1683	100.0	0.0
URI89H	contig_1	484291	484591	300	renamed_GCF_000008685.2	chromosome	484286	484586	300	100.0	5.976e-62
URI89H	contig_1	484761	485271	510	renamed_GCF_000008685.2	chromosome	484756	485266	510	100.0	1.216e-113
URI89H	contig_1	485554	486082	528	renamed_GCF_000008685.2	chromosome	485549	486077	528	100.0	1.004e-118
URI89H	contig_1	486078	486774	696	renamed_GCF_000008685.2	chromosome	486073	486769	696	100.0	2.835e-152
URI89H	contig_1	486721	487543	822	renamed_GCF_000008685.2	chromosome	486746	487538	822	100.0	1.872e-169
URI89H	contig_1	505558	506863	1305	renamed_GCF_000008685.2	chromosome	505553	506858	1305	100.0	4.133e-285
URI89H	contig_1	506875	506989	114	renamed_GCF_000008685.2	chromosome	506864	506984	114	100.0	7.638e-22
URI89H	contig_1	507006	507384	378	renamed_GCF_000008685.2	chromosome	507001	507379	378	100.0	8.763e-79
URI89H	contig_1	516493	522994	6501	renamed_GCF_000008685.2	chromosome	516492	522993	6501	100.0	0.0
URI89H	contig_1	524554	526255	1701	renamed_GCF_000008685.2	chromosome	524553	526254	1701	100.0	0.0
URI89H	contig_1	529198	528103	1095	renamed_GCF_000008685.2	chromosome	529198	528103	1095	100.0	3.934e-250
URI89H	contig_1	531105	529197	1908	renamed_GCF_000008685.2	chromosome	531105	529197	1908	100.0	0.0
URI89H	contig_1	553138	553789	651	renamed_GCF_000008685.2	chromosome	553138	553789	651	100.0	1.464e-143
URI89H	contig_1	553991	555212	1221	renamed_GCF_000008685.2	chromosome	553991	555212	1221	100.0	5.34e-268
URI89H	contig_1	555215	556580	1365	renamed_GCF_000008685.2	chromosome	555215	556580	1365	100.0	6.28e-308
URI89H	contig_1	568269	569139	870	renamed_GCF_000008685.2	chromosome	568269	569139	870	100.0	1.737e-195
URI89H	contig_1	569277	569538	261	renamed_GCF_000008685.2	chromosome	569277	569538	261	100.0	9.575e-51
URI89H	contig_1	569558	571280	1722	renamed_GCF_000008685.2	chromosome	569558	571280	1722	100.0	0.0
URI89H	contig_1	571282	571852	570	renamed_GCF_000008685.2	chromosome	571282	571852	570	100.0	1.471e-121
URI89H	contig_1	573740	571889	1851	renamed_GCF_000008685.2	chromosome	573740	571889	1851	100.0	0.0
URI89H	contig_1	573852	575247	1395	renamed_GCF_000008685.2	chromosome	573852	575247	1395	100.0	2.85e-313
URI89H	contig_1	575816	575273	543	renamed_GCF_000008685.2	chromosome	575816	575273	543	100.0	3.121e-117
URI89H	contig_1	628948	627091	1857	renamed_GCF_000008685.2	chromosome	628948	627091	1857	100.0	0.0
URI89H	contig_1	630698	629195	1503	renamed_GCF_000008685.2	chromosome	630698	629195	1503	100.0	0.0
URI89H	contig_1	630768	631986	1218	renamed_GCF_000008685.2	chromosome	630795	631986	1218	99.7	8.847e-262
URI89H	contig_1	644770	645139	369	renamed_GCF_000008685.2	chromosome	644771	645140	369	100.0	1.529e-79
URI89H	contig_1	645600	645135	465	renamed_GCF_000008685.2	chromosome	645601	645136	465	100.0	4.176e-101
URI89H	contig_1	645717	646680	963	renamed_GCF_000008685.2	chromosome	645718	646681	963	100.0	1.162e-215
URI89H	contig_1	648325	646657	1668	renamed_GCF_000008685.2	chromosome	648254	646658	1668	100.0	0.0
URI89H	contig_1	648551	649106	555	renamed_GCF_000008685.2	chromosome	648552	649107	555	100.0	3.12e-119
URI89H	contig_1	650386	649168	1218	renamed_GCF_000008685.2	chromosome	650387	649169	1218	100.0	2.758e-266
URI89H	contig_1	653789	650411	3378	renamed_GCF_000008685.2	chromosome	653790	650412	3378	100.0	0.0
URI89H	contig_1	714105	713241	864	renamed_GCF_000008685.2	chromosome	714107	713243	864	100.0	1.134e-190
URI89H	contig_1	714764	714101	663	renamed_GCF_000008685.2	chromosome	714766	714103	663	100.0	1.333e-146
URI89H	contig_1	715006	716617	1611	renamed_GCF_000008685.2	chromosome	715008	716619	1611	100.0	0.0
URI89H	contig_1	716617	717769	1152	renamed_GCF_000008685.2	chromosome	716619	717771	1152	100.0	1.261e-246
URI89H	contig_1	717740	718643	903	renamed_GCF_000008685.2	chromosome	717742	718669	903	100.0	1.36e-186
URI89H	contig_1	718823	721085	2262	renamed_GCF_000008685.2	chromosome	718826	721088	2262	100.0	0.0
URI89H	contig_1	721115	723017	1902	renamed_GCF_000008685.2	chromosome	721118	723020	1902	100.0	0.0
URI89H	contig_1	724127	723059	1068	renamed_GCF_000008685.2	chromosome	724130	723062	1068	100.0	3.402e-247
URI89H	contig_1	724220	725444	1224	renamed_GCF_000008685.2	chromosome	724223	725447	1224	100.0	3.222e-274
URI89H	contig_1	725427	726492	1065	renamed_GCF_000008685.2	chromosome	725430	726495	1065	100.0	4.042e-236
URI89H	contig_1	768062	766730	1332	renamed_GCF_000008685.2	chromosome	768064	766732	1332	100.0	1.239e-294
URI89H	contig_1	769468	768076	1392	renamed_GCF_000008685.2	chromosome	769470	768078	1392	100.0	1.696e-292
URI89H	contig_1	771137	769544	1593	renamed_GCF_000008685.2	chromosome	771139	769546	1593	100.0	0.0
URI89H	contig_1	783387	785019	1632	renamed_GCF_000008685.2	chromosome	783389	785021	1632	100.0	0.0
URI89H	contig_1	785054	786752	1698	renamed_GCF_000008685.2	chromosome	785056	786754	1698	100.0	0.0
URI89H	contig_1	786857	788960	2103	renamed_GCF_000008685.2	chromosome	786859	788962	2103	100.0	0.0
URI89H	contig_1	789318	789936	618	renamed_GCF_000008685.2	chromosome	789302	789938	618	100.0	3.406e-137
URI89H	contig_1	790805	789944	861	renamed_GCF_000008685.2	chromosome	790807	789946	861	100.0	1.57e-186
URI89H	contig_1	791785	790804	981	renamed_GCF_000008685.2	chromosome	791787	790806	981	100.0	5.759e-218
URI89H	contig_1	792250	791791	459	renamed_GCF_000008685.2	chromosome	792252	791793	459	100.0	5.068e-98
URI89H	contig_1	803166	802836	330	renamed_GCF_000008685.2	chromosome	803167	802837	330	100.0	2.178e-69
URI89H	contig_1	806922	805773	1149	renamed_GCF_000008685.2	chromosome	806923	805774	1149	100.0	1.098e-247
URI89H	contig_1	807965	806918	1047	renamed_GCF_000008685.2	chromosome	807966	806919	1047	100.0	5.315e-230
URI89H	contig_1	808463	807974	489	renamed_GCF_000008685.2	chromosome	808464	807975	489	100.0	6.125e-101
URI89H	contig_1	809551	808459	1092	renamed_GCF_000008685.2	chromosome	809552	808460	1092	100.0	7.863e-242
URI89H	contig_1	810494	809699	795	renamed_GCF_000008685.2	chromosome	810495	809700	795	100.0	1.877e-173
URI89H	contig_1	811509	810468	1041	renamed_GCF_000008685.2	chromosome	811510	810469	1041	100.0	2.778e-236
URI89H	contig_1	812387	811505	882	renamed_GCF_000008685.2	chromosome	812388	811506	882	100.0	2.526e-193
URI89H	contig_1	819249	819495	246	renamed_GCF_000008685.2	chromosome	819241	819487	246	100.0	8.275e-50
URI89H	contig_1	819549	820536	987	renamed_GCF_000008685.2	chromosome	819541	820528	987	100.0	5.255e-220
URI89H	contig_1	820614	821196	582	renamed_GCF_000008685.2	chromosome	820606	821188	582	100.0	9.143e-129
URI89H	contig_1	821192	822377	1185	renamed_GCF_000008685.2	chromosome	821184	822369	1185	100.0	1.177e-261
URI89H	contig_1	822351	822702	351	renamed_GCF_000008685.2	chromosome	822343	822694	351	100.0	6.889e-77
URI89H	contig_1	822817	823111	294	renamed_GCF_000008685.2	chromosome	822809	823103	294	100.0	1.207e-61
URI89H	contig_1	823270	823819	549	renamed_GCF_000008685.2	chromosome	823262	823811	549	100.0	1.698e-116
URI89H	contig_1	823823	824390	567	renamed_GCF_000008685.2	chromosome	823815	824382	567	100.0	1.275e-122
URI89H	contig_1	824389	825712	1323	renamed_GCF_000008685.2	chromosome	824381	825704	1323	100.0	8.966e-297
URI89H	contig_1	825708	827628	1920	renamed_GCF_000008685.2	chromosome	825700	827620	1920	100.0	0.0
URI89H	contig_1	855996	857517	1521	renamed_GCF_000008685.2	chromosome	855988	857509	1521	100.0	0.0
URI89H	contig_1	857513	858923	1410	renamed_GCF_000008685.2	chromosome	857505	858915	1410	100.0	1.384e-306
URI89H	contig_1	860119	858946	1173	renamed_GCF_000008685.2	chromosome	860111	858938	1173	100.0	1.287e-258
URI89H	contig_1	869524	868741	783	renamed_GCF_000008685.2	chromosome	869380	868732	783	99.5	1.931e-145
URI89H	contig_1	870032	869516	516	renamed_GCF_000008685.2	chromosome	870023	869507	516	100.0	1.621e-111
URI89H	contig_1	872592	870120	2472	renamed_GCF_000008685.2	chromosome	872583	870111	2472	100.0	0.0
URI89H	contig_1	875141	872594	2547	renamed_GCF_000008685.2	chromosome	875132	872585	2547	100.0	0.0
URI89H	contig_1	875215	876457	1242	renamed_GCF_000008685.2	chromosome	875206	876448	1242	100.0	1.008e-281
URI89H	contig_1	876437	879290	2853	renamed_GCF_000008685.2	chromosome	876491	879281	2853	99.7	0.0
URI89H	contig_1	879323	880259	936	renamed_GCF_000008685.2	chromosome	879314	880250	936	100.0	3.242e-208
URI89H	contig_2	5405	6197	792	renamed_GCF_000008685.2	lp54	48267	47475	792	100.0	4.37e-172
URI89H	contig_2	6444	7200	756	renamed_GCF_000008685.2	lp54	47228	46472	756	100.0	2.151e-165
URI89H	contig_2	7725	8955	1230	renamed_GCF_000008685.2	lp54	45947	44711	1230	98.7	1.97e-263
URI89H	contig_2	17713	17437	276	renamed_GCF_000008685.2	lp54	35953	36229	276	100.0	3.31e-56
URI89H	contig_2	18679	17833	846	renamed_GCF_000008685.2	lp54	34987	35833	846	100.0	5.585e-187
URI89H	contig_2	19282	18718	564	renamed_GCF_000008685.2	lp54	34384	34948	564	100.0	7.276e-120
URI89H	contig_2	20925	20706	219	renamed_GCF_000008685.2	lp54	32741	32960	219	100.0	7.958e-46
URI89H	contig_2	21406	20917	489	renamed_GCF_000008685.2	lp54	32260	32749	489	100.0	3.125e-108
URI89H	contig_2	21887	21464	423	renamed_GCF_000008685.2	lp54	31779	32202	423	100.0	5.086e-92
URI89H	contig_2	47146	46519	627	renamed_GCF_000008685.2	lp54	6520	7147	627	100.0	4.747e-135
URI89H	contig_2	48021	47148	873	renamed_GCF_000008685.2	lp54	5645	6518	873	100.0	2.408e-192
URI89H	contig_2	48353	48017	336	renamed_GCF_000008685.2	lp54	5313	5649	336	100.0	1.784e-72
URI89H	contig_3	34995	35271	276	renamed_GCF_000008685.2	lp38	9155	8876	276	98.9	6.666e-57
URI89H	contig_3	38052	37278	774	renamed_GCF_000008685.2	lp38	6088	6862	774	100.0	2.049e-160
URI89H	contig_3	39582	38661	921	renamed_GCF_000008685.2	lp38	4575	5496	921	100.0	7.813e-196
URI89H	contig_4	158	1052	894	renamed_GCF_000008685.2	lp36	187	1081	894	100.0	7.433e-192
URI89H	contig_4	6011	5258	753	renamed_GCF_000008685.2	lp36	6040	5287	753	100.0	7.287e-160
URI89H	contig_4	6336	6621	285	renamed_GCF_000008685.2	lp36	6365	6650	285	100.0	1.151e-60
URI89H	contig_4	20359	21424	1065	renamed_GCF_000008685.2	lp36	20388	21453	1065	100.0	2.633e-232
URI89H	contig_4	21882	22104	222	renamed_GCF_000008685.2	lp36	21911	22133	222	100.0	1.866e-45
URI89H	contig_4	22264	22438	174	renamed_GCF_000008685.2	lp36	22293	22467	174	100.0	8.56e-38
URI89H	contig_4	24037	24214	177	renamed_GCF_000008685.2	lp36	24066	24243	177	100.0	7.659e-32
URI89H	contig_5	20412	19644	768	renamed_GCF_000008685.2	cp32-6	2576	3344	768	100.0	1.48e-171
URI89H	contig_5	32280	31524	756	renamed_GCF_000008685.2	lp56	24517	25273	756	100.0	1.063e-164
URI89H	contig_6	1191	2190	999	renamed_GCF_000008685.2	lp28-1	466	1465	999	100.0	6.954e-219
URI89H	contig_6	3501	3801	300	renamed_GCF_000008685.2	lp28-3	1044	1368	300	89.8	8.93e-58
URI89H	contig_6	18529	18274	255	renamed_GCF_000008685.2	lp28-1	17805	17550	255	100.0	1.423e-53
URI89H	contig_7	13569	14079	510	renamed_GCF_000008685.2	lp25	10694	10199	510	99.3	8.021e-110
URI89H	contig_7	17366	16517	849	renamed_GCF_000008685.2	lp25	6897	7761	849	93.7	5.551e-179
URI89H	contig_8	9283	10234	951	renamed_GCF_000008685.2	lp56	14441	15392	951	99.6	1.057e-214
URI89H	contig_8	10835	11168	333	renamed_GCF_000008685.2	cp32-3	12494	12827	333	100.0	8.424e-72
URI89H	contig_9	3649	3886	237	renamed_GCF_000008685.2	cp32-7	8725	8962	237	98.7	8.748e-48
URI89H	contig_9	5243	5885	642	renamed_GCF_000008685.2	cp32-7	10316	10958	642	99.5	4.53e-138
URI89H	contig_9	12159	12597	438	renamed_GCF_000008685.2	cp32-7	17244	17667	438	93.1	9.537e-88
URI89H	contig_9	15689	16430	741	renamed_GCF_000008685.2	cp32-8	20739	21480	741	99.5	5.003e-162
URI89H	contig_9	17061	17640	579	renamed_GCF_000008685.2	cp32-8	22112	22691	579	100.0	3.43e-122
URI89H	contig_9	19506	19932	426	renamed_GCF_000008685.2	cp32-1	24608	25034	426	100.0	1.627e-96
URI89H	contig_10	1709	1355	354	renamed_GCF_000008685.2	lp56	19584	19938	354	100.0	1.459e-77
URI89H	contig_11	10735	11089	354	renamed_GCF_000008685.2	cp32-9	16183	16537	354	100.0	1.459e-77
URI89H	contig_11	11193	11748	555	renamed_GCF_000008685.2	cp32-9	16641	17196	555	100.0	1.867e-116
URI89H	contig_11	14826	15393	567	renamed_GCF_000008685.2	cp32-9	20274	20841	567	100.0	1.456e-129
URI89H	contig_11	16165	16726	561	renamed_GCF_000008685.2	cp32-9	21613	22174	561	100.0	6.308e-121
URI89H	contig_11	27785	28553	768	renamed_GCF_000008685.2	cp32-9	2582	3350	768	99.6	1.626e-170
URI89H	contig_12	26952	27720	768	renamed_GCF_000008685.2	cp32-4	2579	3347	768	100.0	3.291e-171
URI89H	contig_12	27748	28324	576	renamed_GCF_000008685.2	cp32-4	3375	3951	576	100.0	1.005e-126
URI89H	contig_12	29324	29780	456	renamed_GCF_000008685.2	cp32-4	4951	5407	456	100.0	1.075e-97
URI89H	contig_13	5918	5372	546	renamed_GCF_000008685.2	cp32-8	11919	12465	546	100.0	7.28e-117
URI89H	contig_13	6886	5935	951	renamed_GCF_000008685.2	cp32-3	10951	11902	951	100.0	4.333e-216
URI89H	contig_13	8870	7595	1275	renamed_GCF_000008685.2	cp32-3	8967	10242	1275	100.0	2.667e-276
URI89H	contig_13	9566	9110	456	renamed_GCF_000008685.2	cp32-8	8271	8727	456	100.0	1.971e-99
URI89H	contig_13	11137	10024	1113	renamed_GCF_000008685.2	cp32-1	6700	7813	1113	100.0	6.876e-247
URI89H	contig_13	19825	19186	639	renamed_GCF_000008685.2	cp32-3	28235	28874	639	100.0	1.943e-138
URI89H	contig_13	21353	20762	591	renamed_GCF_000008685.2	cp32-3	26707	27298	591	100.0	2.345e-128
URI89H	contig_15	23766	22440	1326	renamed_GCF_000008685.2	cp32-7	23134	24460	1326	99.7	3.211e-300
URI89H	contig_15	26736	26169	567	renamed_GCF_000008685.2	cp32-8	20197	20764	567	99.4	3.238e-129
URI89H	contig_16	1336	625	711	renamed_GCF_000008685.2	lp28-3	2970	2259	711	100.0	1.615e-152
URI89H	contig_16	15772	16339	567	renamed_GCF_000008685.2	lp28-3	17407	17974	567	100.0	1.938e-126
URI89H	contig_16	17162	17792	630	renamed_GCF_000008685.2	lp28-3	18797	19427	630	100.0	1.007e-135
URI89H	contig_16	21042	21318	276	renamed_GCF_000008685.2	lp28-3	22677	22953	276	100.0	6.026e-58
URI89H	contig_16	24709	23797	912	renamed_GCF_000008685.2	lp28-3	26371	25432	912	100.0	5.639e-198
URI89H	contig_16	27402	27975	573	renamed_GCF_000008685.2	lp28-3	28197	27624	573	100.0	5.735e-124
URI89H	contig_17	1484	2300	816	renamed_GCF_000008685.2	lp28-4	2535	3351	816	100.0	8.08e-178
URI89H	contig_17	4076	4295	219	renamed_GCF_000008685.2	lp28-4	5127	5346	219	100.0	1.443e-47
URI89H	contig_18	4606	3973	633	renamed_GCF_000008685.2	cp26	16902	17535	633	100.0	1.275e-133
URI89H	contig_18	6401	7616	1215	renamed_GCF_000008685.2	cp26	15107	13892	1215	100.0	5.333e-267
URI89H	contig_18	10091	10589	498	renamed_GCF_000008685.2	cp26	11417	10919	498	100.0	3.608e-108
URI89H	contig_18	12234	11472	762	renamed_GCF_000008685.2	cp26	9274	10036	762	100.0	1.063e-165
URI89H	contig_18	13673	12743	930	renamed_GCF_000008685.2	cp26	7835	8765	930	100.0	7.897e-206
URI89H	contig_18	24852	25404	552	renamed_GCF_000008685.2	cp26	23154	22602	552	100.0	6.015e-120
URI89H	contig_19	457	1567	1110	renamed_GCF_000008685.2	lp21	1485	2628	1110	98.9	8.376e-253
URI89H	contig_19	3839	4124	285	renamed_GCF_000008685.2	cp9	4788	4503	285	96.8	3.136e-58
URI89H	contig_19	5830	4918	912	renamed_GCF_000008685.2	cp9	2803	3712	912	99.3	1.323e-205
URI89H	contig_19	20612	19619	993	renamed_GCF_000008685.2	lp21	16885	17878	993	100.0	1.858e-215
URI89H	contig_20	791	1061	270	renamed_GCF_000008685.2	lp17	14069	14339	270	100.0	1.489e-55
URI89H	contig_20	10616	10913	297	renamed_GCF_000008685.2	lp17	9980	9590	297	100.0	9.385e-65
URI89H	contig_20	12719	12392	327	renamed_GCF_000008685.2	lp17	7784	8111	327	100.0	1.029e-68
URI89H	contig_20	15448	14764	684	renamed_GCF_000008685.2	lp17	5055	5739	684	100.0	2.578e-151
URI89H	contig_20	20174	19700	474	renamed_GCF_000008685.2	lp17	329	803	474	100.0	1.788e-103
URI89H	contig_21	6825	3564	3261	renamed_GCF_000008685.2	lp56	43696	40435	3261	100.0	0.0
URI89H	contig_22	1795	1219	576	renamed_GCF_000008685.2	lp56	6835	7411	576	100.0	4.521e-127
URI89H	contig_22	2800	3562	762	renamed_GCF_000008685.2	lp56	5830	5068	762	100.0	1.784e-168
URI89H	contig_22	5887	5134	753	renamed_GCF_000008685.2	lp56	2743	3496	753	100.0	1.868e-166
URI89H	contig_23	1411	853	558	renamed_GCF_000008685.2	cp32-1	21560	22118	558	100.0	2.975e-120
URI89H	contig_24	45	669	624	renamed_GCF_000008685.2	lp56	20042	20738	624	100.0	2.705e-132
URI89H	contig_1	69566	70127	561	renamed_GCF_000008685.2	chromosome	69565	70126	561	100.0	3.775e-118
URI89H	contig_1	81404	82940	1536	renamed_GCF_000008685.2	chromosome	81404	82940	1536	100.0	0.0
URI89H	contig_1	85720	84040	1680	renamed_GCF_000008685.2	chromosome	85720	84040	1680	100.0	0.0
URI89H	contig_1	87360	86925	435	renamed_GCF_000008685.2	chromosome	87360	86925	435	100.0	2.772e-92
URI89H	contig_1	91115	89810	1305	renamed_GCF_000008685.2	chromosome	91115	89810	1305	100.0	2.863e-289
URI89H	contig_1	105431	103763	1668	renamed_GCF_000008685.2	chromosome	105299	103763	1668	100.0	0.0
URI89H	contig_1	106894	105883	1011	renamed_GCF_000008685.2	chromosome	106894	105883	1011	100.0	4.14e-218
URI89H	contig_1	108306	109671	1365	renamed_GCF_000008685.2	chromosome	108306	109671	1365	100.0	4.349e-312
URI89H	contig_1	111567	111045	522	renamed_GCF_000008685.2	chromosome	111567	111045	522	100.0	1.783e-111
URI89H	contig_1	323782	322849	933	renamed_GCF_000008685.2	chromosome	323779	322846	933	100.0	1.839e-205
URI89H	contig_1	325239	323778	1461	renamed_GCF_000008685.2	chromosome	325236	323775	1461	99.7	0.0
URI89H	contig_1	326291	325238	1053	renamed_GCF_000008685.2	chromosome	326288	325235	1053	100.0	4.032e-234
URI89H	contig_1	327730	326701	1029	renamed_GCF_000008685.2	chromosome	327757	326698	1029	99.7	7.409e-232
URI89H	contig_1	353443	351343	2100	renamed_GCF_000008685.2	chromosome	353437	351340	2100	100.0	0.0
URI89H	contig_1	354639	353442	1197	renamed_GCF_000008685.2	chromosome	354636	353439	1197	100.0	5.312e-264
URI89H	contig_1	355301	354650	651	renamed_GCF_000008685.2	chromosome	355298	354647	651	100.0	1.769e-141
URI89H	contig_1	355493	356912	1419	renamed_GCF_000008685.2	chromosome	355490	356909	1419	100.0	1.415e-316
URI89H	contig_1	357009	358443	1434	renamed_GCF_000008685.2	chromosome	357006	358440	1434	100.0	9.657e-315
URI89H	contig_1	358460	359201	741	renamed_GCF_000008685.2	chromosome	358457	359198	741	100.0	9.218e-164
URI89H	contig_1	406179	405690	489	renamed_GCF_000008685.2	chromosome	406176	405687	489	100.0	1.238e-101
URI89H	contig_1	406864	406183	681	renamed_GCF_000008685.2	chromosome	406861	406180	681	100.0	2.702e-150
URI89H	contig_1	407295	406863	432	renamed_GCF_000008685.2	chromosome	407292	406860	432	100.0	3.534e-89
URI89H	contig_1	407901	407346	555	renamed_GCF_000008685.2	chromosome	407898	407343	555	100.0	5.734e-121
URI89H	contig_1	417726	418338	612	renamed_GCF_000008685.2	chromosome	417723	418335	612	100.0	3.097e-137
URI89H	contig_1	419509	418390	1119	renamed_GCF_000008685.2	chromosome	419506	418387	1119	100.0	8.015e-255
URI89H	contig_1	421383	419505	1878	renamed_GCF_000008685.2	chromosome	421380	419502	1878	100.0	0.0
URI89H	contig_1	421556	422186	630	renamed_GCF_000008685.2	chromosome	421553	422183	630	100.0	5.705e-142
URI89H	contig_1	423060	423840	780	renamed_GCF_000008685.2	chromosome	423054	423834	780	100.0	3.296e-173
URI89H	contig_1	467283	465522	1761	renamed_GCF_000008685.2	chromosome	467278	465517	1761	100.0	0.0
URI89H	contig_1	469392	467286	2106	renamed_GCF_000008685.2	chromosome	469387	467281	2106	100.0	0.0
URI89H	contig_1	469670	469394	276	renamed_GCF_000008685.2	chromosome	469665	469389	276	100.0	1.644e-55
URI89H	contig_1	469976	469682	294	renamed_GCF_000008685.2	chromosome	469971	469677	294	100.0	2.2e-63
URI89H	contig_1	471225	469965	1260	renamed_GCF_000008685.2	chromosome	471220	469960	1260	100.0	2.539e-274
URI89H	contig_1	471761	471227	534	renamed_GCF_000008685.2	chromosome	471756	471222	534	100.0	8.816e-113
URI89H	contig_1	472480	471775	705	renamed_GCF_000008685.2	chromosome	472358	471770	705	99.4	1.099e-121
URI89H	contig_1	472570	473413	843	renamed_GCF_000008685.2	chromosome	472565	473408	843	100.0	5.328e-187
URI89H	contig_1	474561	473409	1152	renamed_GCF_000008685.2	chromosome	474556	473404	1152	100.0	7.714e-261
URI89H	contig_1	474617	475607	990	renamed_GCF_000008685.2	chromosome	474612	475602	990	100.0	3.939e-215
URI89H	contig_1	496272	496584	312	renamed_GCF_000008685.2	chromosome	496267	496579	312	100.0	2.953e-63
URI89H	contig_1	496619	497240	621	renamed_GCF_000008685.2	chromosome	496614	497235	621	100.0	8.732e-136
URI89H	contig_1	497249	497879	630	renamed_GCF_000008685.2	chromosome	497244	497874	630	100.0	4.528e-136
URI89H	contig_1	497899	498196	297	renamed_GCF_000008685.2	chromosome	497894	498191	297	100.0	5.69e-62
URI89H	contig_1	507410	507803	393	renamed_GCF_000008685.2	chromosome	507405	507798	393	100.0	3.073e-84
URI89H	contig_1	507818	508853	1035	renamed_GCF_000008685.2	chromosome	507813	508848	1035	100.0	4.156e-222
URI89H	contig_1	508874	509246	372	renamed_GCF_000008685.2	chromosome	508869	509241	372	100.0	8.775e-78
URI89H	contig_1	509318	510851	1533	renamed_GCF_000008685.2	chromosome	509313	510846	1533	100.0	0.0
URI89H	contig_1	510840	511629	789	renamed_GCF_000008685.2	chromosome	510835	511624	789	100.0	3.149e-175
URI89H	contig_1	513144	512397	747	renamed_GCF_000008685.2	chromosome	513139	512392	747	100.0	7.284e-159
URI89H	contig_1	609906	609060	846	renamed_GCF_000008685.2	chromosome	609906	609060	846	100.0	3.324e-184
URI89H	contig_1	611308	612022	714	renamed_GCF_000008685.2	chromosome	611308	612022	714	100.0	1.949e-159
URI89H	contig_1	615771	614013	1758	renamed_GCF_000008685.2	chromosome	615771	614013	1758	100.0	0.0
URI89H	contig_1	631990	632482	492	renamed_GCF_000008685.2	chromosome	631990	632482	492	100.0	1.786e-106
URI89H	contig_1	634580	636011	1431	renamed_GCF_000008685.2	chromosome	634580	636011	1431	100.0	1.295e-319
URI89H	contig_1	637961	638555	594	renamed_GCF_000008685.2	chromosome	637971	638556	594	100.0	1.47e-125
URI89H	contig_1	639839	642248	2409	renamed_GCF_000008685.2	chromosome	639858	642249	2409	100.0	0.0
URI89H	contig_1	643125	642498	627	renamed_GCF_000008685.2	chromosome	643126	642499	627	100.0	8.735e-137
URI89H	contig_1	658896	659622	726	renamed_GCF_000008685.2	chromosome	658897	659623	726	100.0	3.429e-155
URI89H	contig_1	661604	662528	924	renamed_GCF_000008685.2	chromosome	661605	662529	924	100.0	4.691e-202
URI89H	contig_1	690500	690797	297	renamed_GCF_000008685.2	chromosome	690481	690799	297	98.9	6.955e-60
URI89H	contig_1	692626	693526	900	renamed_GCF_000008685.2	chromosome	692628	693528	900	100.0	8.957e-191
URI89H	contig_1	695521	694690	831	renamed_GCF_000008685.2	chromosome	695523	694692	831	100.0	5.839e-184
URI89H	contig_1	697435	696748	687	renamed_GCF_000008685.2	chromosome	697437	696750	687	100.0	2.97e-150
URI89H	contig_1	699963	698397	1566	renamed_GCF_000008685.2	chromosome	699965	698399	1566	100.0	0.0
URI89H	contig_1	704946	705498	552	renamed_GCF_000008685.2	chromosome	704948	705500	552	100.0	2.458e-121
URI89H	contig_1	731096	730628	468	renamed_GCF_000008685.2	chromosome	731099	730631	468	100.0	1.969e-101
URI89H	contig_1	731790	733800	2010	renamed_GCF_000008685.2	chromosome	731793	733803	2010	100.0	0.0
URI89H	contig_1	735348	736683	1335	renamed_GCF_000008685.2	chromosome	735351	736686	1335	100.0	6.003e-286
URI89H	contig_1	737208	737709	501	renamed_GCF_000008685.2	chromosome	737211	737712	501	100.0	9.268e-107
URI89H	contig_1	900807	901791	984	renamed_GCF_000008685.2	chromosome	900798	901782	984	100.0	5.014e-220
URI89H	contig_2	9133	9982	849	renamed_GCF_000008685.2	lp54	44533	43684	849	100.0	7.054e-185
URI89H	contig_2	11400	11193	207	renamed_GCF_000008685.2	lp54	42266	42473	207	100.0	9.856e-42
URI89H	contig_2	11647	12271	624	renamed_GCF_000008685.2	lp54	42019	41395	624	100.0	3.1e-139
URI89H	contig_2	13554	13794	240	renamed_GCF_000008685.2	lp54	40112	39872	240	100.0	3.722e-49
URI89H	contig_2	17399	17132	267	renamed_GCF_000008685.2	lp54	36255	36534	267	98.8	1.568e-54
URI89H	contig_2	34942	33589	1353	renamed_GCF_000008685.2	lp54	18724	20077	1353	100.0	1.524e-304
URI89H	contig_2	36407	36971	564	renamed_GCF_000008685.2	lp54	17259	16695	564	100.0	1.065e-115
URI89H	contig_2	38297	37865	432	renamed_GCF_000008685.2	lp54	15369	15801	432	100.0	1.792e-96
URI89H	contig_3	25893	24852	1041	renamed_GCF_000008685.2	lp38	18213	19254	1041	100.0	2.778e-236
URI89H	contig_4	8830	8134	696	renamed_GCF_000008685.2	lp36	8859	8163	696	100.0	1.275e-152
URI89H	contig_4	10271	11918	1647	renamed_GCF_000008685.2	lp36	10300	11947	1647	100.0	0.0
URI89H	contig_4	14297	13547	750	renamed_GCF_000008685.2	lp36	14326	13576	750	100.0	1.062e-163
URI89H	contig_4	15731	14804	927	renamed_GCF_000008685.2	lp36	15760	14833	927	100.0	2.815e-208
URI89H	contig_4	17350	17554	204	renamed_GCF_000008685.2	lp36	17379	17583	204	100.0	8.441e-43
URI89H	contig_5	2268	1518	750	renamed_GCF_000008685.2	cp32-6	20720	21470	750	100.0	4.35e-165
URI89H	contig_5	3920	2819	1101	renamed_GCF_000008685.2	cp32-6	19068	20169	1101	100.0	1.945e-250
URI89H	contig_5	5742	5292	450	renamed_GCF_000008685.2	cp32-6	17246	17696	450	100.0	3.616e-100
URI89H	contig_5	6886	6532	354	renamed_GCF_000008685.2	cp32-6	16102	16456	354	100.0	1.459e-77
URI89H	contig_7	1596	2328	732	renamed_GCF_000008685.2	lp25	22677	21945	732	100.0	5.239e-160
URI89H	contig_7	9802	10876	1074	renamed_GCF_000008685.2	lp25	14530	13402	1074	99.7	2.22e-244
URI89H	contig_7	10885	11449	564	renamed_GCF_000008685.2	lp25	13393	12829	564	100.0	4.519e-125
URI89H	contig_7	12199	12781	582	renamed_GCF_000008685.2	lp25	12079	11497	582	100.0	4.521e-128
URI89H	contig_8	3816	4200	384	renamed_GCF_000008685.2	cp32-4	5406	5790	384	100.0	2.931e-83
URI89H	contig_8	4573	5140	567	renamed_GCF_000008685.2	lp56	9623	10190	567	98.9	5.214e-124
URI89H	contig_8	6246	6675	429	renamed_GCF_000008685.2	lp56	11296	11725	429	100.0	5.601e-92
URI89H	contig_9	10692	11028	336	renamed_GCF_000008685.2	cp32-9	15855	16191	336	100.0	5.348e-69
URI89H	contig_9	21144	21666	522	renamed_GCF_000008685.2	cp32-8	26381	26903	522	100.0	1.338e-114
URI89H	contig_10	5299	4966	333	renamed_GCF_000008685.2	cp32-7	12502	12835	333	100.0	1.876e-71
URI89H	contig_10	6840	5898	942	renamed_GCF_000008685.2	cp32-7	10961	11903	942	99.6	2.695e-211
URI89H	contig_10	11075	9962	1113	renamed_GCF_000008685.2	cp32-7	6702	7815	1113	100.0	3.095e-247
URI89H	contig_10	12011	11621	390	renamed_GCF_000008685.2	cp32-1	5767	6157	390	100.0	3.229e-83
URI89H	contig_12	7735	8341	606	renamed_GCF_000008685.2	cp32-4	13661	14267	606	100.0	5.47e-130
URI89H	contig_12	15488	16034	546	renamed_GCF_000008685.2	cp32-4	21414	21960	546	100.0	3.273e-117
URI89H	contig_12	18283	18709	426	renamed_GCF_000008685.2	cp32-4	24209	24635	426	100.0	8.056e-96
URI89H	contig_12	20926	21601	675	renamed_GCF_000008685.2	cp32-4	26852	27527	675	100.0	3.937e-145
URI89H	contig_12	21749	22277	528	renamed_GCF_000008685.2	cp32-4	27675	28203	528	100.0	1.105e-117
URI89H	contig_13	749	140	609	renamed_GCF_000008685.2	cp32-3	17088	17697	609	100.0	2.836e-129
URI89H	contig_13	1754	1400	354	renamed_GCF_000008685.2	cp32-3	16083	16437	354	100.0	1.459e-77
URI89H	contig_13	2419	2071	348	renamed_GCF_000008685.2	lp56	18919	19267	348	100.0	3.962e-74
URI89H	contig_14	22782	22395	387	renamed_GCF_000008685.2	lp28-2	22659	22272	387	100.0	4.63e-87
URI89H	contig_14	23848	23155	693	renamed_GCF_000008685.2	lp28-2	23725	23032	693	100.0	4.125e-156
URI89H	contig_15	1935	1731	204	renamed_GCF_000008685.2	cp32-8	15214	15418	204	100.0	2.578e-39
URI89H	contig_15	3441	2835	606	renamed_GCF_000008685.2	cp32-1	13708	14314	606	100.0	5.47e-130
URI89H	contig_15	6207	5256	951	renamed_GCF_000008685.2	cp32-6	10961	11912	951	100.0	4.333e-216
URI89H	contig_15	8191	6916	1275	renamed_GCF_000008685.2	cp32-6	8977	10252	1275	100.0	5.405e-277
URI89H	contig_15	15863	15170	693	renamed_GCF_000008685.2	cp32-6	1305	1998	693	100.0	1.162e-144
URI89H	contig_15	18521	17168	1353	renamed_GCF_000008685.2	cp32-6	28485	29838	1353	100.0	6.259e-306
URI89H	contig_1	1796	767	1029	renamed_GCF_000008685.2	chromosome	1796	767	1029	100.0	4.829e-228
URI89H	contig_1	3395	5189	1794	renamed_GCF_000008685.2	chromosome	3418	5188	1794	100.0	0.0
URI89H	contig_1	6307	5251	1056	renamed_GCF_000008685.2	chromosome	6306	5250	1056	99.7	7.804e-236
URI89H	contig_1	7398	6309	1089	renamed_GCF_000008685.2	chromosome	7397	6308	1089	100.0	1.828e-240
URI89H	contig_1	8316	7458	858	renamed_GCF_000008685.2	chromosome	8315	7457	858	100.0	6.472e-196
URI89H	contig_1	8427	9198	771	renamed_GCF_000008685.2	chromosome	8426	9197	771	100.0	1.781e-161
URI89H	contig_1	9202	10207	1005	renamed_GCF_000008685.2	chromosome	9201	10206	1005	100.0	1.697e-218
URI89H	contig_1	10203	10578	375	renamed_GCF_000008685.2	chromosome	10202	10577	375	100.0	3.75e-79
URI89H	contig_1	10581	11421	840	renamed_GCF_000008685.2	chromosome	10580	11420	840	100.0	7.775e-191
URI89H	contig_1	59037	58029	1008	renamed_GCF_000008685.2	chromosome	58982	58028	1008	100.0	2.425e-206
URI89H	contig_1	71201	72611	1410	renamed_GCF_000008685.2	chromosome	71200	72610	1410	100.0	2.56e-308
URI89H	contig_1	72647	73493	846	renamed_GCF_000008685.2	chromosome	72646	73492	846	100.0	5.813e-178
URI89H	contig_1	76450	77701	1251	renamed_GCF_000008685.2	chromosome	76450	77701	1251	100.0	1.724e-268
URI89H	contig_1	79352	79001	351	renamed_GCF_000008685.2	chromosome	79322	79001	351	100.0	3.732e-67
URI89H	contig_1	93423	92877	546	renamed_GCF_000008685.2	chromosome	93423	92877	546	100.0	2.704e-119
URI89H	contig_1	94605	94218	387	renamed_GCF_000008685.2	chromosome	94605	94218	387	100.0	1.031e-86
URI89H	contig_1	97866	96942	924	renamed_GCF_000008685.2	chromosome	97866	96942	924	100.0	7.888e-205
URI89H	contig_1	98816	100205	1389	renamed_GCF_000008685.2	chromosome	98816	100205	1389	100.0	9.726e-316
URI89H	contig_1	146372	145472	900	renamed_GCF_000008685.2	chromosome	146370	145470	900	100.0	6.779e-194
URI89H	contig_1	148661	147650	1011	renamed_GCF_000008685.2	chromosome	148659	147648	1011	100.0	5.463e-215
URI89H	contig_1	150975	152181	1206	renamed_GCF_000008685.2	chromosome	150973	152179	1206	100.0	4.93e-275
URI89H	contig_1	153688	153076	612	renamed_GCF_000008685.2	chromosome	153686	153074	612	100.0	4.712e-141
URI89H	contig_1	156463	157600	1137	renamed_GCF_000008685.2	chromosome	156461	157598	1137	100.0	1.164e-253
URI89H	contig_1	158059	158476	417	renamed_GCF_000008685.2	chromosome	158075	158474	417	100.0	2.72e-81
URI89H	contig_1	171252	171486	234	renamed_GCF_000008685.2	chromosome	171262	171484	234	98.6	1.134e-44
URI89H	contig_1	174118	173530	588	renamed_GCF_000008685.2	chromosome	174116	173528	588	100.0	1.529e-132
URI89H	contig_1	176976	176070	906	renamed_GCF_000008685.2	chromosome	176974	176068	906	100.0	1.374e-195
URI89H	contig_1	254946	255651	705	renamed_GCF_000008685.2	chromosome	254944	255649	705	100.0	7.263e-152
URI89H	contig_1	283867	282700	1167	renamed_GCF_000008685.2	chromosome	283865	282698	1167	100.0	1.172e-258
URI89H	contig_1	287091	285972	1119	renamed_GCF_000008685.2	chromosome	287089	285970	1119	100.0	9.957e-244
URI89H	contig_1	288175	287911	264	renamed_GCF_000008685.2	chromosome	288173	287909	264	100.0	2.025e-51
URI89H	contig_1	289585	288958	627	renamed_GCF_000008685.2	chromosome	289583	288956	627	100.0	2.836e-132
URI89H	contig_1	291023	289964	1059	renamed_GCF_000008685.2	chromosome	291021	289962	1059	100.0	3.164e-229
URI89H	contig_1	292428	291645	783	renamed_GCF_000008685.2	chromosome	292426	291643	783	100.0	1.874e-171
URI89H	contig_1	293431	293206	225	renamed_GCF_000008685.2	chromosome	293429	293204	225	100.0	8.8e-46
URI89H	contig_1	295230	294786	444	renamed_GCF_000008685.2	chromosome	295228	294784	444	100.0	1.185e-94
URI89H	contig_1	297047	296429	618	renamed_GCF_000008685.2	chromosome	297045	296427	618	100.0	5.47e-132
URI89H	contig_5	14011	12736	1275	renamed_GCF_000008685.2	cp32-8	8967	10242	1275	100.0	1.201e-276
URI89H	contig_5	15151	14722	429	renamed_GCF_000008685.2	cp32-8	7827	8256	429	100.0	5.601e-92
URI89H	contig_6	3338	2822	516	renamed_GCF_000008685.2	lp28-1	2619	2097	516	100.0	2.617e-106
URI89H	contig_8	12664	13480	816	renamed_GCF_000008685.2	lp56	17822	18638	816	98.5	1.796e-177
URI89H	contig_8	14098	14434	336	renamed_GCF_000008685.2	cp32-4	15710	16046	336	100.0	5.348e-69
URI89H	contig_9	18128	19454	1326	renamed_GCF_000008685.2	cp32-1	23230	24556	1326	99.0	1.737e-298
URI89H	contig_10	2037	1701	336	renamed_GCF_000008685.2	cp32-6	15774	16110	336	100.0	5.348e-69
URI89H	contig_10	2581	2377	204	renamed_GCF_000008685.2	cp32-9	15311	15515	204	100.0	2.578e-39
URI89H	contig_12	10112	10466	354	renamed_GCF_000008685.2	cp32-4	16038	16392	354	100.0	6.554e-78
URI89H	contig_12	11176	11599	423	renamed_GCF_000008685.2	cp32-4	17102	17525	423	100.0	4.616e-93
URI89H	contig_12	13033	14131	1098	renamed_GCF_000008685.2	cp32-4	18959	20057	1098	100.0	8.352e-251
URI89H	contig_12	22457	23024	567	renamed_GCF_000008685.2	cp32-4	28383	28950	567	100.0	1.275e-122
URI89H	contig_12	24438	25662	1224	renamed_GCF_000008685.2	cp32-4	65	1289	1224	100.0	4.655e-270
URI89H	contig_12	26385	26949	564	renamed_GCF_000008685.2	cp32-4	2012	2576	564	100.0	2.235e-124
URI89H	contig_12	28345	29305	960	renamed_GCF_000008685.2	cp32-4	3972	4932	960	100.0	6.008e-214
URI89H	contig_13	5343	5010	333	renamed_GCF_000008685.2	cp32-4	12447	12780	333	100.0	8.424e-72
URI89H	contig_13	7573	6889	684	renamed_GCF_000008685.2	cp32-3	10264	10948	684	99.5	3.113e-149
URI89H	contig_13	9114	8877	237	renamed_GCF_000008685.2	cp32-3	8723	8960	237	100.0	7.893e-49
URI89H	contig_14	6033	6801	768	renamed_GCF_000008685.2	lp28-2	5910	6678	768	100.0	2.365e-166
URI89H	contig_14	12442	11623	819	renamed_GCF_000008685.2	lp28-2	12319	11500	819	100.0	1.075e-183
URI89H	contig_14	13264	12871	393	renamed_GCF_000008685.2	lp28-2	13141	12748	393	100.0	6.841e-84
URI89H	contig_14	14464	13630	834	renamed_GCF_000008685.2	lp28-2	14341	13507	834	100.0	1.239e-184
URI89H	contig_14	15008	14498	510	renamed_GCF_000008685.2	lp28-2	14885	14375	510	100.0	3.606e-110
URI89H	contig_14	24231	23844	387	renamed_GCF_000008685.2	lp28-2	24108	23721	387	100.0	1.013e-78
URI89H	contig_14	26102	26513	411	renamed_GCF_000008685.2	lp28-2	25979	26390	411	100.0	2.076e-91
URI89H	contig_16	6093	2256	3837	renamed_GCF_000008685.2	lp28-3	7728	3891	3837	100.0	0.0
URI89H	contig_16	8881	8212	669	renamed_GCF_000008685.2	lp28-3	10516	9847	669	100.0	5.739e-140
URI89H	contig_16	14883	15780	897	renamed_GCF_000008685.2	lp28-3	16518	17415	897	100.0	1.518e-201
URI89H	contig_16	16311	17067	756	renamed_GCF_000008685.2	lp28-3	17946	18702	756	100.0	8.81e-167
URI89H	contig_16	19834	20584	750	renamed_GCF_000008685.2	lp28-3	21469	22219	750	100.0	6.33e-161
URI89H	contig_16	25810	25342	468	renamed_GCF_000008685.2	lp28-3	27445	26977	468	99.3	1.339e-105
URI89H	contig_20	8857	9520	663	renamed_GCF_000008685.2	lp17	11646	10983	663	100.0	1.005e-149
URI89H	contig_20	12237	11124	1113	renamed_GCF_000008685.2	lp17	8266	9379	1113	100.0	6.27e-248
URI89H	contig_20	14051	14630	579	renamed_GCF_000008685.2	lp17	6452	5873	579	100.0	2.345e-126
URI89H	contig_20	16906	16684	222	renamed_GCF_000008685.2	lp17	3651	3819	222	100.0	6.565e-33
URI89H	contig_20	19094	18737	357	renamed_GCF_000008685.2	lp17	1409	1766	357	100.0	1.532e-77
URI89H	contig_35	409	19	390	renamed_GCF_000008685.2	cp32-8	5767	6157	390	100.0	3.229e-83
URI89H	contig_1	28491	27855	636	renamed_GCF_000008685.2	chromosome	28490	27854	636	100.0	8.334e-139
URI89H	contig_1	60534	60036	498	renamed_GCF_000008685.2	chromosome	60533	60035	498	100.0	3.278e-109
URI89H	contig_1	63147	64029	882	renamed_GCF_000008685.2	chromosome	63146	64028	882	100.0	1.369e-191
URI89H	contig_1	65291	65753	462	renamed_GCF_000008685.2	chromosome	65290	65752	462	100.0	3.193e-95
URI89H	contig_1	67248	69570	2322	renamed_GCF_000008685.2	chromosome	67247	69569	2322	100.0	0.0
URI89H	contig_1	80982	81408	426	renamed_GCF_000008685.2	chromosome	80982	81408	426	100.0	5.338e-92
URI89H	contig_1	83920	82969	951	renamed_GCF_000008685.2	chromosome	83920	82969	951	99.6	3.736e-209
URI89H	contig_1	86854	85879	975	renamed_GCF_000008685.2	chromosome	86854	85879	975	100.0	4.354e-220
URI89H	contig_1	186555	186948	393	renamed_GCF_000008685.2	chromosome	186553	186946	393	100.0	5.626e-86
URI89H	contig_1	186950	187196	246	renamed_GCF_000008685.2	chromosome	186948	187194	246	100.0	9.168e-49
URI89H	contig_1	187833	187179	654	renamed_GCF_000008685.2	chromosome	187831	187177	654	100.0	1.397e-144
URI89H	contig_1	188239	187825	414	renamed_GCF_000008685.2	chromosome	188237	187823	414	100.0	2.918e-88
URI89H	contig_1	188496	188235	261	renamed_GCF_000008685.2	chromosome	188494	188233	261	100.0	7.054e-54
URI89H	contig_1	201052	199966	1086	renamed_GCF_000008685.2	chromosome	201050	199964	1086	100.0	2.679e-244
URI89H	contig_1	202580	201053	1527	renamed_GCF_000008685.2	chromosome	202578	201051	1527	100.0	0.0
URI89H	contig_1	228523	227815	708	renamed_GCF_000008685.2	chromosome	228521	227813	708	100.0	8.763e-159
URI89H	contig_1	229218	230226	1008	renamed_GCF_000008685.2	chromosome	229216	230224	1008	100.0	1.228e-222
URI89H	contig_1	231493	230215	1278	renamed_GCF_000008685.2	chromosome	231491	230213	1278	100.0	4.58e-288
URI89H	contig_1	231622	232324	702	renamed_GCF_000008685.2	chromosome	231620	232322	702	100.0	1.161e-154
URI89H	contig_1	232339	235255	2916	renamed_GCF_000008685.2	chromosome	232337	235253	2916	100.0	0.0
URI89H	contig_1	255647	256262	615	renamed_GCF_000008685.2	chromosome	255645	256260	615	100.0	1.16e-131
URI89H	contig_1	256464	258987	2523	renamed_GCF_000008685.2	chromosome	256462	258985	2523	100.0	0.0
URI89H	contig_1	281313	279408	1905	renamed_GCF_000008685.2	chromosome	281311	279406	1905	100.0	0.0
URI89H	contig_1	282689	281801	888	renamed_GCF_000008685.2	chromosome	282687	281799	888	100.0	4.025e-189
URI89H	contig_1	302491	300781	1710	renamed_GCF_000008685.2	chromosome	302489	300779	1710	100.0	0.0
URI89H	contig_1	303311	302852	459	renamed_GCF_000008685.2	chromosome	303309	302850	459	100.0	4.601e-99
URI89H	contig_1	514528	515788	1260	renamed_GCF_000008685.2	chromosome	514523	515783	1260	100.0	5.48e-283
URI89H	contig_1	535601	535178	423	renamed_GCF_000008685.2	chromosome	535600	535177	423	100.0	5.606e-91
URI89H	contig_1	539276	538328	948	renamed_GCF_000008685.2	chromosome	539275	538327	948	100.0	1.008e-214
URI89H	contig_1	542263	543025	762	renamed_GCF_000008685.2	chromosome	542262	543024	762	100.0	5.516e-173
URI89H	contig_1	604769	603725	1044	renamed_GCF_000008685.2	chromosome	604769	603725	1044	100.0	3.194e-235
URI89H	contig_1	607137	607935	798	renamed_GCF_000008685.2	chromosome	607137	607935	798	100.0	9.72e-173
URI89H	contig_1	611193	609942	1251	renamed_GCF_000008685.2	chromosome	611193	609942	1251	100.0	7.081e-270
URI89H	contig_1	612047	613985	1938	renamed_GCF_000008685.2	chromosome	612047	613985	1938	100.0	0.0
URI89H	contig_1	616390	615763	627	renamed_GCF_000008685.2	chromosome	616390	615763	627	100.0	5.736e-133
URI89H	contig_1	632484	634464	1980	renamed_GCF_000008685.2	chromosome	632484	634464	1980	100.0	0.0
URI89H	contig_1	636591	637956	1365	renamed_GCF_000008685.2	chromosome	636592	637957	1365	100.0	3.184e-298
URI89H	contig_1	638578	639871	1293	renamed_GCF_000008685.2	chromosome	638579	639872	1293	100.0	3.129e-286
URI89H	contig_1	642287	642440	153	renamed_GCF_000008685.2	chromosome	642288	642441	153	100.0	5.64e-31
URI89H	contig_1	644649	643293	1356	renamed_GCF_000008685.2	chromosome	644650	643294	1356	100.0	1.597e-304
URI89H	contig_1	690190	690487	297	renamed_GCF_000008685.2	chromosome	690192	690489	297	100.0	1.037e-63
URI89H	contig_1	690882	692643	1761	renamed_GCF_000008685.2	chromosome	690884	692645	1761	100.0	0.0
URI89H	contig_1	693551	694694	1143	renamed_GCF_000008685.2	chromosome	693553	694696	1143	100.0	3.979e-258
URI89H	contig_1	695628	696762	1134	renamed_GCF_000008685.2	chromosome	695630	696764	1134	100.0	1.419e-259
URI89H	contig_1	697583	698330	747	renamed_GCF_000008685.2	chromosome	697585	698332	747	100.0	1.547e-167
URI89H	contig_1	700922	700049	873	renamed_GCF_000008685.2	chromosome	700924	700051	873	100.0	5.874e-191
URI89H	contig_1	701026	701383	357	renamed_GCF_000008685.2	chromosome	701028	701385	357	100.0	2.301e-81
URI89H	contig_1	701392	701803	411	renamed_GCF_000008685.2	chromosome	701394	701805	411	100.0	2.78e-88
URI89H	contig_1	701822	702272	450	renamed_GCF_000008685.2	chromosome	701824	702274	450	100.0	9.762e-98
URI89H	contig_1	702964	702280	684	renamed_GCF_000008685.2	chromosome	702951	702282	684	100.0	4.537e-145
URI89H	contig_1	866502	866703	201	renamed_GCF_000008685.2	chromosome	866493	866694	201	100.0	2.206e-40
URI89H	contig_1	868123	867751	372	renamed_GCF_000008685.2	chromosome	868114	867742	372	100.0	7.954e-79
URI89H	contig_1	893137	896578	3441	renamed_GCF_000008685.2	chromosome	893128	896569	3441	100.0	0.0
URI89H	contig_1	897704	897104	600	renamed_GCF_000008685.2	chromosome	897695	897095	600	100.0	6.881e-135
URI89H	contig_1	899507	900740	1233	renamed_GCF_000008685.2	chromosome	899498	900731	1233	100.0	1.522e-275
URI89H	contig_1	901842	903267	1425	renamed_GCF_000008685.2	chromosome	901833	903258	1425	100.0	1.211e-310
URI89H	contig_2	10134	11043	909	renamed_GCF_000008685.2	lp54	43532	42623	909	100.0	1.089e-198
URI89H	contig_2	12621	13455	834	renamed_GCF_000008685.2	lp54	41045	40211	834	100.0	3.319e-182
URI89H	contig_2	14261	15506	1245	renamed_GCF_000008685.2	lp54	39405	38160	1245	100.0	4.898e-273
URI89H	contig_4	14812	14272	540	renamed_GCF_000008685.2	lp36	14841	14301	540	100.0	2.234e-120
URI89H	contig_4	16245	16857	612	renamed_GCF_000008685.2	lp36	16274	16886	612	100.0	9.153e-134
URI89H	contig_5	2810	2243	567	renamed_GCF_000008685.2	cp32-6	20178	20745	567	100.0	6.547e-130
URI89H	contig_5	4308	5256	948	renamed_GCF_000008685.2	cp32-6	18680	17732	948	100.0	7.628e-218
URI89H	contig_5	5913	6396	483	renamed_GCF_000008685.2	cp32-6	17075	16592	483	100.0	5.056e-102
URI89H	contig_5	21683	20990	693	renamed_GCF_000008685.2	lp56	35114	35807	693	100.0	1.057e-145
URI89H	contig_5	24343	22990	1353	renamed_GCF_000008685.2	lp56	32454	33807	1353	100.0	5.71e-307
URI89H	contig_5	24906	24339	567	renamed_GCF_000008685.2	lp56	31891	32458	567	100.0	5.734e-123
URI89H	contig_5	26861	25823	1038	renamed_GCF_000008685.2	lp56	29936	30974	1038	100.0	2.28e-229
URI89H	contig_9	8642	9248	606	renamed_GCF_000008685.2	cp32-7	13715	14321	606	99.5	2.704e-129
URI89H	contig_9	10148	10352	204	renamed_GCF_000008685.2	cp32-4	15166	15370	204	100.0	2.578e-39
URI89H	contig_9	20714	19937	777	renamed_GCF_000008685.2	cp32-1	25816	25039	777	100.0	2.863e-174
URI89H	contig_9	21693	22830	1137	renamed_GCF_000008685.2	cp32-1	26795	27932	1137	100.0	3.741e-249
URI89H	contig_9	23013	23553	540	renamed_GCF_000008685.2	cp32-8	28250	28790	540	100.0	1.472e-116
URI89H	contig_10	12382	11998	384	renamed_GCF_000008685.2	lp56	8866	9250	384	100.0	2.931e-83
URI89H	contig_11	7473	8349	876	renamed_GCF_000008685.2	cp32-9	12921	13797	876	99.6	3.04e-190
URI89H	contig_11	9863	10067	204	renamed_GCF_000008685.2	cp32-6	15230	15434	204	100.0	2.578e-39
URI89H	contig_11	17745	19071	1326	renamed_GCF_000008685.2	lp56	26920	28246	1326	99.0	3.858e-298
URI89H	contig_11	21349	22381	1032	renamed_GCF_000008685.2	cp32-9	26797	27829	1032	100.0	2.498e-227
URI89H	contig_12	1911	2340	429	renamed_GCF_000008685.2	cp32-4	7837	8266	429	100.0	5.601e-92
URI89H	contig_12	2807	3044	237	renamed_GCF_000008685.2	lp56	12192	12429	237	100.0	1.76e-48
URI89H	contig_12	4369	4966	597	renamed_GCF_000008685.2	cp32-4	10295	10892	597	100.0	4.743e-130
URI89H	contig_12	6521	6854	333	renamed_GCF_000008685.2	cp32-6	12513	12846	333	100.0	8.424e-72
URI89H	contig_12	14682	15438	756	renamed_GCF_000008685.2	cp32-4	20608	21364	756	100.0	8.022e-168
URI89H	contig_12	16904	18230	1326	renamed_GCF_000008685.2	cp32-4	22830	24156	1326	100.0	6.506e-301
URI89H	contig_13	17772	16548	1224	renamed_GCF_000008685.2	cp32-8	65	1289	1224	100.0	2.096e-270
URI89H	contig_14	15554	15008	546	renamed_GCF_000008685.2	lp28-2	15431	14885	546	100.0	8.811e-115
URI89H	contig_14	17807	16616	1191	renamed_GCF_000008685.2	lp28-2	17684	16493	1191	100.0	6.781e-269
URI89H	contig_14	18950	18152	798	renamed_GCF_000008685.2	lp28-2	18827	18029	798	100.0	7.719e-184
URI89H	contig_14	22427	19742	2685	renamed_GCF_000008685.2	lp28-2	22259	19619	2685	99.8	0.0
URI89H	contig_14	23156	22781	375	renamed_GCF_000008685.2	lp28-2	23033	22658	375	100.0	2.05e-77
URI89H	contig_15	1728	1371	357	renamed_GCF_000008685.2	cp32-7	15428	15785	357	99.1	1.866e-75
URI89H	contig_15	2826	2010	816	renamed_GCF_000008685.2	cp32-1	14323	15139	816	100.0	1.636e-178
URI89H	contig_15	4655	4322	333	renamed_GCF_000008685.2	cp32-1	12494	12827	333	100.0	8.424e-72
URI89H	contig_17	20673	19881	792	renamed_GCF_000008685.2	lp28-4	21562	20770	792	100.0	1.631e-174
URI89H	contig_17	23106	22269	837	renamed_GCF_000008685.2	lp28-4	23995	23158	837	100.0	6.415e-184
URI89H	contig_17	25470	26022	552	renamed_GCF_000008685.2	lp36	35867	36422	552	99.4	5.467e-121
URI89H	contig_18	2187	3543	1356	renamed_GCF_000008685.2	cp26	19321	17965	1356	100.0	1.971e-293
URI89H	contig_18	16740	15642	1098	renamed_GCF_000008685.2	cp26	4768	5866	1098	100.0	2.035e-249
URI89H	contig_18	17425	17077	348	renamed_GCF_000008685.2	cp26	4083	4431	348	100.0	1.075e-71
URI89H	contig_18	19322	20672	1350	renamed_GCF_000008685.2	cp26	2186	836	1350	100.0	7.868e-303
URI89H	contig_18	21463	21184	279	renamed_GCF_000008685.2	cp26	45	324	279	100.0	2.323e-60
URI89H	contig_18	24752	23507	1245	renamed_GCF_000008685.2	cp26	23254	24499	1245	100.0	1.056e-281