QUERY_ID	QUERY_NAME	QUERY_START	QUERY_END	QUERY_LENGTH	REF_ID	REF_NAME	REF_START	REF_END	REF_LENGTH	IDENTITY	EVALUE
UWI263P	contig_1	85322	85028	294	renamed_GCF_000008685.2	chromosome	822809	823103	294	100.0	1.207e-61
UWI263P	contig_1	85788	85437	351	renamed_GCF_000008685.2	chromosome	822343	822694	351	99.1	1.534e-76
UWI263P	contig_1	87525	86943	582	renamed_GCF_000008685.2	chromosome	820606	821188	582	100.0	9.143e-129
UWI263P	contig_1	88890	88644	246	renamed_GCF_000008685.2	chromosome	819241	819487	246	100.0	8.275e-50
UWI263P	contig_1	89210	88889	321	renamed_GCF_000008685.2	chromosome	819035	819242	321	97.0	1.267e-41
UWI263P	contig_1	90114	89583	531	renamed_GCF_000008685.2	chromosome	818017	818548	531	100.0	1.403e-115
UWI263P	contig_1	90935	91826	891	renamed_GCF_000008685.2	chromosome	817160	816311	891	99.6	1.029e-187
UWI263P	contig_1	101244	102393	1149	renamed_GCF_000008685.2	chromosome	806923	805774	1149	99.7	5.42e-247
UWI263P	contig_1	105000	105330	330	renamed_GCF_000008685.2	chromosome	803167	802837	330	100.0	2.178e-69
UWI263P	contig_1	105369	106227	858	renamed_GCF_000008685.2	chromosome	802798	801940	858	99.6	1.709e-176
UWI263P	contig_1	296782	296068	714	renamed_GCF_000008685.2	chromosome	611308	612022	714	99.5	9.633e-159
UWI263P	contig_1	296897	298148	1251	renamed_GCF_000008685.2	chromosome	611193	609942	1251	98.0	4.601e-266
UWI263P	contig_1	298184	299030	846	renamed_GCF_000008685.2	chromosome	609906	609060	846	100.0	3.324e-184
UWI263P	contig_1	300953	300155	798	renamed_GCF_000008685.2	chromosome	607137	607935	798	97.7	3.139e-168
UWI263P	contig_1	317738	317150	588	renamed_GCF_000008685.2	chromosome	590347	590935	588	99.4	4.112e-130
UWI263P	contig_1	317877	318402	525	renamed_GCF_000008685.2	chromosome	590208	589683	525	97.7	3.018e-106
UWI263P	contig_1	320020	318418	1602	renamed_GCF_000008685.2	chromosome	588065	589667	1602	99.8	0.0
UWI263P	contig_1	321055	320203	852	renamed_GCF_000008685.2	chromosome	587030	587882	852	98.2	2.291e-189
UWI263P	contig_1	345900	343917	1983	renamed_GCF_000008685.2	chromosome	562184	564167	1983	99.8	0.0
UWI263P	contig_1	346141	346522	381	renamed_GCF_000008685.2	chromosome	561943	561562	381	99.2	5.027e-77
UWI263P	contig_1	346530	346950	420	renamed_GCF_000008685.2	chromosome	561554	561116	420	93.0	2.589e-82
UWI263P	contig_1	346939	347338	399	renamed_GCF_000008685.2	chromosome	561127	560728	399	96.2	1.01e-80
UWI263P	contig_1	347334	350061	2727	renamed_GCF_000008685.2	chromosome	560732	558005	2727	99.4	0.0
UWI263P	contig_1	359588	360233	645	renamed_GCF_000008685.2	chromosome	548490	547845	645	100.0	1.056e-137
UWI263P	contig_1	363493	360691	2802	renamed_GCF_000008685.2	chromosome	544585	547387	2802	98.8	0.0
UWI263P	contig_1	364247	363473	774	renamed_GCF_000008685.2	chromosome	543831	544605	774	99.6	1.962e-169
UWI263P	contig_1	365030	364262	768	renamed_GCF_000008685.2	chromosome	543048	543816	768	99.6	4.167e-177
UWI263P	contig_1	365816	365054	762	renamed_GCF_000008685.2	chromosome	542262	543024	762	99.2	1.347e-171
UWI263P	contig_1	15032	11591	3441	renamed_GCF_000008685.2	chromosome	893128	896569	3441	98.5	0.0
UWI263P	contig_1	17839	14986	2853	renamed_GCF_000008685.2	chromosome	890321	893174	2853	99.7	0.0
UWI263P	contig_1	19981	21691	1710	renamed_GCF_000008685.2	chromosome	888179	886469	1710	99.2	0.0
UWI263P	contig_1	21713	23933	2220	renamed_GCF_000008685.2	chromosome	886447	884227	2220	99.0	0.0
UWI263P	contig_1	23947	27076	3129	renamed_GCF_000008685.2	chromosome	884213	881084	3129	99.7	0.0
UWI263P	contig_1	27069	27894	825	renamed_GCF_000008685.2	chromosome	881091	880266	825	99.6	6.405e-182
UWI263P	contig_1	28846	27910	936	renamed_GCF_000008685.2	chromosome	879314	880250	936	99.6	1.601e-207
UWI263P	contig_1	31732	28879	2853	renamed_GCF_000008685.2	chromosome	876491	879281	2853	99.3	0.0
UWI263P	contig_1	32954	31712	1242	renamed_GCF_000008685.2	chromosome	875206	876448	1242	98.3	3.236e-277
UWI263P	contig_1	47722	46387	1335	renamed_GCF_000008685.2	chromosome	860439	861774	1335	98.6	5.478e-287
UWI263P	contig_1	48050	49223	1173	renamed_GCF_000008685.2	chromosome	860111	858938	1173	98.9	1.696e-255
UWI263P	contig_1	50656	49246	1410	renamed_GCF_000008685.2	chromosome	857505	858915	1410	99.3	7.483e-305
UWI263P	contig_1	52173	50652	1521	renamed_GCF_000008685.2	chromosome	855988	857509	1521	99.8	0.0
UWI263P	contig_1	53293	52165	1128	renamed_GCF_000008685.2	chromosome	854868	855996	1128	99.4	1.292e-259
UWI263P	contig_1	54387	53319	1068	renamed_GCF_000008685.2	chromosome	853774	854842	1068	100.0	1.362e-231
UWI263P	contig_1	55673	54383	1290	renamed_GCF_000008685.2	chromosome	852488	853778	1290	99.7	1.474e-285
UWI263P	contig_1	57168	55647	1521	renamed_GCF_000008685.2	chromosome	850993	852514	1521	99.4	0.0
UWI263P	contig_1	59343	57174	2169	renamed_GCF_000008685.2	chromosome	848836	850987	2169	99.8	0.0
UWI263P	contig_1	59624	59357	267	renamed_GCF_000008685.2	chromosome	848537	848804	267	100.0	3.495e-54
UWI263P	contig_1	60671	59822	849	renamed_GCF_000008685.2	chromosome	847490	848339	849	99.6	1.428e-185
UWI263P	contig_1	61036	60673	363	renamed_GCF_000008685.2	chromosome	847125	847488	363	100.0	2.269e-74
UWI263P	contig_1	63678	61059	2619	renamed_GCF_000008685.2	chromosome	844453	847102	2619	97.6	0.0
UWI263P	contig_1	65129	63680	1449	renamed_GCF_000008685.2	chromosome	843002	844451	1449	99.5	1.877e-318
UWI263P	contig_1	65580	65142	438	renamed_GCF_000008685.2	chromosome	842500	842989	438	98.6	2.908e-92
UWI263P	contig_1	66298	65680	618	renamed_GCF_000008685.2	chromosome	841833	842451	618	100.0	1.393e-138
UWI263P	contig_1	68888	66299	2589	renamed_GCF_000008685.2	chromosome	839243	841832	2589	99.5	0.0
UWI263P	contig_1	69585	69051	534	renamed_GCF_000008685.2	chromosome	838546	839080	534	100.0	7.282e-115
UWI263P	contig_1	72071	69605	2466	renamed_GCF_000008685.2	chromosome	836060	838526	2466	99.5	0.0
UWI263P	contig_1	131487	132501	1014	renamed_GCF_000008685.2	chromosome	776679	775665	1014	99.7	8.011e-220
UWI263P	contig_1	159987	158091	1896	renamed_GCF_000008685.2	chromosome	748122	750018	1896	100.0	0.0
UWI263P	contig_1	163589	163265	324	renamed_GCF_000008685.2	chromosome	744521	744845	324	99.0	2.941e-65
UWI263P	contig_1	165482	166715	1233	renamed_GCF_000008685.2	chromosome	742628	741395	1233	99.5	1.829e-273
UWI263P	contig_1	167665	167422	243	renamed_GCF_000008685.2	chromosome	740445	740688	243	100.0	1.755e-49
UWI263P	contig_1	168426	167934	492	renamed_GCF_000008685.2	chromosome	739684	740176	492	99.3	2.164e-104
UWI263P	contig_1	178497	177603	894	renamed_GCF_000008685.2	chromosome	729612	730506	894	98.9	3.048e-193
UWI263P	contig_1	180373	179434	939	renamed_GCF_000008685.2	chromosome	727736	728675	939	100.0	1.678e-207
UWI263P	contig_1	182679	181614	1065	renamed_GCF_000008685.2	chromosome	725430	726495	1065	96.0	1.425e-230
UWI263P	contig_1	183979	185047	1068	renamed_GCF_000008685.2	chromosome	724130	723062	1068	99.7	1.68e-246
UWI263P	contig_1	225572	226412	840	renamed_GCF_000008685.2	chromosome	682524	681684	840	100.0	1.641e-182
UWI263P	contig_1	227533	228343	810	renamed_GCF_000008685.2	chromosome	680557	679753	810	99.6	5.278e-173
UWI263P	contig_1	246576	248448	1872	renamed_GCF_000008685.2	chromosome	661515	659643	1872	99.1	0.0
UWI263P	contig_1	254205	253242	963	renamed_GCF_000008685.2	chromosome	653886	654849	963	100.0	5.23e-216
UWI263P	contig_1	257704	258922	1218	renamed_GCF_000008685.2	chromosome	650387	649169	1218	100.0	2.758e-266
UWI263P	contig_1	259765	261433	1668	renamed_GCF_000008685.2	chromosome	648254	646658	1668	99.4	0.0
UWI263P	contig_1	289263	287055	2208	renamed_GCF_000008685.2	chromosome	618827	621035	2208	100.0	0.0
UWI263P	contig_1	398758	397225	1533	renamed_GCF_000008685.2	chromosome	509313	510846	1533	100.0	0.0
UWI263P	contig_1	399202	398830	372	renamed_GCF_000008685.2	chromosome	508869	509241	372	99.1	4.349e-77
UWI263P	contig_1	418340	417518	822	renamed_GCF_000008685.2	chromosome	489732	490554	822	98.9	1.491e-180
UWI263P	contig_1	418581	418353	228	renamed_GCF_000008685.2	chromosome	489539	489719	228	96.6	3.611e-32
UWI263P	contig_1	419090	418577	513	renamed_GCF_000008685.2	chromosome	488982	489495	513	100.0	1.545e-111
UWI263P	contig_1	419847	419100	747	renamed_GCF_000008685.2	chromosome	488225	488972	747	99.5	1.867e-165
UWI263P	contig_1	420538	419848	690	renamed_GCF_000008685.2	chromosome	487534	488224	690	98.6	2.579e-152
UWI263P	contig_1	421356	420534	822	renamed_GCF_000008685.2	chromosome	486746	487538	822	99.6	9.243e-169
UWI263P	contig_1	421999	421303	696	renamed_GCF_000008685.2	chromosome	486073	486769	696	100.0	2.835e-152
UWI263P	contig_1	422523	421995	528	renamed_GCF_000008685.2	chromosome	485549	486077	528	100.0	1.004e-118
UWI263P	contig_1	423310	422806	504	renamed_GCF_000008685.2	chromosome	484756	485266	504	99.4	1.338e-111
UWI263P	contig_1	423786	423486	300	renamed_GCF_000008685.2	chromosome	484286	484586	300	98.9	5.976e-62
UWI263P	contig_1	459364	458758	606	renamed_GCF_000008685.2	chromosome	448707	449310	606	99.5	2.46e-130
UWI263P	contig_1	459477	459867	390	renamed_GCF_000008685.2	chromosome	448591	448201	390	100.0	7.926e-82
UWI263P	contig_1	460214	459896	318	renamed_GCF_000008685.2	chromosome	447854	448172	318	100.0	8.883e-69
UWI263P	contig_1	460425	461100	675	renamed_GCF_000008685.2	chromosome	447736	446968	675	99.5	9.618e-144
UWI263P	contig_1	461194	461743	549	renamed_GCF_000008685.2	chromosome	446875	446326	549	98.9	2.344e-121
UWI263P	contig_1	464821	465382	561	renamed_GCF_000008685.2	chromosome	443248	442687	561	99.4	1.054e-123
UWI263P	contig_1	465515	466355	840	renamed_GCF_000008685.2	chromosome	442552	441712	840	98.9	7.382e-183
UWI263P	contig_1	472965	477450	4485	renamed_GCF_000008685.2	chromosome	435103	430618	4485	98.1	0.0
UWI263P	contig_1	477452	478376	924	renamed_GCF_000008685.2	chromosome	430616	429692	924	98.0	2.542e-200
UWI263P	contig_1	479423	478394	1029	renamed_GCF_000008685.2	chromosome	428645	429674	1029	99.1	2.098e-237
UWI263P	contig_1	533806	532429	1377	renamed_GCF_000008685.2	chromosome	374276	375653	1377	99.7	6.3e-310
UWI263P	contig_1	533931	534516	585	renamed_GCF_000008685.2	chromosome	374151	373566	585	99.4	4.742e-128
UWI263P	contig_1	534943	534562	381	renamed_GCF_000008685.2	chromosome	373139	373520	381	99.2	8.339e-80
UWI263P	contig_1	537049	535036	2013	renamed_GCF_000008685.2	chromosome	371033	373046	2013	99.4	0.0
UWI263P	contig_1	538056	537069	987	renamed_GCF_000008685.2	chromosome	370026	371013	987	99.3	3.978e-223
UWI263P	contig_1	539099	538055	1044	renamed_GCF_000008685.2	chromosome	368884	370027	1044	99.1	5.75e-220
UWI263P	contig_1	539626	539200	426	renamed_GCF_000008685.2	chromosome	368455	368881	426	98.5	9.562e-86
UWI263P	contig_1	541121	541853	732	renamed_GCF_000008685.2	chromosome	366960	366228	732	97.9	6.321e-158
UWI263P	contig_1	564874	563902	972	renamed_GCF_000008685.2	chromosome	343207	344179	972	100.0	3.579e-213
UWI263P	contig_1	565747	564874	873	renamed_GCF_000008685.2	chromosome	342334	343207	873	99.6	7.766e-188
UWI263P	contig_1	566808	565758	1050	renamed_GCF_000008685.2	chromosome	341273	342323	1050	100.0	1.489e-227
UWI263P	contig_1	567741	566820	921	renamed_GCF_000008685.2	chromosome	340340	341261	921	98.6	3.516e-196
UWI263P	contig_1	569724	568098	1626	renamed_GCF_000008685.2	chromosome	338357	339983	1626	99.8	0.0
UWI263P	contig_1	573133	571561	1572	renamed_GCF_000008685.2	chromosome	334936	336508	1572	99.8	0.0
UWI263P	contig_1	573554	574451	897	renamed_GCF_000008685.2	chromosome	334515	333618	897	100.0	1.666e-200
UWI263P	contig_1	574471	577276	2805	renamed_GCF_000008685.2	chromosome	333598	330802	2805	99.6	0.0
UWI263P	contig_1	577326	578436	1110	renamed_GCF_000008685.2	chromosome	330752	329642	1110	100.0	1.105e-249
UWI263P	contig_8	14143	13192	951	renamed_GCF_000008685.2	cp32-6	10961	11912	951	100.0	4.333e-216
UWI263P	contig_8	16085	14822	1263	renamed_GCF_000008685.2	cp32-3	8967	10242	1263	88.9	8.376e-244
UWI263P	contig_8	16329	16092	237	renamed_GCF_000008685.2	cp32-6	8733	8970	237	100.0	7.893e-49
UWI263P	contig_8	16781	16325	456	renamed_GCF_000008685.2	cp32-6	8281	8737	456	98.0	2.171e-98
UWI263P	contig_8	17225	16796	429	renamed_GCF_000008685.2	lp56	11296	11725	429	100.0	5.601e-92
UWI263P	contig_8	18902	18332	570	renamed_GCF_000008685.2	cp32-6	6160	6730	570	98.4	5.468e-124
UWI263P	contig_8	19288	18898	390	renamed_GCF_000008685.2	cp32-6	5774	6164	390	99.2	3.229e-83
UWI263P	contig_8	19659	19275	384	renamed_GCF_000008685.2	cp32-6	5403	5787	384	100.0	2.931e-83
UWI263P	contig_1	190364	189437	927	renamed_GCF_000008685.2	chromosome	717742	718669	927	100.0	3.519e-197
UWI263P	contig_1	191487	190335	1152	renamed_GCF_000008685.2	chromosome	716619	717771	1152	100.0	1.261e-246
UWI263P	contig_1	193098	191487	1611	renamed_GCF_000008685.2	chromosome	715008	716619	1611	99.8	0.0
UWI263P	contig_1	193340	194003	663	renamed_GCF_000008685.2	chromosome	714766	714103	663	98.6	1.611e-144
UWI263P	contig_1	193999	194863	864	renamed_GCF_000008685.2	chromosome	714107	713243	864	100.0	1.134e-190
UWI263P	contig_1	194856	195903	1047	renamed_GCF_000008685.2	chromosome	713250	712203	1047	100.0	4.165e-224
UWI263P	contig_1	195899	196415	516	renamed_GCF_000008685.2	chromosome	712207	711691	516	99.4	8.019e-111
UWI263P	contig_1	196896	196455	441	renamed_GCF_000008685.2	chromosome	711210	711651	441	100.0	1.245e-93
UWI263P	contig_1	197421	196935	486	renamed_GCF_000008685.2	chromosome	710685	711171	486	100.0	5.304e-102
UWI263P	contig_1	198833	197432	1401	renamed_GCF_000008685.2	chromosome	709273	710674	1401	98.4	5.94e-306
UWI263P	contig_1	229158	230205	1047	renamed_GCF_000008685.2	chromosome	678938	677891	1047	100.0	5.633e-238
UWI263P	contig_1	231625	230236	1389	renamed_GCF_000008685.2	chromosome	676471	677860	1389	100.0	1.442e-302
UWI263P	contig_1	233058	231714	1344	renamed_GCF_000008685.2	chromosome	675034	676378	1344	99.7	1.793e-292
UWI263P	contig_1	234751	233314	1437	renamed_GCF_000008685.2	chromosome	673341	674778	1437	99.3	0.0
UWI263P	contig_1	234880	236326	1446	renamed_GCF_000008685.2	chromosome	673167	671766	1446	98.7	5.364e-306
UWI263P	contig_1	239574	243084	3510	renamed_GCF_000008685.2	chromosome	668517	665007	3510	99.4	0.0
UWI263P	contig_1	243080	244913	1833	renamed_GCF_000008685.2	chromosome	665011	663178	1833	99.6	0.0
UWI263P	contig_1	245174	245489	315	renamed_GCF_000008685.2	chromosome	662917	662602	315	99.0	2.806e-64
UWI263P	contig_1	246486	245562	924	renamed_GCF_000008685.2	chromosome	661605	662529	924	99.6	1.144e-200
UWI263P	contig_1	301107	303312	2205	renamed_GCF_000008685.2	chromosome	606983	604778	2205	99.3	0.0
UWI263P	contig_1	303321	304365	1044	renamed_GCF_000008685.2	chromosome	604769	603725	1044	99.1	3.503e-234
UWI263P	contig_1	305717	304361	1356	renamed_GCF_000008685.2	chromosome	602373	603729	1356	99.3	1.137e-299
UWI263P	contig_1	307081	305746	1335	renamed_GCF_000008685.2	chromosome	601009	602344	1335	100.0	3.161e-293
UWI263P	contig_1	308596	307246	1350	renamed_GCF_000008685.2	chromosome	599494	600844	1350	100.0	3.989e-293
UWI263P	contig_1	308714	309503	789	renamed_GCF_000008685.2	chromosome	599376	598587	789	99.2	5.285e-178
UWI263P	contig_1	311560	309499	2061	renamed_GCF_000008685.2	chromosome	596530	598591	2061	100.0	0.0
UWI263P	contig_1	312148	311569	579	renamed_GCF_000008685.2	chromosome	595942	596521	579	99.4	1.865e-120
UWI263P	contig_1	315603	312159	3444	renamed_GCF_000008685.2	chromosome	592445	595931	3444	99.4	0.0
UWI263P	contig_1	316903	315733	1170	renamed_GCF_000008685.2	chromosome	591187	592357	1170	98.9	5.197e-251
UWI263P	contig_1	350042	350660	618	renamed_GCF_000008685.2	chromosome	558024	557406	618	100.0	1.216e-131
UWI263P	contig_1	350643	351501	858	renamed_GCF_000008685.2	chromosome	557423	556562	858	98.6	8.121e-185
UWI263P	contig_1	352848	351483	1365	renamed_GCF_000008685.2	chromosome	555215	556580	1365	98.8	3.723e-305
UWI263P	contig_1	354072	352851	1221	renamed_GCF_000008685.2	chromosome	553991	555212	1221	100.0	5.34e-268
UWI263P	contig_1	354925	354274	651	renamed_GCF_000008685.2	chromosome	553138	553789	651	100.0	1.464e-143
UWI263P	contig_1	356355	358437	2082	renamed_GCF_000008685.2	chromosome	551723	549641	2082	99.8	0.0
UWI263P	contig_1	358460	359159	699	renamed_GCF_000008685.2	chromosome	549618	548919	699	100.0	1.058e-146
UWI263P	contig_1	359193	359592	399	renamed_GCF_000008685.2	chromosome	548885	548486	399	99.2	3.385e-84
UWI263P	contig_1	400258	399223	1035	renamed_GCF_000008685.2	chromosome	507813	508848	1035	99.7	1.013e-220
UWI263P	contig_1	400666	400273	393	renamed_GCF_000008685.2	chromosome	507405	507798	393	100.0	3.073e-84
UWI263P	contig_1	401070	400692	378	renamed_GCF_000008685.2	chromosome	507001	507379	378	100.0	8.763e-79
UWI263P	contig_1	401201	401087	114	renamed_GCF_000008685.2	chromosome	506864	506984	114	100.0	7.638e-22
UWI263P	contig_1	402518	401213	1305	renamed_GCF_000008685.2	chromosome	505553	506858	1305	99.7	2.039e-284
UWI263P	contig_1	402968	402530	438	renamed_GCF_000008685.2	chromosome	505103	505541	438	100.0	1.186e-93
UWI263P	contig_1	403273	402967	306	renamed_GCF_000008685.2	chromosome	504798	505104	306	100.0	1.468e-61
UWI263P	contig_1	403774	403276	498	renamed_GCF_000008685.2	chromosome	504297	504795	498	100.0	1.785e-107
UWI263P	contig_1	404146	403786	360	renamed_GCF_000008685.2	chromosome	503925	504285	360	100.0	4.361e-75
UWI263P	contig_1	404706	404163	543	renamed_GCF_000008685.2	chromosome	503365	503908	543	100.0	7.636e-116
UWI263P	contig_1	425473	423790	1683	renamed_GCF_000008685.2	chromosome	482599	484282	1683	99.2	0.0
UWI263P	contig_1	426015	426729	714	renamed_GCF_000008685.2	chromosome	482057	481343	714	100.0	3.944e-160
UWI263P	contig_1	428364	427053	1311	renamed_GCF_000008685.2	chromosome	479708	481019	1311	100.0	7.438e-297
UWI263P	contig_1	429995	431807	1812	renamed_GCF_000008685.2	chromosome	478005	476262	1812	99.4	0.0
UWI263P	contig_1	432464	431858	606	renamed_GCF_000008685.2	chromosome	475605	476211	606	100.0	1.006e-131
UWI263P	contig_1	433457	432467	990	renamed_GCF_000008685.2	chromosome	474612	475602	990	99.6	3.939e-215
UWI263P	contig_1	433513	434665	1152	renamed_GCF_000008685.2	chromosome	474556	473404	1152	100.0	7.714e-261
UWI263P	contig_1	435504	434661	843	renamed_GCF_000008685.2	chromosome	472565	473408	843	100.0	5.328e-187
UWI263P	contig_1	435594	436299	705	renamed_GCF_000008685.2	chromosome	472358	471770	705	99.4	1.099e-121
UWI263P	contig_1	480082	479446	636	renamed_GCF_000008685.2	chromosome	427986	428622	636	99.5	1.686e-139
UWI263P	contig_1	481333	480118	1215	renamed_GCF_000008685.2	chromosome	426735	427950	1215	99.7	1.711e-262
UWI263P	contig_1	482485	481357	1128	renamed_GCF_000008685.2	chromosome	425583	426711	1128	99.7	5.155e-244
UWI263P	contig_1	483375	482517	858	renamed_GCF_000008685.2	chromosome	424693	425551	858	100.0	1.579e-194
UWI263P	contig_1	483622	484246	624	renamed_GCF_000008685.2	chromosome	424442	423821	624	99.5	4.527e-135
UWI263P	contig_1	485013	484233	780	renamed_GCF_000008685.2	chromosome	423054	423834	780	99.6	1.628e-172
UWI263P	contig_1	486517	485887	630	renamed_GCF_000008685.2	chromosome	421553	422183	630	98.5	1.533e-139
UWI263P	contig_1	486690	488568	1878	renamed_GCF_000008685.2	chromosome	421380	419502	1878	99.5	0.0
UWI263P	contig_1	488564	489683	1119	renamed_GCF_000008685.2	chromosome	419506	418387	1119	99.7	1.781e-254
UWI263P	contig_1	511003	511477	474	renamed_GCF_000008685.2	chromosome	397077	396603	474	100.0	4.822e-101
UWI263P	contig_1	511574	512600	1026	renamed_GCF_000008685.2	chromosome	396506	395480	1026	100.0	3.003e-224
UWI263P	contig_1	512916	513978	1062	renamed_GCF_000008685.2	chromosome	395166	394104	1062	99.7	9.401e-235
UWI263P	contig_1	514019	515039	1020	renamed_GCF_000008685.2	chromosome	394063	393043	1020	100.0	6.665e-223
UWI263P	contig_1	515125	516151	1026	renamed_GCF_000008685.2	chromosome	392957	391931	1026	99.4	6.082e-225
UWI263P	contig_1	516263	517688	1425	renamed_GCF_000008685.2	chromosome	391819	390391	1425	99.5	0.0
UWI263P	contig_1	517741	519106	1365	renamed_GCF_000008685.2	chromosome	390341	388976	1365	99.3	3.579e-288
UWI263P	contig_1	519156	519576	420	renamed_GCF_000008685.2	chromosome	388926	388506	420	100.0	9.787e-93
UWI263P	contig_1	519602	520265	663	renamed_GCF_000008685.2	chromosome	388480	387817	663	99.5	1.104e-148
UWI263P	contig_1	520749	520275	474	renamed_GCF_000008685.2	chromosome	387333	387807	474	100.0	1.339e-106
UWI263P	contig_1	578817	578457	360	renamed_GCF_000008685.2	chromosome	329261	329621	360	100.0	1.609e-77
UWI263P	contig_1	580050	578913	1137	renamed_GCF_000008685.2	chromosome	328031	329165	1137	99.4	6.912e-251
UWI263P	contig_1	580354	581383	1029	renamed_GCF_000008685.2	chromosome	327757	326698	1029	99.4	1.646e-231
UWI263P	contig_1	581792	582845	1053	renamed_GCF_000008685.2	chromosome	326288	325235	1053	99.4	2.184e-232
UWI263P	contig_1	582844	584305	1461	renamed_GCF_000008685.2	chromosome	325236	323775	1461	99.7	0.0
UWI263P	contig_1	584301	585234	933	renamed_GCF_000008685.2	chromosome	323779	322846	933	99.3	9.965e-204
UWI263P	contig_1	585234	586041	807	renamed_GCF_000008685.2	chromosome	322846	322039	807	99.6	2.064e-174
UWI263P	contig_1	586729	586042	687	renamed_GCF_000008685.2	chromosome	321351	322038	687	100.0	1.336e-150
UWI263P	contig_1	587772	586728	1044	renamed_GCF_000008685.2	chromosome	320308	321352	1044	99.4	3.304e-226
UWI263P	contig_1	587822	588401	579	renamed_GCF_000008685.2	chromosome	320249	319679	579	98.9	3.43e-122
UWI263P	contig_1	614872	615655	783	renamed_GCF_000008685.2	chromosome	293208	292425	783	100.0	6.057e-167
UWI263P	contig_1	615654	616437	783	renamed_GCF_000008685.2	chromosome	292426	291643	783	100.0	1.874e-171
UWI263P	contig_1	616485	617022	537	renamed_GCF_000008685.2	chromosome	291595	291058	537	100.0	7.638e-115
UWI263P	contig_1	617059	618118	1059	renamed_GCF_000008685.2	chromosome	291021	289962	1059	100.0	3.164e-229
UWI263P	contig_1	618163	618505	342	renamed_GCF_000008685.2	chromosome	289917	289575	342	100.0	1.077e-70
UWI263P	contig_1	618497	619124	627	renamed_GCF_000008685.2	chromosome	289583	288956	627	100.0	2.836e-132
UWI263P	contig_1	619134	619899	765	renamed_GCF_000008685.2	chromosome	288946	288181	765	100.0	2.478e-165
UWI263P	contig_1	619907	620171	264	renamed_GCF_000008685.2	chromosome	288173	287909	264	100.0	2.025e-51
UWI263P	contig_1	620203	620992	789	renamed_GCF_000008685.2	chromosome	287877	287088	789	100.0	1.783e-164
UWI263P	contig_1	620991	622110	1119	renamed_GCF_000008685.2	chromosome	287089	285970	1119	100.0	9.957e-244
UWI263P	contig_1	634227	632844	1383	renamed_GCF_000008685.2	chromosome	273856	275236	1383	99.5	1.314e-302
UWI263P	contig_1	634433	635456	1023	renamed_GCF_000008685.2	chromosome	273647	272633	1023	98.5	8.403e-221
UWI263P	contig_1	635409	637602	2193	renamed_GCF_000008685.2	chromosome	272641	270487	2193	99.8	0.0
UWI263P	contig_1	637616	638417	801	renamed_GCF_000008685.2	chromosome	270473	269672	801	99.6	3.29e-168
UWI263P	contig_1	641024	640814	210	renamed_GCF_000008685.2	chromosome	267065	267275	210	100.0	4.647e-42
UWI263P	contig_1	641983	641038	945	renamed_GCF_000008685.2	chromosome	266106	267051	945	99.6	6.888e-210
UWI263P	contig_1	644102	641975	2127	renamed_GCF_000008685.2	chromosome	263987	266114	2127	99.2	0.0
UWI263P	contig_1	644377	646798	2421	renamed_GCF_000008685.2	chromosome	263712	261291	2421	100.0	0.0
UWI263P	contig_1	680260	681478	1218	renamed_GCF_000008685.2	chromosome	227827	226609	1218	99.7	3.023e-265
UWI263P	contig_1	681477	683262	1785	renamed_GCF_000008685.2	chromosome	226610	224825	1785	99.4	0.0
UWI263P	contig_1	683302	684124	822	renamed_GCF_000008685.2	chromosome	224785	223963	822	100.0	3.638e-179
UWI263P	contig_1	684909	684126	783	renamed_GCF_000008685.2	chromosome	223178	223961	783	99.2	8.433e-172
UWI263P	contig_1	686454	684909	1545	renamed_GCF_000008685.2	chromosome	221741	223178	1545	98.3	8.416e-309
UWI263P	contig_1	687359	686450	909	renamed_GCF_000008685.2	chromosome	220728	221637	909	99.3	4.638e-191
UWI263P	contig_1	688288	687448	840	renamed_GCF_000008685.2	chromosome	219799	220639	840	100.0	1.641e-182
UWI263P	contig_1	688453	689032	579	renamed_GCF_000008685.2	chromosome	219634	219055	579	100.0	8.388e-121
UWI263P	contig_1	689009	689663	654	renamed_GCF_000008685.2	chromosome	219078	218424	654	100.0	1.052e-147
UWI263P	contig_1	690807	689775	1032	renamed_GCF_000008685.2	chromosome	217277	218312	1032	99.1	2.355e-219
UWI263P	contig_1	718228	718789	561	renamed_GCF_000008685.2	chromosome	189859	189298	561	100.0	1.275e-121
UWI263P	contig_1	718811	719012	201	renamed_GCF_000008685.2	chromosome	189276	189075	201	100.0	9.889e-41
UWI263P	contig_1	719593	719854	261	renamed_GCF_000008685.2	chromosome	188494	188233	261	100.0	7.054e-54
UWI263P	contig_1	719850	720264	414	renamed_GCF_000008685.2	chromosome	188237	187823	414	99.2	2.918e-88
UWI263P	contig_1	720256	720910	654	renamed_GCF_000008685.2	chromosome	187831	187177	654	100.0	1.397e-144
UWI263P	contig_1	721139	720893	246	renamed_GCF_000008685.2	chromosome	186948	187194	246	100.0	9.168e-49
UWI263P	contig_1	721534	721141	393	renamed_GCF_000008685.2	chromosome	186553	186946	393	100.0	5.626e-86
UWI263P	contig_1	747998	746879	1119	renamed_GCF_000008685.2	chromosome	160089	161208	1119	99.7	1.16e-250
UWI263P	contig_1	748720	748045	675	renamed_GCF_000008685.2	chromosome	159367	160042	675	98.6	4.754e-143
UWI263P	contig_1	749460	748743	717	renamed_GCF_000008685.2	chromosome	158627	159344	717	97.0	3.592e-153
UWI263P	contig_1	750030	749613	417	renamed_GCF_000008685.2	chromosome	158075	158474	417	100.0	2.72e-81
UWI263P	contig_1	750461	750026	435	renamed_GCF_000008685.2	chromosome	157626	158061	435	99.3	1.372e-91
UWI263P	contig_1	751626	750489	1137	renamed_GCF_000008685.2	chromosome	156461	157598	1137	100.0	1.164e-253
UWI263P	contig_1	751687	754387	2700	renamed_GCF_000008685.2	chromosome	156400	153700	2700	99.8	0.0
UWI263P	contig_1	754401	755013	612	renamed_GCF_000008685.2	chromosome	153686	153074	612	100.0	4.712e-141
UWI263P	contig_1	755882	755075	807	renamed_GCF_000008685.2	chromosome	152205	153012	807	99.2	2.384e-181
UWI263P	contig_1	757114	755908	1206	renamed_GCF_000008685.2	chromosome	150973	152179	1206	99.7	1.095e-274
UWI263P	contig_1	770319	772212	1893	renamed_GCF_000008685.2	chromosome	137766	135873	1893	99.6	0.0
UWI263P	contig_1	774111	772221	1890	renamed_GCF_000008685.2	chromosome	133974	135864	1890	99.2	0.0
UWI263P	contig_1	774243	775614	1371	renamed_GCF_000008685.2	chromosome	133842	132471	1371	100.0	2.422e-302
UWI263P	contig_1	776788	775660	1128	renamed_GCF_000008685.2	chromosome	131297	132425	1128	99.4	1.93e-246
UWI263P	contig_1	776971	777916	945	renamed_GCF_000008685.2	chromosome	131114	130169	945	100.0	6.888e-210
UWI263P	contig_1	777953	780659	2706	renamed_GCF_000008685.2	chromosome	130132	127426	2706	99.8	0.0
UWI263P	contig_1	780672	781770	1098	renamed_GCF_000008685.2	chromosome	127413	126315	1098	100.0	1.369e-236
UWI263P	contig_1	781784	782552	768	renamed_GCF_000008685.2	chromosome	126301	125533	768	99.2	8.033e-170
UWI263P	contig_1	782538	783288	750	renamed_GCF_000008685.2	chromosome	125547	124797	750	100.0	1.281e-161
UWI263P	contig_1	783271	783937	666	renamed_GCF_000008685.2	chromosome	124814	124148	666	100.0	8.347e-144
UWI263P	contig_1	813477	813864	387	renamed_GCF_000008685.2	chromosome	94605	94218	387	100.0	1.031e-86
UWI263P	contig_1	814050	814650	600	renamed_GCF_000008685.2	chromosome	94032	93432	600	100.0	1.47e-126
UWI263P	contig_1	814659	815205	546	renamed_GCF_000008685.2	chromosome	93423	92877	546	97.7	1.472e-117
UWI263P	contig_1	816967	818272	1305	renamed_GCF_000008685.2	chromosome	91115	89810	1305	100.0	2.863e-289
UWI263P	contig_1	818274	818883	609	renamed_GCF_000008685.2	chromosome	89808	89199	609	100.0	1.275e-129
UWI263P	contig_1	820722	821157	435	renamed_GCF_000008685.2	chromosome	87360	86925	435	100.0	2.772e-92
UWI263P	contig_1	821228	822203	975	renamed_GCF_000008685.2	chromosome	86854	85879	975	100.0	4.354e-220
UWI263P	contig_1	822362	824042	1680	renamed_GCF_000008685.2	chromosome	85720	84040	1680	100.0	0.0
UWI263P	contig_1	855649	856831	1182	renamed_GCF_000008685.2	chromosome	52434	51252	1182	99.4	1.623e-257
UWI263P	contig_1	856832	857594	762	renamed_GCF_000008685.2	chromosome	51251	50489	762	98.8	6.336e-163
UWI263P	contig_1	857609	857972	363	renamed_GCF_000008685.2	chromosome	50474	50111	363	99.1	1.019e-74
UWI263P	contig_1	858742	858070	672	renamed_GCF_000008685.2	chromosome	49340	50012	672	100.0	9.591e-152
UWI263P	contig_1	858823	859480	657	renamed_GCF_000008685.2	chromosome	49259	48602	657	99.0	5.221e-139
UWI263P	contig_1	860178	859476	702	renamed_GCF_000008685.2	chromosome	47916	48606	702	99.1	1.109e-146
UWI263P	contig_1	860916	860241	675	renamed_GCF_000008685.2	chromosome	47166	47841	675	98.6	2.138e-143
UWI263P	contig_1	861703	862072	369	renamed_GCF_000008685.2	chromosome	46379	46010	369	100.0	3.085e-80
UWI263P	contig_1	862637	862091	546	renamed_GCF_000008685.2	chromosome	45445	45991	546	100.0	3.273e-117
UWI263P	contig_1	862728	865176	2448	renamed_GCF_000008685.2	chromosome	45354	42906	2448	99.7	0.0
UWI263P	contig_1	895778	895178	600	renamed_GCF_000008685.2	chromosome	12153	12753	600	98.9	1.006e-130
UWI263P	contig_1	896511	895770	741	renamed_GCF_000008685.2	chromosome	11420	12161	741	99.1	4.555e-163
UWI263P	contig_1	897351	896511	840	renamed_GCF_000008685.2	chromosome	10580	11420	840	100.0	7.775e-191
UWI263P	contig_1	897729	897354	375	renamed_GCF_000008685.2	chromosome	10202	10577	375	99.1	8.349e-79
UWI263P	contig_1	898730	897725	1005	renamed_GCF_000008685.2	chromosome	9201	10206	1005	99.4	1.861e-217
UWI263P	contig_1	899505	898734	771	renamed_GCF_000008685.2	chromosome	8426	9197	771	100.0	1.781e-161
UWI263P	contig_1	899616	900474	858	renamed_GCF_000008685.2	chromosome	8315	7457	858	100.0	6.472e-196
UWI263P	contig_1	900534	901623	1089	renamed_GCF_000008685.2	chromosome	7397	6308	1089	99.7	9.025e-240
UWI263P	contig_1	901625	902681	1056	renamed_GCF_000008685.2	chromosome	6306	5250	1056	99.1	8.56e-235
UWI263P	contig_1	904537	902743	1794	renamed_GCF_000008685.2	chromosome	3418	5188	1794	99.3	0.0
UWI263P	contig_5	9492	10818	1326	renamed_GCF_000008685.2	cp32-7	23134	24460	1326	99.0	3.52e-299
UWI263P	contig_5	12096	11301	795	renamed_GCF_000008685.2	cp32-4	25435	24640	795	99.6	2.87e-177
UWI263P	contig_5	13791	14331	540	renamed_GCF_000008685.2	cp32-8	28250	28790	540	97.7	1.96e-113
UWI263P	contig_5	14519	15086	567	renamed_GCF_000008685.2	cp32-4	28383	28950	567	90.4	1.796e-110
UWI263P	contig_5	18444	19008	564	renamed_GCF_000008685.2	cp32-4	2012	2576	564	98.9	1.105e-123
UWI263P	contig_5	19807	20383	576	renamed_GCF_000008685.2	lp56	6835	7411	576	99.4	1.005e-126
UWI263P	contig_5	20404	21364	960	renamed_GCF_000008685.2	cp32-6	3969	4929	960	99.6	6.008e-214
UWI263P	contig_5	21383	21839	456	renamed_GCF_000008685.2	cp32-6	4948	5404	456	99.3	5.32e-97
UWI263P	contig_7	9505	10282	777	renamed_GCF_000008685.2	lp56	29506	28729	777	97.6	2.057e-169
UWI263P	contig_7	12091	10765	1326	renamed_GCF_000008685.2	cp32-6	23240	24566	1326	98.8	1.904e-297
UWI263P	contig_7	13233	12564	669	renamed_GCF_000008685.2	cp32-6	22101	22770	669	100.0	2.138e-142
UWI263P	contig_7	13815	13236	579	renamed_GCF_000008685.2	cp32-6	21519	22098	579	100.0	5.735e-125
UWI263P	contig_7	14614	13864	750	renamed_GCF_000008685.2	cp32-6	20720	21470	750	99.5	4.35e-165
UWI263P	contig_7	15156	14589	567	renamed_GCF_000008685.2	cp32-6	20178	20745	567	99.4	1.456e-129
UWI263P	contig_7	16263	15165	1098	renamed_GCF_000008685.2	cp32-8	19090	20188	1098	96.1	1.918e-241
UWI263P	contig_7	16651	17599	948	renamed_GCF_000008685.2	cp32-6	18680	17732	948	98.7	4.537e-215
UWI263P	contig_7	19417	19063	354	renamed_GCF_000008685.2	cp32-7	16093	16447	354	99.1	3.249e-77
UWI263P	contig_7	19745	19409	336	renamed_GCF_000008685.2	lp56	19256	19592	336	100.0	5.348e-69
UWI263P	contig_7	20082	19734	348	renamed_GCF_000008685.2	cp32-1	15421	15769	348	99.1	4.373e-73
UWI263P	contig_7	20289	20085	204	renamed_GCF_000008685.2	cp32-1	15214	15418	204	100.0	2.578e-39
UWI263P	contig_8	28508	27833	675	renamed_GCF_000008685.2	cp32-4	26852	27527	675	87.6	2.351e-125
UWI263P	contig_8	28939	29716	777	renamed_GCF_000008685.2	cp32-3	26276	25499	777	99.6	6.988e-173
UWI263P	contig_9	1390	1594	204	renamed_GCF_000008685.2	cp32-7	15221	15425	204	100.0	2.578e-39
UWI263P	contig_9	2262	2616	354	renamed_GCF_000008685.2	lp56	19584	19938	354	100.0	1.459e-77
UWI263P	contig_9	2720	3188	468	renamed_GCF_000008685.2	cp32-4	16496	16997	468	91.5	4.26e-93
UWI263P	contig_9	5325	6426	1101	renamed_GCF_000008685.2	cp32-9	19163	20264	1101	98.3	2.566e-247
UWI263P	contig_9	6436	7003	567	renamed_GCF_000008685.2	cp32-9	20274	20841	567	98.9	1.602e-128
UWI263P	contig_9	6978	7734	756	renamed_GCF_000008685.2	cp32-9	20816	21572	756	99.6	4.781e-165
UWI263P	contig_9	7775	8336	561	renamed_GCF_000008685.2	cp32-9	21613	22174	561	100.0	6.308e-121
UWI263P	contig_9	19087	19642	555	renamed_GCF_000008685.2	cp32-4	11863	12418	555	99.4	1.698e-117
UWI263P	contig_9	19671	20004	333	renamed_GCF_000008685.2	cp32-8	12494	12827	333	100.0	8.424e-72
UWI263P	contig_10	651	1449	798	renamed_GCF_000008685.2	cp9	6973	7771	798	99.2	6.687e-177
UWI263P	contig_10	3241	4369	1128	renamed_GCF_000008685.2	cp9	162	1272	1128	93.7	1.99e-237
UWI263P	contig_10	4981	5542	561	renamed_GCF_000008685.2	cp9	1891	2452	561	97.3	3.432e-119
UWI263P	contig_10	5896	6805	909	renamed_GCF_000008685.2	cp9	2803	3712	909	99.6	3.914e-210
UWI263P	contig_10	7470	6945	525	renamed_GCF_000008685.2	cp9	4377	3852	525	94.8	1.357e-106
UWI263P	contig_12	10182	9561	621	renamed_GCF_000008685.2	lp25	10187	9566	621	99.0	3.249e-138
UWI263P	contig_12	10701	10194	507	renamed_GCF_000008685.2	lp25	10694	10199	507	96.3	1.122e-105
UWI263P	contig_12	11821	11239	582	renamed_GCF_000008685.2	lp25	12079	11497	582	98.9	1.106e-126
UWI263P	contig_12	12596	11837	759	renamed_GCF_000008685.2	lp25	12854	12095	759	98.4	5.504e-164
UWI263P	contig_12	13135	12571	564	renamed_GCF_000008685.2	lp25	13393	12829	564	94.6	2.975e-121
UWI263P	contig_12	14230	13144	1086	renamed_GCF_000008685.2	lp25	14530	13402	1086	93.0	1.069e-228
UWI263P	contig_12	15302	14798	504	renamed_GCF_000008685.2	lp25	15545	15041	504	93.4	3.607e-109
UWI263P	contig_13	13885	14953	1068	renamed_GCF_000008685.2	lp28-1	15451	14350	1068	96.0	6.722e-231
UWI263P	contig_13	15008	15569	561	renamed_GCF_000008685.2	lp28-1	14329	13768	561	98.9	4.739e-124
UWI263P	contig_13	15544	16309	765	renamed_GCF_000008685.2	lp28-1	13793	13028	765	99.6	1.871e-168
UWI263P	contig_13	16345	16897	552	renamed_GCF_000008685.2	lp28-1	12992	12440	552	97.8	3.273e-118
UWI263P	contig_13	23757	24942	1185	renamed_GCF_000008685.2	chromosome	908406	909591	1185	100.0	8.142e-266
UWI263P	contig_14	17417	17984	567	renamed_GCF_000008685.2	lp28-3	17407	17974	567	100.0	1.938e-126
UWI263P	contig_14	17956	18712	756	renamed_GCF_000008685.2	lp28-3	17946	18702	756	100.0	8.81e-167
UWI263P	contig_14	18807	19437	630	renamed_GCF_000008685.2	lp28-3	18797	19427	630	99.5	4.977e-135
UWI263P	contig_14	21480	22230	750	renamed_GCF_000008685.2	lp28-3	21469	22219	750	99.5	6.33e-161
UWI263P	contig_14	22688	22964	276	renamed_GCF_000008685.2	lp28-3	22677	22953	276	100.0	6.026e-58
UWI263P	contig_14	26353	25441	912	renamed_GCF_000008685.2	lp28-3	26371	25432	912	99.0	1.509e-195
UWI263P	contig_14	27454	26986	468	renamed_GCF_000008685.2	lp28-3	27445	26977	468	99.3	1.339e-105
UWI263P	contig_14	27777	28335	558	renamed_GCF_000008685.2	lp28-4	26359	26914	558	95.1	2.369e-114
UWI263P	contig_15	221	1115	894	renamed_GCF_000008685.2	lp36	187	1081	894	98.6	8.951e-190
UWI263P	contig_15	15432	14679	753	renamed_GCF_000008685.2	lp28-4	12453	13206	753	100.0	4.561e-165
UWI263P	contig_15	15962	15407	555	renamed_GCF_000008685.2	lp28-4	11923	12478	555	100.0	3.559e-126
UWI263P	contig_15	17065	15958	1107	renamed_GCF_000008685.2	lp28-4	10814	11927	1107	98.9	2.343e-249
UWI263P	contig_15	20834	19343	1491	renamed_GCF_000008685.2	lp28-4	7182	8538	1491	90.9	2.258e-288
UWI263P	contig_15	22927	22708	219	renamed_GCF_000008685.2	lp28-4	5127	5346	219	100.0	1.443e-47
UWI263P	contig_15	25520	24704	816	renamed_GCF_000008685.2	lp28-4	2535	3351	816	100.0	8.08e-178
UWI263P	contig_17	6134	5960	174	renamed_GCF_000008685.2	lp36	22293	22467	174	92.9	1.178e-34
UWI263P	contig_17	6517	6295	222	renamed_GCF_000008685.2	lp36	21911	22133	222	100.0	1.866e-45
UWI263P	contig_17	8049	6975	1074	renamed_GCF_000008685.2	lp36	20388	21453	1074	98.5	3.995e-229
UWI263P	contig_17	9949	9337	612	renamed_GCF_000008685.2	lp36	16274	16886	612	100.0	9.153e-134
UWI263P	contig_17	10462	11389	927	renamed_GCF_000008685.2	lp36	15760	14833	927	99.6	1.39e-207
UWI263P	contig_17	11381	11921	540	renamed_GCF_000008685.2	lp36	14841	14301	540	100.0	2.234e-120
UWI263P	contig_17	11896	12646	750	renamed_GCF_000008685.2	lp36	14326	13576	750	100.0	1.062e-163
UWI263P	contig_17	13621	12985	636	renamed_GCF_000008685.2	lp36	12601	13237	636	100.0	3.41e-140
UWI263P	contig_17	15922	14275	1647	renamed_GCF_000008685.2	lp36	10300	11947	1647	99.8	0.0
UWI263P	contig_18	16073	15035	1038	renamed_GCF_000008685.2	lp38	22042	23008	1038	88.7	1.356e-200
UWI263P	contig_18	16822	16096	726	renamed_GCF_000008685.2	lp38	21222	21948	726	92.5	2.708e-149
UWI263P	contig_18	18044	16814	1230	renamed_GCF_000008685.2	lp38	20000	21230	1230	94.8	1.685e-256
UWI263P	contig_18	18732	18036	696	renamed_GCF_000008685.2	lp38	19312	20008	696	94.3	1.108e-145
UWI263P	contig_18	19825	18790	1035	renamed_GCF_000008685.2	lp38	18213	19254	1035	87.8	3.062e-208
UWI263P	contig_18	20644	19867	777	renamed_GCF_000008685.2	lp38	17387	18170	777	83.3	2.326e-142
UWI263P	contig_18	21506	20696	810	renamed_GCF_000008685.2	lp38	16519	17329	810	86.2	2.571e-155
UWI263P	contig_18	23345	24335	990	renamed_GCF_000008685.2	lp38	13440	12444	990	82.2	3.09e-183
UWI263P	contig_18	24327	24924	597	renamed_GCF_000008685.2	lp38	12452	11861	597	88.7	8.047e-116
UWI263P	contig_18	24896	25634	738	renamed_GCF_000008685.2	lp38	11889	11151	738	91.8	4.993e-153
UWI263P	contig_19	5501	6257	756	renamed_GCF_000008685.2	lp54	47228	46472	756	98.4	1.282e-162
UWI263P	contig_19	7910	9143	1233	renamed_GCF_000008685.2	lp54	45947	44711	1233	97.8	1.341e-259
UWI263P	contig_19	9321	10170	849	renamed_GCF_000008685.2	lp54	44533	43684	849	99.6	1.568e-184
UWI263P	contig_19	10334	11243	909	renamed_GCF_000008685.2	lp54	43532	42623	909	99.6	5.38e-198
UWI263P	contig_19	11600	11393	207	renamed_GCF_000008685.2	lp54	42266	42473	207	100.0	9.856e-42
UWI263P	contig_19	11847	12471	624	renamed_GCF_000008685.2	lp54	42019	41395	624	100.0	3.1e-139
UWI263P	contig_19	12821	13655	834	renamed_GCF_000008685.2	lp54	41045	40211	834	99.2	8.097e-181
UWI263P	contig_19	13754	13994	240	renamed_GCF_000008685.2	lp54	40112	39872	240	100.0	3.722e-49
UWI263P	contig_19	14460	15705	1245	renamed_GCF_000008685.2	lp54	39405	38160	1245	99.5	5.369e-272
UWI263P	contig_19	30082	29440	642	renamed_GCF_000008685.2	lp54	23776	24415	642	99.0	1.217e-135
UWI263P	contig_19	30585	32175	1590	renamed_GCF_000008685.2	lp54	23273	21683	1590	99.4	0.0
UWI263P	contig_19	32772	32232	540	renamed_GCF_000008685.2	lp54	21086	21626	540	98.8	4.36e-113
UWI263P	contig_19	33141	32946	195	renamed_GCF_000008685.2	lp54	20717	20912	195	100.0	2.214e-39
UWI263P	contig_19	35082	33729	1353	renamed_GCF_000008685.2	lp54	18724	20077	1353	100.0	1.524e-304
UWI263P	contig_19	35679	35085	594	renamed_GCF_000008685.2	lp54	18127	18721	594	99.4	7.271e-125
UWI263P	contig_19	36547	37111	564	renamed_GCF_000008685.2	lp54	17259	16695	564	99.4	5.267e-115
UWI263P	contig_19	37230	37797	567	renamed_GCF_000008685.2	lp54	16576	16000	567	91.8	1.571e-103
UWI263P	contig_19	38459	38027	432	renamed_GCF_000008685.2	lp54	15369	15801	432	99.3	3.987e-96
UWI263P	contig_19	47380	46753	627	renamed_GCF_000008685.2	lp54	6520	7147	627	99.0	1.16e-133
UWI263P	contig_19	48255	47382	873	renamed_GCF_000008685.2	lp54	5645	6518	873	99.3	2.643e-191
UWI263P	contig_19	48587	48251	336	renamed_GCF_000008685.2	lp54	5313	5649	336	100.0	1.784e-72
UWI263P	contig_19	48760	49234	474	renamed_GCF_000008685.2	lp54	5140	4666	474	100.0	5.31e-100
UWI263P	contig_19	49644	50898	1254	renamed_GCF_000008685.2	lp54	4256	3002	1254	100.0	3.245e-279
UWI263P	contig_19	51007	51856	849	renamed_GCF_000008685.2	lp54	2893	2044	849	99.2	1.301e-186
UWI263P	contig_19	52441	51931	510	renamed_GCF_000008685.2	lp54	1460	1970	510	100.0	8.829e-109
UWI263P	contig_19	53249	52763	486	renamed_GCF_000008685.2	lp28-3	28197	27624	486	48.4	2.052e-45
UWI263P	contig_1	40046	40418	372	renamed_GCF_000008685.2	chromosome	868114	867742	372	99.1	1.771e-78
UWI263P	contig_1	41667	41466	201	renamed_GCF_000008685.2	chromosome	866493	866694	201	100.0	2.206e-40
UWI263P	contig_1	76403	77177	774	renamed_GCF_000008685.2	chromosome	831563	830954	774	99.5	5.119e-133
UWI263P	contig_1	77190	77814	624	renamed_GCF_000008685.2	chromosome	830941	830317	624	98.5	1.394e-139
UWI263P	contig_1	78914	77810	1104	renamed_GCF_000008685.2	chromosome	829217	830321	1104	99.1	5.448e-248
UWI263P	contig_1	80501	79019	1482	renamed_GCF_000008685.2	chromosome	827630	829112	1482	98.9	0.0
UWI263P	contig_1	82431	80511	1920	renamed_GCF_000008685.2	chromosome	825700	827620	1920	100.0	0.0
UWI263P	contig_1	83750	82427	1323	renamed_GCF_000008685.2	chromosome	824381	825704	1323	100.0	8.966e-297
UWI263P	contig_1	84869	84320	549	renamed_GCF_000008685.2	chromosome	823262	823811	549	98.9	4.154e-115
UWI263P	contig_1	107693	107096	597	renamed_GCF_000008685.2	chromosome	800475	801072	597	99.4	1.402e-126
UWI263P	contig_1	109152	110112	960	renamed_GCF_000008685.2	chromosome	799016	798056	960	99.6	2.967e-213
UWI263P	contig_1	113313	114327	1014	renamed_GCF_000008685.2	chromosome	794855	793841	1014	98.8	1.021e-225
UWI263P	contig_1	115916	116375	459	renamed_GCF_000008685.2	chromosome	792252	791793	459	99.3	2.509e-97
UWI263P	contig_1	117361	118222	861	renamed_GCF_000008685.2	chromosome	790807	789946	861	100.0	1.57e-186
UWI263P	contig_1	121307	119204	2103	renamed_GCF_000008685.2	chromosome	786859	788962	2103	99.4	0.0
UWI263P	contig_1	124777	123145	1632	renamed_GCF_000008685.2	chromosome	783389	785021	1632	99.8	0.0
UWI263P	contig_1	125337	126015	678	renamed_GCF_000008685.2	chromosome	782829	782151	678	97.7	6.295e-149
UWI263P	contig_1	129409	126781	2628	renamed_GCF_000008685.2	chromosome	778757	781385	2628	98.8	0.0
UWI263P	contig_1	131382	130593	789	renamed_GCF_000008685.2	chromosome	776784	777573	789	98.4	5.027e-170
UWI263P	contig_1	133434	132648	786	renamed_GCF_000008685.2	chromosome	774676	775462	786	100.0	1.17e-168
UWI263P	contig_1	162809	161777	1032	renamed_GCF_000008685.2	chromosome	745301	746333	1032	98.8	6.089e-226
UWI263P	contig_1	165367	163594	1773	renamed_GCF_000008685.2	chromosome	742743	744516	1773	99.3	0.0
UWI263P	contig_1	167423	166685	738	renamed_GCF_000008685.2	chromosome	740687	741425	738	100.0	4.772e-162
UWI263P	contig_1	167871	167688	183	renamed_GCF_000008685.2	chromosome	740239	740422	183	100.0	1.805e-39
UWI263P	contig_1	177010	177478	468	renamed_GCF_000008685.2	chromosome	731099	730631	468	98.0	1.073e-99
UWI263P	contig_1	179444	178490	954	renamed_GCF_000008685.2	chromosome	728665	729619	954	98.7	7.929e-210
UWI263P	contig_1	181625	180356	1269	renamed_GCF_000008685.2	chromosome	726457	727753	1269	96.9	1.731e-271
UWI263P	contig_1	183886	182662	1224	renamed_GCF_000008685.2	chromosome	724223	725447	1224	99.5	3.533e-273
UWI263P	contig_1	186991	185089	1902	renamed_GCF_000008685.2	chromosome	721118	723020	1902	99.6	0.0
UWI263P	contig_1	201434	198839	2595	renamed_GCF_000008685.2	chromosome	706672	709267	2595	99.5	0.0
UWI263P	contig_1	203156	202604	552	renamed_GCF_000008685.2	chromosome	704948	705500	552	95.6	1.781e-116
UWI263P	contig_1	205096	204136	960	renamed_GCF_000008685.2	chromosome	703008	703968	960	100.0	6.008e-214
UWI263P	contig_1	206280	205830	450	renamed_GCF_000008685.2	chromosome	701824	702274	450	99.3	2.172e-97
UWI263P	contig_1	222115	223099	984	renamed_GCF_000008685.2	chromosome	685980	684996	984	99.3	1.874e-222
UWI263P	contig_1	225418	224719	699	renamed_GCF_000008685.2	chromosome	682678	683377	699	100.0	1.337e-152
UWI263P	contig_1	226490	227534	1044	renamed_GCF_000008685.2	chromosome	681606	680562	1044	99.7	1.897e-232
UWI263P	contig_1	228346	229138	792	renamed_GCF_000008685.2	chromosome	679750	678958	792	99.6	3.445e-166
UWI263P	contig_1	249194	248468	726	renamed_GCF_000008685.2	chromosome	658897	659623	726	99.1	3.767e-154
UWI263P	contig_1	253283	251189	2094	renamed_GCF_000008685.2	chromosome	654862	656902	2094	98.9	0.0
UWI263P	contig_1	254301	257679	3378	renamed_GCF_000008685.2	chromosome	653790	650412	3378	99.5	0.0
UWI263P	contig_1	259539	258984	555	renamed_GCF_000008685.2	chromosome	648552	649107	555	98.9	6.939e-119
UWI263P	contig_1	262373	261410	963	renamed_GCF_000008685.2	chromosome	645718	646681	963	100.0	1.162e-215
UWI263P	contig_1	289531	291679	2148	renamed_GCF_000008685.2	chromosome	618559	616411	2148	99.8	0.0
UWI263P	contig_1	291700	292327	627	renamed_GCF_000008685.2	chromosome	616390	615763	627	99.0	1.402e-131
UWI263P	contig_1	292319	294077	1758	renamed_GCF_000008685.2	chromosome	615771	614013	1758	99.1	0.0
UWI263P	contig_1	296043	294105	1938	renamed_GCF_000008685.2	chromosome	612047	613985	1938	99.8	0.0
UWI263P	contig_1	322994	321929	1065	renamed_GCF_000008685.2	chromosome	585079	586156	1065	98.0	9.851e-235
UWI263P	contig_1	323205	323895	690	renamed_GCF_000008685.2	chromosome	584880	584190	690	99.1	4.749e-154
UWI263P	contig_1	324628	324253	375	renamed_GCF_000008685.2	chromosome	583457	583832	375	99.1	1.859e-78
UWI263P	contig_1	326441	324668	1773	renamed_GCF_000008685.2	chromosome	581644	583417	1773	99.4	0.0
UWI263P	contig_1	327600	326442	1158	renamed_GCF_000008685.2	chromosome	580485	581643	1158	100.0	7.971e-253
UWI263P	contig_1	338807	338546	261	renamed_GCF_000008685.2	chromosome	569277	569538	261	100.0	9.575e-51
UWI263P	contig_1	339814	338944	870	renamed_GCF_000008685.2	chromosome	568269	569139	870	99.6	1.907e-194
UWI263P	contig_1	340274	339800	474	renamed_GCF_000008685.2	chromosome	567809	568277	474	100.0	2.168e-101
UWI263P	contig_1	342114	340260	1854	renamed_GCF_000008685.2	chromosome	565954	567823	1854	99.6	0.0
UWI263P	contig_1	368803	369751	948	renamed_GCF_000008685.2	chromosome	539275	538327	948	99.6	1.106e-213
UWI263P	contig_1	370559	369770	789	renamed_GCF_000008685.2	chromosome	537543	538308	789	98.8	3.287e-166
UWI263P	contig_1	391586	385085	6501	renamed_GCF_000008685.2	chromosome	516492	522993	6501	99.2	0.0
UWI263P	contig_1	393548	392288	1260	renamed_GCF_000008685.2	chromosome	514523	515783	1260	98.3	1.758e-278
UWI263P	contig_1	394846	393544	1302	renamed_GCF_000008685.2	chromosome	513225	514527	1302	99.5	1.776e-285
UWI263P	contig_1	394932	395679	747	renamed_GCF_000008685.2	chromosome	513139	512392	747	99.5	3.599e-158
UWI263P	contig_1	397236	396447	789	renamed_GCF_000008685.2	chromosome	510835	511624	789	100.0	3.149e-175
UWI263P	contig_1	3263	4235	972	renamed_GCF_000008685.2	chromosome	904900	903928	972	99.6	1.152e-208
UWI263P	contig_1	6330	4905	1425	renamed_GCF_000008685.2	chromosome	901833	903258	1425	99.7	2.69e-310
UWI263P	contig_1	7365	6381	984	renamed_GCF_000008685.2	chromosome	900798	901782	984	100.0	5.014e-220
UWI263P	contig_1	8665	7432	1233	renamed_GCF_000008685.2	chromosome	899498	900731	1233	100.0	1.522e-275
UWI263P	contig_1	8843	10460	1617	renamed_GCF_000008685.2	chromosome	899320	897703	1617	99.4	0.0
UWI263P	contig_1	10468	11068	600	renamed_GCF_000008685.2	chromosome	897695	897095	600	99.4	6.881e-135
UWI263P	contig_1	11036	11582	546	renamed_GCF_000008685.2	chromosome	897127	896578	546	97.7	8.009e-116
UWI263P	contig_1	33028	35575	2547	renamed_GCF_000008685.2	chromosome	875132	872585	2547	100.0	0.0
UWI263P	contig_1	35577	38049	2472	renamed_GCF_000008685.2	chromosome	872583	870111	2472	100.0	0.0
UWI263P	contig_1	38137	38653	516	renamed_GCF_000008685.2	chromosome	870023	869507	516	100.0	1.621e-111
UWI263P	contig_1	38645	39428	783	renamed_GCF_000008685.2	chromosome	869380	868732	783	99.5	1.931e-145
UWI263P	contig_1	39966	39420	546	renamed_GCF_000008685.2	chromosome	868194	868740	546	100.0	1.846e-123
UWI263P	contig_1	41480	40559	921	renamed_GCF_000008685.2	chromosome	866680	867601	921	99.3	3.387e-205
UWI263P	contig_1	42245	41702	543	renamed_GCF_000008685.2	chromosome	865915	866458	543	98.8	6.309e-118
UWI263P	contig_1	43108	42241	867	renamed_GCF_000008685.2	chromosome	865052	865919	867	99.6	3.181e-188
UWI263P	contig_1	44525	43118	1407	renamed_GCF_000008685.2	chromosome	863635	865042	1407	99.5	3.133e-314
UWI263P	contig_1	45462	44514	948	renamed_GCF_000008685.2	chromosome	862698	863646	948	100.0	4.292e-207
UWI263P	contig_1	84316	83749	567	renamed_GCF_000008685.2	chromosome	823815	824382	567	100.0	1.275e-122
UWI263P	contig_1	86947	85762	1185	renamed_GCF_000008685.2	chromosome	821184	822369	1185	99.7	1.177e-261
UWI263P	contig_1	88590	87603	987	renamed_GCF_000008685.2	chromosome	819541	820528	987	100.0	5.255e-220
UWI263P	contig_1	89527	89215	312	renamed_GCF_000008685.2	chromosome	818604	818916	312	99.0	2.418e-65
UWI263P	contig_1	90736	90175	561	renamed_GCF_000008685.2	chromosome	817395	817956	561	99.4	1.601e-127
UWI263P	contig_1	100201	101248	1047	renamed_GCF_000008685.2	chromosome	807966	806919	1047	99.7	2.624e-229
UWI263P	contig_1	107158	106390	768	renamed_GCF_000008685.2	chromosome	801118	801778	768	98.1	1.322e-138
UWI263P	contig_1	107893	108961	1068	renamed_GCF_000008685.2	chromosome	800275	799207	1068	99.4	4.094e-245
UWI263P	contig_1	110120	111050	930	renamed_GCF_000008685.2	chromosome	798048	797118	930	100.0	3.063e-199
UWI263P	contig_1	115818	114543	1275	renamed_GCF_000008685.2	chromosome	792350	793625	1275	98.1	4.931e-278
UWI263P	contig_1	116381	117362	981	renamed_GCF_000008685.2	chromosome	791787	790806	981	99.6	2.843e-217
UWI263P	contig_1	118848	118230	618	renamed_GCF_000008685.2	chromosome	789302	789938	618	99.5	3.406e-137
UWI263P	contig_1	123110	121412	1698	renamed_GCF_000008685.2	chromosome	785056	786754	1698	99.6	0.0
UWI263P	contig_1	124918	125191	273	renamed_GCF_000008685.2	chromosome	783248	782975	273	100.0	3.858e-54
UWI263P	contig_1	130402	129412	990	renamed_GCF_000008685.2	chromosome	777764	778754	990	99.6	1.559e-225
UWI263P	contig_1	189280	187021	2259	renamed_GCF_000008685.2	chromosome	718826	721088	2259	99.7	0.0
UWI263P	contig_1	202527	201501	1026	renamed_GCF_000008685.2	chromosome	705579	706605	1026	100.0	2.737e-225
UWI263P	contig_1	204174	203145	1029	renamed_GCF_000008685.2	chromosome	703960	704959	1029	98.7	4.152e-221
UWI263P	contig_1	205138	205822	684	renamed_GCF_000008685.2	chromosome	702951	702282	684	99.5	1.009e-144
UWI263P	contig_1	206710	206299	411	renamed_GCF_000008685.2	chromosome	701394	701805	411	98.5	1.377e-87
UWI263P	contig_1	207076	206719	357	renamed_GCF_000008685.2	chromosome	701028	701385	357	99.1	2.301e-81
UWI263P	contig_1	207180	208053	873	renamed_GCF_000008685.2	chromosome	700924	700051	873	99.3	1.433e-189
UWI263P	contig_1	219606	217968	1638	renamed_GCF_000008685.2	chromosome	688489	690127	1638	100.0	0.0
UWI263P	contig_1	221588	222119	531	renamed_GCF_000008685.2	chromosome	686507	685976	531	100.0	1.053e-118
UWI263P	contig_1	224674	223129	1545	renamed_GCF_000008685.2	chromosome	683422	684967	1545	99.8	0.0
UWI263P	contig_1	409016	408737	279	renamed_GCF_000008685.2	chromosome	499055	499334	279	100.0	1.411e-57
UWI263P	contig_1	409859	409025	834	renamed_GCF_000008685.2	chromosome	498212	499046	834	100.0	1.895e-188
UWI263P	contig_1	410177	409880	297	renamed_GCF_000008685.2	chromosome	497894	498191	297	100.0	5.69e-62
UWI263P	contig_1	410827	410197	630	renamed_GCF_000008685.2	chromosome	497244	497874	630	100.0	4.528e-136
UWI263P	contig_1	411457	410836	621	renamed_GCF_000008685.2	chromosome	496614	497235	621	100.0	8.732e-136
UWI263P	contig_1	411804	411492	312	renamed_GCF_000008685.2	chromosome	496267	496579	312	100.0	2.953e-63
UWI263P	contig_1	413039	411854	1185	renamed_GCF_000008685.2	chromosome	495032	496217	1185	100.0	4.832e-263
UWI263P	contig_1	413533	413923	390	renamed_GCF_000008685.2	chromosome	494539	494149	390	99.2	2.146e-79
UWI263P	contig_1	415485	414120	1365	renamed_GCF_000008685.2	chromosome	492587	493952	1365	100.0	1.721e-296
UWI263P	contig_1	417429	416145	1284	renamed_GCF_000008685.2	chromosome	490643	491927	1284	100.0	9.564e-281
UWI263P	contig_1	436313	436847	534	renamed_GCF_000008685.2	chromosome	471756	471222	534	100.0	8.816e-113
UWI263P	contig_1	436849	438109	1260	renamed_GCF_000008685.2	chromosome	471220	469960	1260	100.0	2.539e-274
UWI263P	contig_1	438098	438392	294	renamed_GCF_000008685.2	chromosome	469971	469677	294	100.0	2.2e-63
UWI263P	contig_1	438404	438680	276	renamed_GCF_000008685.2	chromosome	469665	469389	276	97.8	9.032e-54
UWI263P	contig_1	438682	440788	2106	renamed_GCF_000008685.2	chromosome	469387	467281	2106	99.7	0.0
UWI263P	contig_1	440791	442552	1761	renamed_GCF_000008685.2	chromosome	467278	465517	1761	99.4	0.0
UWI263P	contig_1	444016	442936	1080	renamed_GCF_000008685.2	chromosome	464052	465132	1080	99.7	2.027e-246
UWI263P	contig_1	445250	444182	1068	renamed_GCF_000008685.2	chromosome	462818	463886	1068	99.7	9.979e-244
UWI263P	contig_1	446024	445295	729	renamed_GCF_000008685.2	chromosome	462044	462773	729	98.7	1.34e-157
UWI263P	contig_1	490347	489735	612	renamed_GCF_000008685.2	chromosome	417723	418335	612	99.0	7.572e-136
UWI263P	contig_1	490969	490357	612	renamed_GCF_000008685.2	chromosome	417101	417713	612	100.0	4.975e-132
UWI263P	contig_1	491382	490965	417	renamed_GCF_000008685.2	chromosome	416688	417105	417	100.0	1.248e-89
UWI263P	contig_1	491547	492225	678	renamed_GCF_000008685.2	chromosome	416478	415845	678	99.5	1.008e-143
UWI263P	contig_1	492277	493744	1467	renamed_GCF_000008685.2	chromosome	415793	414326	1467	99.5	0.0
UWI263P	contig_1	494958	493755	1203	renamed_GCF_000008685.2	chromosome	413112	414315	1203	99.5	7.009e-262
UWI263P	contig_1	495070	496615	1545	renamed_GCF_000008685.2	chromosome	413006	411455	1545	99.2	0.0
UWI263P	contig_1	497284	496624	660	renamed_GCF_000008685.2	chromosome	410786	411446	660	98.1	2.462e-139
UWI263P	contig_1	497623	498655	1032	renamed_GCF_000008685.2	chromosome	410447	409415	1032	97.3	8.518e-231
UWI263P	contig_1	498668	499517	849	renamed_GCF_000008685.2	chromosome	409402	408553	849	99.6	2.186e-189
UWI263P	contig_1	553446	554643	1197	renamed_GCF_000008685.2	chromosome	354636	353439	1197	100.0	5.312e-264
UWI263P	contig_1	554642	556742	2100	renamed_GCF_000008685.2	chromosome	353437	351340	2100	98.1	0.0
UWI263P	contig_1	556751	557027	276	renamed_GCF_000008685.2	chromosome	351331	351055	276	97.8	4.053e-54
UWI263P	contig_1	557034	558483	1449	renamed_GCF_000008685.2	chromosome	351045	349599	1449	99.7	6.4e-322
UWI263P	contig_1	558472	559930	1458	renamed_GCF_000008685.2	chromosome	349610	348152	1458	99.5	5e-324
UWI263P	contig_1	559922	560732	810	renamed_GCF_000008685.2	chromosome	348160	347350	810	99.6	4.196e-184
UWI263P	contig_1	560781	561222	441	renamed_GCF_000008685.2	chromosome	347301	346860	441	100.0	1.706e-98
UWI263P	contig_1	561241	561652	411	renamed_GCF_000008685.2	chromosome	346841	346430	411	100.0	6.821e-87
UWI263P	contig_1	563019	561717	1302	renamed_GCF_000008685.2	chromosome	345062	346364	1302	99.5	6.653e-288
UWI263P	contig_1	588444	588975	531	renamed_GCF_000008685.2	chromosome	319636	319105	531	100.0	1.699e-113
UWI263P	contig_1	588964	589804	840	renamed_GCF_000008685.2	chromosome	319116	318276	840	99.6	1.977e-180
UWI263P	contig_1	590075	590834	759	renamed_GCF_000008685.2	chromosome	318005	317246	759	100.0	1.223e-163
UWI263P	contig_1	590864	591941	1077	renamed_GCF_000008685.2	chromosome	317216	316139	1077	99.7	9.003e-238
UWI263P	contig_1	591937	592774	837	renamed_GCF_000008685.2	chromosome	316143	315306	837	99.6	1.426e-183
UWI263P	contig_1	592766	593657	891	renamed_GCF_000008685.2	chromosome	315314	314423	891	99.6	4.455e-197
UWI263P	contig_1	593653	593935	282	renamed_GCF_000008685.2	chromosome	314427	314145	282	100.0	2.699e-59
UWI263P	contig_1	593957	595349	1392	renamed_GCF_000008685.2	chromosome	314123	312728	1392	100.0	1.047e-306
UWI263P	contig_1	595366	596422	1056	renamed_GCF_000008685.2	chromosome	312715	311659	1056	100.0	1.239e-230
UWI263P	contig_1	596428	597523	1095	renamed_GCF_000008685.2	chromosome	311617	310558	1095	99.4	1.229e-228
UWI263P	contig_1	605592	607302	1710	renamed_GCF_000008685.2	chromosome	302489	300779	1710	100.0	0.0
UWI263P	contig_1	607317	608352	1035	renamed_GCF_000008685.2	chromosome	300764	299729	1035	100.0	3.255e-216
UWI263P	contig_1	608366	609287	921	renamed_GCF_000008685.2	chromosome	299715	298794	921	99.6	2.293e-192
UWI263P	contig_1	609305	610616	1311	renamed_GCF_000008685.2	chromosome	298776	297465	1311	99.5	1.7e-287
UWI263P	contig_1	610612	611044	432	renamed_GCF_000008685.2	chromosome	297469	297037	432	99.3	2.176e-94
UWI263P	contig_1	611036	611654	618	renamed_GCF_000008685.2	chromosome	297045	296427	618	99.5	5.47e-132
UWI263P	contig_1	611661	612840	1179	renamed_GCF_000008685.2	chromosome	296420	295241	1179	99.4	2.611e-260
UWI263P	contig_1	612853	613297	444	renamed_GCF_000008685.2	chromosome	295228	294784	444	100.0	1.185e-94
UWI263P	contig_1	613301	614630	1329	renamed_GCF_000008685.2	chromosome	294780	293451	1329	99.7	1.183e-294
UWI263P	contig_1	614651	614876	225	renamed_GCF_000008685.2	chromosome	293429	293204	225	100.0	8.8e-46
UWI263P	contig_1	651627	649104	2523	renamed_GCF_000008685.2	chromosome	256462	258985	2523	98.3	0.0
UWI263P	contig_1	652444	651829	615	renamed_GCF_000008685.2	chromosome	255645	256260	615	99.5	1.275e-130
UWI263P	contig_1	653145	652440	705	renamed_GCF_000008685.2	chromosome	254944	255649	705	99.5	3.589e-151
UWI263P	contig_1	654931	653158	1773	renamed_GCF_000008685.2	chromosome	253158	254931	1773	98.9	0.0
UWI263P	contig_1	655656	655050	606	renamed_GCF_000008685.2	chromosome	252433	253039	606	100.0	4.115e-133
UWI263P	contig_1	655852	656878	1026	renamed_GCF_000008685.2	chromosome	252237	251211	1026	99.4	1.351e-224
UWI263P	contig_1	656878	657433	555	renamed_GCF_000008685.2	chromosome	251211	250656	555	99.4	1.543e-118
UWI263P	contig_1	657419	657914	495	renamed_GCF_000008685.2	chromosome	250670	250175	495	100.0	5.051e-104
UWI263P	contig_1	659563	658000	1563	renamed_GCF_000008685.2	chromosome	248505	250089	1563	99.8	0.0
UWI263P	contig_1	661493	659987	1506	renamed_GCF_000008685.2	chromosome	246596	248102	1506	100.0	0.0
UWI263P	contig_1	670458	670866	408	renamed_GCF_000008685.2	chromosome	237629	237221	408	100.0	2.649e-88
UWI263P	contig_1	670945	672493	1548	renamed_GCF_000008685.2	chromosome	237142	235594	1548	99.8	0.0
UWI263P	contig_1	672553	672799	246	renamed_GCF_000008685.2	chromosome	235534	235288	246	98.7	3.025e-52
UWI263P	contig_1	675750	672834	2916	renamed_GCF_000008685.2	chromosome	232337	235253	2916	99.8	0.0
UWI263P	contig_1	676467	675765	702	renamed_GCF_000008685.2	chromosome	231620	232322	702	100.0	1.161e-154
UWI263P	contig_1	676596	677874	1278	renamed_GCF_000008685.2	chromosome	231491	230213	1278	99.5	2.26e-287
UWI263P	contig_1	678871	677863	1008	renamed_GCF_000008685.2	chromosome	229216	230224	1008	99.4	2.993e-221
UWI263P	contig_1	679566	680274	708	renamed_GCF_000008685.2	chromosome	228521	227813	708	100.0	8.763e-159
UWI263P	contig_1	692661	690828	1833	renamed_GCF_000008685.2	chromosome	215426	217259	1833	99.1	0.0
UWI263P	contig_1	696787	696019	768	renamed_GCF_000008685.2	chromosome	211300	212068	768	100.0	8.822e-169
UWI263P	contig_1	699467	700004	537	renamed_GCF_000008685.2	chromosome	208581	208083	537	99.3	7.373e-107
UWI263P	contig_1	701558	700007	1551	renamed_GCF_000008685.2	chromosome	206528	208106	1551	99.6	0.0
UWI263P	contig_1	703015	702043	972	renamed_GCF_000008685.2	chromosome	205174	206044	972	99.6	3.289e-188
UWI263P	contig_1	703951	703015	936	renamed_GCF_000008685.2	chromosome	204136	205072	936	100.0	4.7e-204
UWI263P	contig_1	705238	703999	1239	renamed_GCF_000008685.2	chromosome	202849	204088	1239	100.0	5.514e-262
UWI263P	contig_1	734507	736556	2049	renamed_GCF_000008685.2	chromosome	173535	171531	2049	99.2	0.0
UWI263P	contig_1	736837	736603	234	renamed_GCF_000008685.2	chromosome	171262	171484	234	97.2	1.134e-44
UWI263P	contig_1	736990	737368	378	renamed_GCF_000008685.2	chromosome	171097	170719	378	98.4	1.768e-79
UWI263P	contig_1	738549	737379	1170	renamed_GCF_000008685.2	chromosome	169562	170708	1170	99.4	2.992e-257
UWI263P	contig_1	738688	740209	1521	renamed_GCF_000008685.2	chromosome	169399	167878	1521	99.6	0.0
UWI263P	contig_1	740328	742173	1845	renamed_GCF_000008685.2	chromosome	167759	165914	1845	99.3	0.0
UWI263P	contig_1	742200	743187	987	renamed_GCF_000008685.2	chromosome	165887	164900	987	99.6	2.948e-209
UWI263P	contig_1	743267	745016	1749	renamed_GCF_000008685.2	chromosome	164820	163071	1749	99.1	0.0
UWI263P	contig_1	745210	745042	168	renamed_GCF_000008685.2	chromosome	162877	163045	168	100.0	5.294e-34
UWI263P	contig_1	745286	746888	1602	renamed_GCF_000008685.2	chromosome	162801	161199	1602	99.8	0.0
UWI263P	contig_1	783939	785595	1656	renamed_GCF_000008685.2	chromosome	124146	122490	1656	99.2	0.0
UWI263P	contig_1	785594	786206	612	renamed_GCF_000008685.2	chromosome	122491	121879	612	97.0	9.656e-125
UWI263P	contig_1	786262	786985	723	renamed_GCF_000008685.2	chromosome	121823	121100	723	98.7	4.546e-160
UWI263P	contig_1	787003	787282	279	renamed_GCF_000008685.2	chromosome	121082	120803	279	96.7	3.477e-56
UWI263P	contig_1	787495	788278	783	renamed_GCF_000008685.2	chromosome	120589	119806	783	99.6	5.024e-169
UWI263P	contig_1	788281	789121	840	renamed_GCF_000008685.2	chromosome	119803	118963	840	97.1	3.15e-175
UWI263P	contig_1	789155	789710	555	renamed_GCF_000008685.2	chromosome	118929	118374	555	99.4	3.776e-117
UWI263P	contig_1	789714	790407	693	renamed_GCF_000008685.2	chromosome	118370	117677	693	98.2	1.337e-151
UWI263P	contig_1	791278	792580	1302	renamed_GCF_000008685.2	chromosome	116806	115504	1302	98.3	1.154e-281
UWI263P	contig_1	802228	802666	438	renamed_GCF_000008685.2	chromosome	105846	105417	438	97.8	4.286e-88
UWI263P	contig_1	802652	804320	1668	renamed_GCF_000008685.2	chromosome	105299	103763	1668	100.0	0.0
UWI263P	contig_1	804312	805068	756	renamed_GCF_000008685.2	chromosome	103771	103015	756	99.6	2.151e-165
UWI263P	contig_1	805134	806559	1425	renamed_GCF_000008685.2	chromosome	102949	101524	1425	100.0	1.009e-312
UWI263P	contig_1	806744	807338	594	renamed_GCF_000008685.2	chromosome	101339	100745	594	100.0	6.255e-135
UWI263P	contig_1	807856	807334	522	renamed_GCF_000008685.2	chromosome	100227	100749	522	100.0	2.976e-114
UWI263P	contig_1	809267	807878	1389	renamed_GCF_000008685.2	chromosome	98816	100205	1389	99.3	2.596e-313
UWI263P	contig_1	809302	810220	918	renamed_GCF_000008685.2	chromosome	98648	97862	918	99.2	2.569e-173
UWI263P	contig_1	810216	811140	924	renamed_GCF_000008685.2	chromosome	97866	96942	924	99.3	8.657e-204
UWI263P	contig_1	811129	813472	2343	renamed_GCF_000008685.2	chromosome	96953	94610	2343	98.8	0.0
UWI263P	contig_1	824162	825113	951	renamed_GCF_000008685.2	chromosome	83920	82969	951	99.6	3.736e-209
UWI263P	contig_1	826678	825142	1536	renamed_GCF_000008685.2	chromosome	81404	82940	1536	100.0	0.0
UWI263P	contig_1	827100	826674	426	renamed_GCF_000008685.2	chromosome	80982	81408	426	99.2	2.643e-91
UWI263P	contig_1	828578	827309	1269	renamed_GCF_000008685.2	chromosome	79504	80773	1269	100.0	1.4e-282
UWI263P	contig_1	828730	829081	351	renamed_GCF_000008685.2	chromosome	79322	79001	351	99.0	3.732e-67
UWI263P	contig_1	829073	830372	1299	renamed_GCF_000008685.2	chromosome	79009	77710	1299	99.7	4.127e-284
UWI263P	contig_1	831632	830381	1251	renamed_GCF_000008685.2	chromosome	76450	77701	1251	99.7	8.508e-268
UWI263P	contig_1	832309	831628	681	renamed_GCF_000008685.2	chromosome	75773	76454	681	100.0	3.584e-147
UWI263P	contig_1	846827	847517	690	renamed_GCF_000008685.2	chromosome	61257	60567	690	98.6	3.759e-148
UWI263P	contig_1	847551	848049	498	renamed_GCF_000008685.2	chromosome	60533	60035	498	100.0	3.278e-109
UWI263P	contig_1	848045	848984	939	renamed_GCF_000008685.2	chromosome	60039	59100	939	99.3	9.091e-206
UWI263P	contig_1	849047	850055	1008	renamed_GCF_000008685.2	chromosome	58982	58028	1008	99.3	5.908e-205
UWI263P	contig_1	850825	850108	717	renamed_GCF_000008685.2	chromosome	57258	57975	717	98.7	3.592e-153
UWI263P	contig_1	850898	851252	354	renamed_GCF_000008685.2	chromosome	57185	56831	354	99.1	6.554e-78
UWI263P	contig_1	851335	851803	468	renamed_GCF_000008685.2	chromosome	56748	56280	468	99.3	1.969e-101
UWI263P	contig_1	851803	852583	780	renamed_GCF_000008685.2	chromosome	56280	55500	780	99.6	1.628e-172
UWI263P	contig_1	852579	854550	1971	renamed_GCF_000008685.2	chromosome	55504	53533	1971	99.6	0.0
UWI263P	contig_1	854622	855630	1008	renamed_GCF_000008685.2	chromosome	53461	52453	1008	99.7	1.478e-220
UWI263P	contig_1	865201	865603	402	renamed_GCF_000008685.2	chromosome	42881	42479	402	100.0	2.405e-88
UWI263P	contig_1	865599	866640	1041	renamed_GCF_000008685.2	chromosome	42483	41442	1041	99.7	4.413e-231
UWI263P	contig_1	866650	867322	672	renamed_GCF_000008685.2	chromosome	41432	40760	672	100.0	1.856e-144
UWI263P	contig_1	868257	867405	852	renamed_GCF_000008685.2	chromosome	39825	40677	852	99.6	5.092e-189
UWI263P	contig_1	868444	869947	1503	renamed_GCF_000008685.2	chromosome	39638	38135	1503	99.8	0.0
UWI263P	contig_1	871470	872223	753	renamed_GCF_000008685.2	chromosome	36609	35856	753	98.8	1.62e-159
UWI263P	contig_1	872243	874043	1800	renamed_GCF_000008685.2	chromosome	35836	34036	1800	100.0	0.0
UWI263P	contig_1	874042	875923	1881	renamed_GCF_000008685.2	chromosome	34037	32156	1881	100.0	0.0
UWI263P	contig_1	875990	876530	540	renamed_GCF_000008685.2	chromosome	32089	31549	540	100.0	3.274e-116
UWI263P	contig_1	885350	885944	594	renamed_GCF_000008685.2	chromosome	22739	22145	594	99.4	7.271e-125
UWI263P	contig_1	885988	887032	1044	renamed_GCF_000008685.2	chromosome	22101	21057	1044	100.0	6.693e-227
UWI263P	contig_1	889627	890140	513	renamed_GCF_000008685.2	chromosome	18304	17791	513	99.4	1.872e-109
UWI263P	contig_1	892087	891127	960	renamed_GCF_000008685.2	chromosome	15994	16804	960	98.8	1.19e-171
UWI263P	contig_1	892209	892587	378	renamed_GCF_000008685.2	chromosome	15716	15344	378	99.1	3.937e-79
UWI263P	contig_1	892586	893207	621	renamed_GCF_000008685.2	chromosome	15345	14724	621	100.0	3.249e-138
UWI263P	contig_1	895186	893203	1983	renamed_GCF_000008685.2	chromosome	12745	14728	1983	99.5	0.0
UWI263P	contig_1	906136	907165	1029	renamed_GCF_000008685.2	chromosome	1796	767	1029	100.0	4.829e-228
UWI263P	contig_1	907844	907280	564	renamed_GCF_000008685.2	chromosome	104	677	564	96.2	6.014e-122
UWI263P	contig_2	182	659	477	renamed_GCF_000008685.2	cp26	16667	15131	477	100.0	3.789e-104
UWI263P	contig_2	683	1898	1215	renamed_GCF_000008685.2	cp26	15107	13892	1215	99.2	1.299e-265
UWI263P	contig_2	3777	2184	1593	renamed_GCF_000008685.2	cp26	12013	13606	1593	99.2	0.0
UWI263P	contig_2	4372	4870	498	renamed_GCF_000008685.2	cp26	11417	10919	498	98.1	4.372e-106
UWI263P	contig_2	5689	5140	549	renamed_GCF_000008685.2	cp26	10103	10652	549	98.9	7.635e-117
UWI263P	contig_2	6518	5756	762	renamed_GCF_000008685.2	cp26	9274	10036	762	98.8	5.77e-164
UWI263P	contig_2	17467	15838	1629	renamed_GCF_000008685.2	cp26	24824	26453	1629	100.0	0.0
UWI263P	contig_2	19037	17792	1245	renamed_GCF_000008685.2	cp26	23254	24499	1245	99.7	5.213e-281
UWI263P	contig_2	19137	19689	552	renamed_GCF_000008685.2	cp26	23154	22602	552	99.4	6.015e-120
UWI263P	contig_2	20394	19698	696	renamed_GCF_000008685.2	cp26	21897	22593	696	99.5	6.925e-151
UWI263P	contig_2	20467	20953	486	renamed_GCF_000008685.2	cp26	21833	21338	486	100.0	3.279e-107
UWI263P	contig_2	20927	21434	507	renamed_GCF_000008685.2	cp26	21364	20857	507	100.0	3.123e-111
UWI263P	contig_2	21505	22861	1356	renamed_GCF_000008685.2	cp26	20786	19430	1356	98.6	2.16e-292
UWI263P	contig_2	22970	24326	1356	renamed_GCF_000008685.2	cp26	19321	17965	1356	99.5	9.723e-293
UWI263P	contig_2	25406	24773	633	renamed_GCF_000008685.2	cp26	16902	17535	633	73.9	1.336e-90
UWI263P	contig_3	1251	558	693	renamed_GCF_000008685.2	cp32-1	1305	1998	693	100.0	2.582e-144
UWI263P	contig_3	11632	10876	756	renamed_GCF_000008685.2	lp56	24517	25273	756	99.6	5.251e-164
UWI263P	contig_3	12174	11607	567	renamed_GCF_000008685.2	cp32-1	20223	20790	567	98.9	1.456e-129
UWI263P	contig_3	15161	14717	444	renamed_GCF_000008685.2	cp32-8	17204	17651	444	80.4	8.229e-74
UWI263P	contig_3	16312	15958	354	renamed_GCF_000008685.2	cp32-6	16102	16456	354	100.0	1.459e-77
UWI263P	contig_3	17184	16980	204	renamed_GCF_000008685.2	lp56	18712	18916	204	100.0	2.578e-39
UWI263P	contig_3	25643	24530	1113	renamed_GCF_000008685.2	cp32-6	6710	7823	1113	98.6	4.476e-243
UWI263P	contig_3	26947	26563	384	renamed_GCF_000008685.2	cp32-9	5412	5796	384	100.0	2.931e-83
UWI263P	contig_3	28976	28400	576	renamed_GCF_000008685.2	cp32-6	3372	3948	576	100.0	4.521e-127
UWI263P	contig_4	773	536	237	renamed_GCF_000008685.2	cp32-7	8725	8962	237	100.0	7.893e-49
UWI263P	contig_4	1225	769	456	renamed_GCF_000008685.2	cp32-7	8273	8729	456	100.0	8.859e-100
UWI263P	contig_4	8202	7509	693	renamed_GCF_000008685.2	cp32-6	1305	1998	693	100.0	5.741e-144
UWI263P	contig_4	13361	12338	1023	renamed_GCF_000008685.2	lp56	29936	30974	1023	95.6	4.99e-218
UWI263P	contig_4	17467	16888	579	renamed_GCF_000008685.2	cp32-8	22112	22691	579	99.4	7.628e-122
UWI263P	contig_4	24375	24171	204	renamed_GCF_000008685.2	cp32-3	15211	15415	204	100.0	2.578e-39
UWI263P	contig_4	27092	26759	333	renamed_GCF_000008685.2	cp32-3	12494	12827	333	100.0	8.424e-72
UWI263P	contig_5	1055	1259	204	renamed_GCF_000008685.2	cp32-8	15214	15418	204	100.0	2.578e-39
UWI263P	contig_5	1599	1935	336	renamed_GCF_000008685.2	cp32-8	15758	16094	336	100.0	5.348e-69
UWI263P	contig_5	2429	2747	318	renamed_GCF_000008685.2	cp32-3	16585	16903	318	100.0	2.414e-66
UWI263P	contig_5	3670	4108	438	renamed_GCF_000008685.2	cp32-3	17802	18249	438	80.0	6.169e-76
UWI263P	contig_5	5062	4144	918	renamed_GCF_000008685.2	cp32-3	19228	18286	918	86.6	6.647e-180
UWI263P	contig_5	5450	6548	1098	renamed_GCF_000008685.2	cp32-7	19116	20214	1098	98.3	2.449e-247
UWI263P	contig_5	6557	7124	567	renamed_GCF_000008685.2	cp32-4	20066	20633	567	100.0	2.944e-130
UWI263P	contig_6	1817	857	960	renamed_GCF_000008685.2	lp56	7432	8392	960	100.0	6.008e-214
UWI263P	contig_6	3780	3213	567	renamed_GCF_000008685.2	lp56	35818	36385	567	100.0	4.74e-125
UWI263P	contig_6	5724	4500	1224	renamed_GCF_000008685.2	cp32-6	65	1289	1224	99.7	4.655e-270
UWI263P	contig_6	18906	18291	615	renamed_GCF_000008685.2	lp56	20843	21455	615	89.2	1.012e-124
UWI263P	contig_6	19566	19011	555	renamed_GCF_000008685.2	cp32-3	17088	17697	555	91.0	2.485e-113
UWI263P	contig_6	20024	19670	354	renamed_GCF_000008685.2	cp32-8	16086	16440	354	99.1	3.249e-77
UWI263P	contig_6	20689	20341	348	renamed_GCF_000008685.2	lp56	18919	19267	348	99.1	4.373e-73
UWI263P	contig_6	22406	21800	606	renamed_GCF_000008685.2	cp32-7	13715	14321	606	97.0	7.992e-126
UWI263P	contig_6	23290	22411	879	renamed_GCF_000008685.2	cp32-7	12831	13710	879	96.9	9.361e-187
UWI263P	contig_7	2311	1546	765	renamed_GCF_000008685.2	cp32-7	2573	3338	765	98.4	3.447e-170
UWI263P	contig_7	2875	2317	558	renamed_GCF_000008685.2	cp32-1	2010	2568	558	100.0	1.105e-122
UWI263P	contig_7	3580	2887	693	renamed_GCF_000008685.2	cp32-8	1305	1998	693	100.0	2.582e-144
UWI263P	contig_7	6804	6237	567	renamed_GCF_000008685.2	cp32-3	28235	28874	567	93.0	1.228e-114
UWI263P	contig_7	8340	7830	510	renamed_GCF_000008685.2	cp32-3	27409	27919	510	96.4	1.177e-105
UWI263P	contig_7	9075	8451	624	renamed_GCF_000008685.2	cp32-3	26707	27298	624	54.2	6.274e-63
UWI263P	contig_7	28842	27729	1113	renamed_GCF_000008685.2	cp32-1	6700	7813	1113	98.1	9.945e-243
UWI263P	contig_7	29389	28822	567	renamed_GCF_000008685.2	cp32-9	6169	6736	567	98.4	2.579e-123
UWI263P	contig_7	29775	29385	390	renamed_GCF_000008685.2	cp32-9	5783	6173	390	100.0	3.229e-83
UWI263P	contig_7	30146	29762	384	renamed_GCF_000008685.2	cp32-4	5406	5790	384	100.0	2.931e-83
UWI263P	contig_7	30601	30145	456	renamed_GCF_000008685.2	cp32-1	4941	5397	456	97.3	1.304e-95
UWI263P	contig_8	2323	1732	591	renamed_GCF_000008685.2	cp32-3	22592	23183	591	100.0	1.16e-127
UWI263P	contig_8	2878	2335	543	renamed_GCF_000008685.2	cp32-1	21560	22118	543	64.0	6.304e-76
UWI263P	contig_8	3659	2918	741	renamed_GCF_000008685.2	cp32-3	21256	21997	741	100.0	5.003e-162
UWI263P	contig_8	5308	4210	1098	renamed_GCF_000008685.2	cp32-1	19113	20214	1098	96.1	1.038e-239
UWI263P	contig_8	5704	6721	1017	renamed_GCF_000008685.2	cp32-1	18728	17714	1017	99.1	8.894e-228
UWI263P	contig_8	7990	7306	684	renamed_GCF_000008685.2	lp56	20042	20738	684	86.1	2.703e-125
UWI263P	contig_1	91838	92636	798	renamed_GCF_000008685.2	chromosome	816299	815501	798	100.0	1.968e-173
UWI263P	contig_1	92835	93270	435	renamed_GCF_000008685.2	chromosome	815302	814867	435	100.0	4.611e-95
UWI263P	contig_1	93440	94448	1008	renamed_GCF_000008685.2	chromosome	814697	813689	1008	99.4	2.823e-213
UWI263P	contig_1	94431	94776	345	renamed_GCF_000008685.2	chromosome	813706	813385	345	92.0	6.146e-61
UWI263P	contig_1	94928	95729	801	renamed_GCF_000008685.2	chromosome	813239	812438	801	100.0	9.279e-174
UWI263P	contig_1	95779	96661	882	renamed_GCF_000008685.2	chromosome	812388	811506	882	99.3	2.773e-192
UWI263P	contig_1	96657	97698	1041	renamed_GCF_000008685.2	chromosome	811510	810469	1041	99.7	3.047e-235
UWI263P	contig_1	97672	98467	795	renamed_GCF_000008685.2	chromosome	810495	809700	795	100.0	1.877e-173
UWI263P	contig_1	98615	99707	1092	renamed_GCF_000008685.2	chromosome	809552	808460	1092	99.7	8.623e-241
UWI263P	contig_1	99703	100192	489	renamed_GCF_000008685.2	chromosome	808464	807975	489	100.0	6.125e-101
UWI263P	contig_1	133742	136541	2799	renamed_GCF_000008685.2	chromosome	774368	771569	2799	99.6	0.0
UWI263P	contig_1	136547	136949	402	renamed_GCF_000008685.2	chromosome	771563	771161	402	100.0	3.917e-83
UWI263P	contig_1	136971	138564	1593	renamed_GCF_000008685.2	chromosome	771139	769546	1593	99.2	0.0
UWI263P	contig_1	138639	140031	1392	renamed_GCF_000008685.2	chromosome	769470	768078	1392	100.0	1.696e-292
UWI263P	contig_1	140045	141377	1332	renamed_GCF_000008685.2	chromosome	768064	766732	1332	98.8	3.624e-291
UWI263P	contig_1	142737	141393	1344	renamed_GCF_000008685.2	chromosome	765372	766716	1344	100.0	2.685e-305
UWI263P	contig_1	143739	142767	972	renamed_GCF_000008685.2	chromosome	764370	765342	972	99.6	1.468e-214
UWI263P	contig_1	144531	143748	783	renamed_GCF_000008685.2	chromosome	763578	764361	783	99.6	1.874e-171
UWI263P	contig_1	147908	146462	1446	renamed_GCF_000008685.2	chromosome	760225	761647	1446	98.3	6.888e-312
UWI263P	contig_1	148524	147894	630	renamed_GCF_000008685.2	chromosome	759585	760215	630	98.0	4.528e-136
UWI263P	contig_1	151756	150439	1317	renamed_GCF_000008685.2	chromosome	756353	757670	1317	99.7	1.293e-291
UWI263P	contig_1	153560	151760	1800	renamed_GCF_000008685.2	chromosome	754636	756349	1800	100.0	0.0
UWI263P	contig_1	154042	153559	483	renamed_GCF_000008685.2	chromosome	754067	754550	483	99.3	6.952e-107
UWI263P	contig_1	154887	154041	846	renamed_GCF_000008685.2	chromosome	753291	754068	846	99.6	1.473e-167
UWI263P	contig_1	155940	154890	1050	renamed_GCF_000008685.2	chromosome	752169	753219	1050	100.0	6.109e-229
UWI263P	contig_1	156919	155950	969	renamed_GCF_000008685.2	chromosome	751190	752159	969	100.0	4.772e-218
UWI263P	contig_1	158079	157320	759	renamed_GCF_000008685.2	chromosome	750030	750789	759	100.0	2.255e-165
UWI263P	contig_1	168967	168427	540	renamed_GCF_000008685.2	chromosome	739143	739683	540	100.0	2.458e-119
UWI263P	contig_1	169705	169339	366	renamed_GCF_000008685.2	chromosome	738405	738771	366	100.0	9.695e-76
UWI263P	contig_1	170402	169682	720	renamed_GCF_000008685.2	chromosome	737708	738428	720	99.5	4.764e-159
UWI263P	contig_1	170899	170398	501	renamed_GCF_000008685.2	chromosome	737211	737712	501	98.1	2.269e-105
UWI263P	contig_1	171151	170902	249	renamed_GCF_000008685.2	chromosome	736959	737208	249	100.0	2.148e-48
UWI263P	contig_1	171412	171151	261	renamed_GCF_000008685.2	chromosome	736698	736959	261	100.0	3.165e-54
UWI263P	contig_1	172759	171424	1335	renamed_GCF_000008685.2	chromosome	735351	736686	1335	99.5	6.578e-285
UWI263P	contig_1	174030	172821	1209	renamed_GCF_000008685.2	chromosome	734080	735289	1209	100.0	8.188e-270
UWI263P	contig_1	176316	174306	2010	renamed_GCF_000008685.2	chromosome	731793	733803	2010	99.8	0.0
UWI263P	contig_1	176926	176389	537	renamed_GCF_000008685.2	chromosome	731183	731720	537	100.0	1.936e-121
UWI263P	contig_1	208139	209705	1566	renamed_GCF_000008685.2	chromosome	699965	698399	1566	99.4	0.0
UWI263P	contig_1	210519	209772	747	renamed_GCF_000008685.2	chromosome	697585	698332	747	99.5	7.646e-167
UWI263P	contig_1	210667	211354	687	renamed_GCF_000008685.2	chromosome	697437	696750	687	99.1	7.255e-149
UWI263P	contig_1	212474	211340	1134	renamed_GCF_000008685.2	chromosome	695630	696764	1134	98.9	3.791e-257
UWI263P	contig_1	212572	213403	831	renamed_GCF_000008685.2	chromosome	695523	694692	831	99.2	6.41e-183
UWI263P	contig_1	214542	213399	1143	renamed_GCF_000008685.2	chromosome	693553	694696	1143	100.0	3.979e-258
UWI263P	contig_1	215467	214567	900	renamed_GCF_000008685.2	chromosome	692628	693528	900	99.3	9.829e-190
UWI263P	contig_1	217211	215450	1761	renamed_GCF_000008685.2	chromosome	690884	692645	1761	99.6	0.0
UWI263P	contig_1	217593	217296	297	renamed_GCF_000008685.2	chromosome	690481	690799	297	98.9	6.955e-60
UWI263P	contig_1	217903	217606	297	renamed_GCF_000008685.2	chromosome	690192	690489	297	100.0	1.037e-63
UWI263P	contig_1	262490	262955	465	renamed_GCF_000008685.2	chromosome	645601	645136	465	100.0	4.176e-101
UWI263P	contig_1	263320	262951	369	renamed_GCF_000008685.2	chromosome	644771	645140	369	100.0	1.529e-79
UWI263P	contig_1	263441	264797	1356	renamed_GCF_000008685.2	chromosome	644650	643294	1356	99.7	8.637e-303
UWI263P	contig_1	264965	265592	627	renamed_GCF_000008685.2	chromosome	643126	642499	627	100.0	8.735e-137
UWI263P	contig_1	265803	265650	153	renamed_GCF_000008685.2	chromosome	642288	642441	153	98.0	2.814e-30
UWI263P	contig_1	268251	265842	2409	renamed_GCF_000008685.2	chromosome	639858	642249	2409	99.2	0.0
UWI263P	contig_1	269512	268219	1293	renamed_GCF_000008685.2	chromosome	638579	639872	1293	99.5	1.544e-285
UWI263P	contig_1	270129	269535	594	renamed_GCF_000008685.2	chromosome	637971	638556	594	99.4	7.271e-125
UWI263P	contig_1	271499	270134	1365	renamed_GCF_000008685.2	chromosome	636592	637957	1365	99.1	3.824e-296
UWI263P	contig_1	273510	272079	1431	renamed_GCF_000008685.2	chromosome	634580	636011	1431	95.5	1.916e-306
UWI263P	contig_1	275606	273626	1980	renamed_GCF_000008685.2	chromosome	632484	634464	1980	99.2	0.0
UWI263P	contig_1	276100	275608	492	renamed_GCF_000008685.2	chromosome	631990	632482	492	100.0	1.786e-106
UWI263P	contig_1	277322	276104	1218	renamed_GCF_000008685.2	chromosome	630795	631986	1218	99.4	4.366e-261
UWI263P	contig_1	277392	278895	1503	renamed_GCF_000008685.2	chromosome	630698	629195	1503	100.0	0.0
UWI263P	contig_1	279142	280999	1857	renamed_GCF_000008685.2	chromosome	628948	627091	1857	100.0	0.0
UWI263P	contig_1	281805	281052	753	renamed_GCF_000008685.2	chromosome	626285	627038	753	100.0	9.23e-166
UWI263P	contig_1	283084	281830	1254	renamed_GCF_000008685.2	chromosome	625006	626260	1254	100.0	1.925e-276
UWI263P	contig_1	284640	283083	1557	renamed_GCF_000008685.2	chromosome	623450	625007	1557	98.6	0.0
UWI263P	contig_1	286086	284643	1443	renamed_GCF_000008685.2	chromosome	622004	623447	1443	98.9	0.0
UWI263P	contig_1	286137	287046	909	renamed_GCF_000008685.2	chromosome	621953	621044	909	99.3	3.709e-202
UWI263P	contig_1	329809	327664	2145	renamed_GCF_000008685.2	chromosome	578276	580421	2145	99.7	0.0
UWI263P	contig_1	330136	329824	312	renamed_GCF_000008685.2	chromosome	577949	578261	312	100.0	5.387e-65
UWI263P	contig_1	330691	330148	543	renamed_GCF_000008685.2	chromosome	577394	577937	543	100.0	3.121e-117
UWI263P	contig_1	330897	331503	606	renamed_GCF_000008685.2	chromosome	577187	576581	606	99.5	4.975e-131
UWI263P	contig_1	331558	332104	546	renamed_GCF_000008685.2	chromosome	576499	575980	546	100.0	1.781e-115
UWI263P	contig_1	332268	332811	543	renamed_GCF_000008685.2	chromosome	575816	575273	543	100.0	3.121e-117
UWI263P	contig_1	334232	332837	1395	renamed_GCF_000008685.2	chromosome	573852	575247	1395	99.5	1.406e-312
UWI263P	contig_1	334344	336195	1851	renamed_GCF_000008685.2	chromosome	573740	571889	1851	100.0	0.0
UWI263P	contig_1	336802	336232	570	renamed_GCF_000008685.2	chromosome	571282	571852	570	100.0	1.471e-121
UWI263P	contig_1	338526	336804	1722	renamed_GCF_000008685.2	chromosome	569558	571280	1722	99.8	0.0
UWI263P	contig_1	372375	370551	1824	renamed_GCF_000008685.2	chromosome	535703	537527	1824	99.0	0.0
UWI263P	contig_1	372478	372901	423	renamed_GCF_000008685.2	chromosome	535600	535177	423	99.2	2.776e-90
UWI263P	contig_1	373778	372923	855	renamed_GCF_000008685.2	chromosome	534300	535155	855	99.6	9.843e-191
UWI263P	contig_1	376387	376951	564	renamed_GCF_000008685.2	chromosome	531692	531128	564	100.0	2.704e-122
UWI263P	contig_1	376974	378882	1908	renamed_GCF_000008685.2	chromosome	531105	529197	1908	100.0	0.0
UWI263P	contig_1	378881	379976	1095	renamed_GCF_000008685.2	chromosome	529198	528103	1095	99.7	8.741e-250
UWI263P	contig_1	383525	381824	1701	renamed_GCF_000008685.2	chromosome	524553	526254	1701	99.1	0.0
UWI263P	contig_1	405121	404722	399	renamed_GCF_000008685.2	chromosome	502950	503349	399	100.0	3.071e-85
UWI263P	contig_1	405316	405130	186	renamed_GCF_000008685.2	chromosome	502755	502941	186	100.0	7.664e-41
UWI263P	contig_1	405881	405332	549	renamed_GCF_000008685.2	chromosome	502190	502739	549	100.0	1.698e-116
UWI263P	contig_1	406192	405886	306	renamed_GCF_000008685.2	chromosome	501879	502185	306	100.0	2.959e-62
UWI263P	contig_1	406575	406206	369	renamed_GCF_000008685.2	chromosome	501496	501865	369	99.1	4.571e-76
UWI263P	contig_1	406857	406602	255	renamed_GCF_000008685.2	chromosome	501214	501469	255	100.0	1.745e-51
UWI263P	contig_1	407060	406859	201	renamed_GCF_000008685.2	chromosome	501014	501212	201	98.4	1.098e-39
UWI263P	contig_1	407479	407062	417	renamed_GCF_000008685.2	chromosome	500592	501009	417	100.0	2.778e-89
UWI263P	contig_1	408365	407483	882	renamed_GCF_000008685.2	chromosome	499706	500588	882	100.0	1.248e-192
UWI263P	contig_1	408731	408368	363	renamed_GCF_000008685.2	chromosome	499340	499703	363	100.0	3.407e-78
UWI263P	contig_1	448017	447657	360	renamed_GCF_000008685.2	chromosome	460051	460411	360	99.1	5.311e-73
UWI263P	contig_1	448153	447997	156	renamed_GCF_000008685.2	chromosome	459915	460071	156	100.0	2.965e-30
UWI263P	contig_1	448544	448244	300	renamed_GCF_000008685.2	chromosome	459524	459824	300	95.9	4.432e-57
UWI263P	contig_1	449792	448634	1158	renamed_GCF_000008685.2	chromosome	458276	459434	1158	99.7	5.514e-257
UWI263P	contig_1	451493	450032	1461	renamed_GCF_000008685.2	chromosome	456575	458036	1461	100.0	0.0
UWI263P	contig_1	451680	453585	1905	renamed_GCF_000008685.2	chromosome	456388	454483	1905	99.8	0.0
UWI263P	contig_1	453596	456029	2433	renamed_GCF_000008685.2	chromosome	454472	452039	2433	100.0	0.0
UWI263P	contig_1	456147	456930	783	renamed_GCF_000008685.2	chromosome	451921	451138	783	99.2	5.024e-169
UWI263P	contig_1	458650	457897	753	renamed_GCF_000008685.2	chromosome	449418	450171	753	100.0	3.278e-160
UWI263P	contig_1	499690	499870	180	renamed_GCF_000008685.2	chromosome	408380	408200	180	100.0	2.118e-37
UWI263P	contig_1	499988	500159	171	renamed_GCF_000008685.2	chromosome	408092	407921	171	98.2	2.497e-34
UWI263P	contig_1	500182	500737	555	renamed_GCF_000008685.2	chromosome	407898	407343	555	99.4	1.275e-120
UWI263P	contig_1	500788	501220	432	renamed_GCF_000008685.2	chromosome	407292	406860	432	99.3	1.75e-88
UWI263P	contig_1	501219	501900	681	renamed_GCF_000008685.2	chromosome	406861	406180	681	100.0	2.702e-150
UWI263P	contig_1	501904	502393	489	renamed_GCF_000008685.2	chromosome	406176	405687	489	99.3	6.125e-101
UWI263P	contig_1	502463	502838	375	renamed_GCF_000008685.2	chromosome	405617	405242	375	99.1	2.753e-74
UWI263P	contig_1	506403	510537	4134	renamed_GCF_000008685.2	chromosome	401677	397543	4134	99.8	0.0
UWI263P	contig_1	510604	510979	375	renamed_GCF_000008685.2	chromosome	397476	397101	375	100.0	1.385e-81
UWI263P	contig_1	521924	520745	1179	renamed_GCF_000008685.2	chromosome	386158	387337	1179	99.7	9.776e-263
UWI263P	contig_1	522634	521920	714	renamed_GCF_000008685.2	chromosome	385448	386162	714	100.0	3.427e-153
UWI263P	contig_1	523796	522656	1140	renamed_GCF_000008685.2	chromosome	384286	385426	1140	99.4	1.764e-249
UWI263P	contig_1	523920	524688	768	renamed_GCF_000008685.2	chromosome	384162	383394	768	99.6	9.689e-168
UWI263P	contig_1	524700	526173	1473	renamed_GCF_000008685.2	chromosome	383382	381909	1473	100.0	0.0
UWI263P	contig_1	526190	527528	1338	renamed_GCF_000008685.2	chromosome	381892	380554	1338	100.0	1.408e-311
UWI263P	contig_1	527524	528742	1218	renamed_GCF_000008685.2	chromosome	380558	379340	1218	99.5	1.909e-270
UWI263P	contig_1	528752	531044	2292	renamed_GCF_000008685.2	chromosome	379258	377038	2292	99.3	0.0
UWI263P	contig_1	531063	532122	1059	renamed_GCF_000008685.2	chromosome	377019	375960	1059	98.2	1.562e-228
UWI263P	contig_1	532422	532143	279	renamed_GCF_000008685.2	chromosome	375660	375939	279	100.0	3.143e-57
UWI263P	contig_1	542478	542967	489	renamed_GCF_000008685.2	chromosome	365603	365114	489	100.0	3.787e-106
UWI263P	contig_1	543002	543953	951	renamed_GCF_000008685.2	chromosome	364972	364129	951	98.9	2.861e-186
UWI263P	contig_1	543965	545765	1800	renamed_GCF_000008685.2	chromosome	364117	362317	1800	99.8	0.0
UWI263P	contig_1	546883	545761	1122	renamed_GCF_000008685.2	chromosome	361187	362321	1122	99.4	1.215e-250
UWI263P	contig_1	547004	548570	1566	renamed_GCF_000008685.2	chromosome	361078	359512	1566	99.6	0.0
UWI263P	contig_1	548587	548866	279	renamed_GCF_000008685.2	chromosome	359495	359216	279	100.0	2.841e-58
UWI263P	contig_1	549625	548884	741	renamed_GCF_000008685.2	chromosome	358457	359198	741	99.1	2.251e-162
UWI263P	contig_1	551076	549642	1434	renamed_GCF_000008685.2	chromosome	357006	358440	1434	99.7	4.764e-314
UWI263P	contig_1	552592	551173	1419	renamed_GCF_000008685.2	chromosome	355490	356909	1419	99.7	6.982e-316
UWI263P	contig_1	552784	553435	651	renamed_GCF_000008685.2	chromosome	355298	354647	651	100.0	1.769e-141
UWI263P	contig_1	597558	598302	744	renamed_GCF_000008685.2	chromosome	310523	309779	744	100.0	5.245e-162
UWI263P	contig_1	598301	599543	1242	renamed_GCF_000008685.2	chromosome	309780	308538	1242	100.0	1.368e-269
UWI263P	contig_1	599564	600764	1200	renamed_GCF_000008685.2	chromosome	308517	307317	1200	99.7	1.629e-260
UWI263P	contig_1	600764	601457	693	renamed_GCF_000008685.2	chromosome	307317	306624	693	100.0	2.971e-151
UWI263P	contig_1	601463	602411	948	renamed_GCF_000008685.2	chromosome	306615	305670	948	99.6	1.604e-209
UWI263P	contig_1	602420	602969	549	renamed_GCF_000008685.2	chromosome	305661	305112	549	100.0	9.24e-115
UWI263P	contig_1	602961	604308	1347	renamed_GCF_000008685.2	chromosome	305120	303773	1347	100.0	1.016e-290
UWI263P	contig_1	604341	604749	408	renamed_GCF_000008685.2	chromosome	303740	303332	408	99.2	2.649e-88
UWI263P	contig_1	604772	605231	459	renamed_GCF_000008685.2	chromosome	303309	302850	459	100.0	4.601e-99
UWI263P	contig_1	605242	605578	336	renamed_GCF_000008685.2	chromosome	302839	302503	336	98.1	1.315e-67
UWI263P	contig_1	622121	624212	2091	renamed_GCF_000008685.2	chromosome	285962	283868	2091	99.4	0.0
UWI263P	contig_1	624215	625382	1167	renamed_GCF_000008685.2	chromosome	283865	282698	1167	100.0	1.172e-258
UWI263P	contig_1	625393	626281	888	renamed_GCF_000008685.2	chromosome	282687	281799	888	100.0	4.025e-189
UWI263P	contig_1	626287	626767	480	renamed_GCF_000008685.2	chromosome	281793	281313	480	99.3	5.307e-101
UWI263P	contig_1	626769	628674	1905	renamed_GCF_000008685.2	chromosome	281311	279406	1905	100.0	0.0
UWI263P	contig_1	628700	629003	303	renamed_GCF_000008685.2	chromosome	279380	279077	303	96.0	6.277e-62
UWI263P	contig_1	629022	629544	522	renamed_GCF_000008685.2	chromosome	279058	278536	522	100.0	3.966e-111
UWI263P	contig_1	629521	630991	1470	renamed_GCF_000008685.2	chromosome	278559	277089	1470	99.5	9.743e-321
UWI263P	contig_1	631523	631016	507	renamed_GCF_000008685.2	chromosome	276671	277064	507	100.0	6.298e-87
UWI263P	contig_1	631584	632838	1254	renamed_GCF_000008685.2	chromosome	276496	275242	1254	99.2	2.7e-281
UWI263P	contig_1	662300	661535	765	renamed_GCF_000008685.2	chromosome	245789	246554	765	100.0	7.663e-170
UWI263P	contig_1	662709	663312	603	renamed_GCF_000008685.2	chromosome	245382	244776	603	99.5	7.936e-134
UWI263P	contig_1	663375	664146	771	renamed_GCF_000008685.2	chromosome	244713	243942	771	100.0	4.161e-169
UWI263P	contig_1	665651	664085	1566	renamed_GCF_000008685.2	chromosome	242437	244003	1566	98.8	0.0
UWI263P	contig_1	665799	667806	2007	renamed_GCF_000008685.2	chromosome	242289	240282	2007	99.7	0.0
UWI263P	contig_1	667838	668945	1107	renamed_GCF_000008685.2	chromosome	240250	239143	1107	99.1	1.835e-243
UWI263P	contig_1	668960	669533	573	renamed_GCF_000008685.2	chromosome	239128	238300	573	96.8	1.543e-121
UWI263P	contig_1	669861	670119	258	renamed_GCF_000008685.2	chromosome	238226	237968	258	100.0	9.113e-51
UWI263P	contig_1	670131	670458	327	renamed_GCF_000008685.2	chromosome	237956	237629	327	100.0	8.435e-71
UWI263P	contig_1	705509	707036	1527	renamed_GCF_000008685.2	chromosome	202578	201051	1527	99.2	0.0
UWI263P	contig_1	707037	708123	1086	renamed_GCF_000008685.2	chromosome	201050	199964	1086	99.4	6.528e-243
UWI263P	contig_1	712395	710391	2004	renamed_GCF_000008685.2	chromosome	195692	197696	2004	99.7	0.0
UWI263P	contig_1	713212	712351	861	renamed_GCF_000008685.2	chromosome	194875	195736	861	98.9	3.489e-186
UWI263P	contig_1	714624	715764	1140	renamed_GCF_000008685.2	chromosome	193463	192323	1140	99.7	9.252e-257
UWI263P	contig_1	715760	716570	810	renamed_GCF_000008685.2	chromosome	192327	191517	810	99.6	1.125e-181
UWI263P	contig_1	717369	716628	741	renamed_GCF_000008685.2	chromosome	190718	191459	741	99.5	3.597e-157
UWI263P	contig_1	718024	717370	654	renamed_GCF_000008685.2	chromosome	190186	190717	654	99.4	1.404e-110
UWI263P	contig_1	725202	724707	495	renamed_GCF_000008685.2	chromosome	182885	183380	495	100.0	9.271e-106
UWI263P	contig_1	725285	726680	1395	renamed_GCF_000008685.2	chromosome	182802	181407	1395	100.0	4.219e-300
UWI263P	contig_1	726682	728548	1866	renamed_GCF_000008685.2	chromosome	181405	179539	1866	99.6	0.0
UWI263P	contig_1	728544	729171	627	renamed_GCF_000008685.2	chromosome	179543	178916	627	97.5	3.766e-129
UWI263P	contig_1	729227	730220	993	renamed_GCF_000008685.2	chromosome	178860	177867	993	99.6	2.235e-213
UWI263P	contig_1	730234	731110	876	renamed_GCF_000008685.2	chromosome	177853	176977	876	100.0	9.427e-195
UWI263P	contig_1	731113	732019	906	renamed_GCF_000008685.2	chromosome	176974	176068	906	100.0	1.374e-195
UWI263P	contig_1	733003	733990	987	renamed_GCF_000008685.2	chromosome	174970	174097	987	99.6	1.701e-189
UWI263P	contig_1	733971	734559	588	renamed_GCF_000008685.2	chromosome	174116	173528	588	99.4	1.682e-131
UWI263P	contig_1	759424	760435	1011	renamed_GCF_000008685.2	chromosome	148659	147648	1011	99.7	2.697e-214
UWI263P	contig_1	760588	761707	1119	renamed_GCF_000008685.2	chromosome	147495	146376	1119	100.0	3.727e-246
UWI263P	contig_1	761713	762613	900	renamed_GCF_000008685.2	chromosome	146370	145470	900	100.0	6.779e-194
UWI263P	contig_1	762625	763498	873	renamed_GCF_000008685.2	chromosome	145458	144585	873	98.9	1.511e-197
UWI263P	contig_1	763904	765140	1236	renamed_GCF_000008685.2	chromosome	144230	142943	1236	99.5	6.15e-269
UWI263P	contig_1	765151	766105	954	renamed_GCF_000008685.2	chromosome	142932	141978	954	99.3	1.665e-201
UWI263P	contig_1	769340	769652	312	renamed_GCF_000008685.2	chromosome	138745	138433	312	99.0	2.189e-66
UWI263P	contig_1	793278	792576	702	renamed_GCF_000008685.2	chromosome	114806	115508	702	98.7	1.276e-153
UWI263P	contig_1	793481	795176	1695	renamed_GCF_000008685.2	chromosome	114603	112908	1695	100.0	0.0
UWI263P	contig_1	795315	795735	420	renamed_GCF_000008685.2	chromosome	112769	112349	420	99.2	1.444e-88
UWI263P	contig_1	795746	796196	450	renamed_GCF_000008685.2	chromosome	112338	111888	450	99.3	9.762e-98
UWI263P	contig_1	796209	796500	291	renamed_GCF_000008685.2	chromosome	111875	111584	291	100.0	1.894e-64
UWI263P	contig_1	796516	797038	522	renamed_GCF_000008685.2	chromosome	111567	111045	522	100.0	1.783e-111
UWI263P	contig_1	797041	798409	1368	renamed_GCF_000008685.2	chromosome	111042	109674	1368	100.0	1.976e-295
UWI263P	contig_1	799777	798412	1365	renamed_GCF_000008685.2	chromosome	108306	109671	1365	100.0	4.349e-312
UWI263P	contig_1	799913	801110	1197	renamed_GCF_000008685.2	chromosome	108170	106973	1197	99.7	1.869e-258
UWI263P	contig_1	801189	802200	1011	renamed_GCF_000008685.2	chromosome	106894	105883	1011	100.0	4.14e-218
UWI263P	contig_1	835435	834589	846	renamed_GCF_000008685.2	chromosome	72646	73492	846	99.2	6.38e-177
UWI263P	contig_1	836881	835471	1410	renamed_GCF_000008685.2	chromosome	71200	72610	1410	99.5	1.263e-307
UWI263P	contig_1	837672	836862	810	renamed_GCF_000008685.2	chromosome	70141	71219	810	99.6	2.744e-180
UWI263P	contig_1	838516	837955	561	renamed_GCF_000008685.2	chromosome	69565	70126	561	100.0	3.775e-118
UWI263P	contig_1	840837	838512	2325	renamed_GCF_000008685.2	chromosome	67247	69569	2325	99.4	0.0
UWI263P	contig_1	842794	842332	462	renamed_GCF_000008685.2	chromosome	65290	65752	462	100.0	3.193e-95
UWI263P	contig_1	844047	842808	1239	renamed_GCF_000008685.2	chromosome	64037	65276	1239	100.0	5.707e-279
UWI263P	contig_1	844938	844056	882	renamed_GCF_000008685.2	chromosome	63146	64028	882	100.0	1.369e-191
UWI263P	contig_1	877059	876600	459	renamed_GCF_000008685.2	chromosome	31026	31479	459	99.3	5.582e-97
UWI263P	contig_1	878546	877064	1482	renamed_GCF_000008685.2	chromosome	29542	31015	1482	97.1	0.0
UWI263P	contig_1	878617	879598	981	renamed_GCF_000008685.2	chromosome	29472	28491	981	99.3	9.688e-221
UWI263P	contig_1	879599	880235	636	renamed_GCF_000008685.2	chromosome	28490	27854	636	99.5	9.161e-138
UWI263P	contig_1	880224	880656	432	renamed_GCF_000008685.2	chromosome	27865	27433	432	100.0	2.641e-92
UWI263P	contig_1	881691	880641	1050	renamed_GCF_000008685.2	chromosome	26398	27448	1050	100.0	7.794e-235
UWI263P	contig_1	882337	881698	639	renamed_GCF_000008685.2	chromosome	25752	26391	639	99.5	1.211e-143
UWI263P	contig_1	882466	883393	927	renamed_GCF_000008685.2	chromosome	25623	24696	927	98.3	7.127e-198
UWI263P	contig_1	883393	884125	732	renamed_GCF_000008685.2	chromosome	24696	23964	732	100.0	2.844e-158
UWI263P	contig_1	885271	884131	1140	renamed_GCF_000008685.2	chromosome	22818	23958	1140	97.8	4.164e-257
UWI263P	contig_2	7957	7027	930	renamed_GCF_000008685.2	cp26	7835	8765	930	98.0	2.319e-202
UWI263P	contig_2	9116	8078	1038	renamed_GCF_000008685.2	cp26	6676	7714	1038	99.4	4.211e-231
UWI263P	contig_2	11024	9926	1098	renamed_GCF_000008685.2	cp26	4768	5866	1098	100.0	2.035e-249
UWI263P	contig_2	11353	11035	318	renamed_GCF_000008685.2	cp26	4481	4757	318	97.8	1.616e-54
UWI263P	contig_2	11709	11361	348	renamed_GCF_000008685.2	cp26	4083	4431	348	99.1	5.329e-71
UWI263P	contig_2	11994	13317	1323	renamed_GCF_000008685.2	cp26	3798	2475	1323	99.5	7.001e-291
UWI263P	contig_2	13604	14954	1350	renamed_GCF_000008685.2	cp26	2186	836	1350	98.8	9.453e-301
UWI263P	contig_2	15039	15486	447	renamed_GCF_000008685.2	cp26	751	307	447	97.2	1.025e-96
UWI263P	contig_2	15748	15469	279	renamed_GCF_000008685.2	cp26	45	324	279	98.9	5.175e-60
UWI263P	contig_3	6459	7236	777	renamed_GCF_000008685.2	cp32-8	25951	25174	777	95.7	5.513e-167
UWI263P	contig_3	7667	7241	426	renamed_GCF_000008685.2	cp32-7	24512	24938	426	100.0	8.056e-96
UWI263P	contig_3	10260	9723	537	renamed_GCF_000008685.2	lp56	25889	26426	537	100.0	1.544e-115
UWI263P	contig_3	18079	17266	813	renamed_GCF_000008685.2	lp56	17822	18638	813	66.9	2.836e-111
UWI263P	contig_3	18694	18088	606	renamed_GCF_000008685.2	lp56	17207	17813	606	99.5	2.704e-129
UWI263P	contig_3	19579	18703	876	renamed_GCF_000008685.2	cp32-8	12823	13699	876	100.0	1.247e-191
UWI263P	contig_3	19908	19575	333	renamed_GCF_000008685.2	cp32-4	12447	12780	333	100.0	8.424e-72
UWI263P	contig_4	1669	1240	429	renamed_GCF_000008685.2	cp32-6	7837	8266	429	100.0	5.601e-92
UWI263P	contig_4	3733	3343	390	renamed_GCF_000008685.2	cp32-4	5777	6167	390	100.0	3.229e-83
UWI263P	contig_4	4104	3720	384	renamed_GCF_000008685.2	lp56	8866	9250	384	100.0	2.931e-83
UWI263P	contig_4	7498	6934	564	renamed_GCF_000008685.2	cp32-6	2009	2573	564	99.4	1.105e-123
UWI263P	contig_4	18839	18098	741	renamed_GCF_000008685.2	cp32-8	20739	21480	741	99.5	5.003e-162
UWI263P	contig_4	20491	19390	1101	renamed_GCF_000008685.2	cp32-3	19604	20705	1101	93.7	2.907e-237
UWI263P	contig_4	20880	21897	1017	renamed_GCF_000008685.2	cp32-7	18728	17711	1017	97.3	2.862e-223
UWI263P	contig_4	22359	21933	426	renamed_GCF_000008685.2	cp32-4	17102	17525	426	87.9	3.813e-79
UWI263P	contig_4	22530	23013	483	renamed_GCF_000008685.2	cp32-6	17075	16592	483	69.29	1.095e-68
UWI263P	contig_4	23503	23149	354	renamed_GCF_000008685.2	cp32-3	16083	16437	354	100.0	1.459e-77
UWI263P	contig_4	23831	23495	336	renamed_GCF_000008685.2	cp32-9	15855	16191	336	100.0	5.348e-69
UWI263P	contig_4	24168	23820	348	renamed_GCF_000008685.2	cp32-3	15418	15766	348	99.1	4.373e-73
UWI263P	contig_5	24269	24698	429	renamed_GCF_000008685.2	cp32-4	7837	8266	429	100.0	5.601e-92
UWI263P	contig_6	8277	8970	693	renamed_GCF_000008685.2	cp32-6	27745	27076	693	27.6	2.503e-09
UWI263P	contig_6	9773	9071	702	renamed_GCF_000008685.2	cp32-7	26151	26841	702	81.59	3.385e-117
UWI263P	contig_6	10204	10981	777	renamed_GCF_000008685.2	cp32-7	25720	24943	777	99.6	3.144e-173
UWI263P	contig_6	11412	10986	426	renamed_GCF_000008685.2	cp32-6	24618	25044	426	100.0	8.056e-96
UWI263P	contig_6	23619	23286	333	renamed_GCF_000008685.2	cp32-6	12513	12846	333	100.0	8.424e-72
UWI263P	contig_6	24194	23648	546	renamed_GCF_000008685.2	cp32-8	11919	12465	546	95.5	5.802e-111
UWI263P	contig_6	25160	24218	942	renamed_GCF_000008685.2	cp32-7	10961	11903	942	98.4	7.211e-209
UWI263P	contig_6	25805	25163	642	renamed_GCF_000008685.2	cp32-7	10316	10958	642	95.7	1.337e-134
UWI263P	contig_6	27155	25817	1338	renamed_GCF_000008685.2	cp32-7	8969	10304	1338	98.2	1.677e-283
UWI263P	contig_6	28294	27865	429	renamed_GCF_000008685.2	cp32-1	7827	8256	429	100.0	5.601e-92
UWI263P	contig_6	29968	29401	567	renamed_GCF_000008685.2	lp56	9623	10190	567	98.9	1.159e-123
UWI263P	contig_8	9323	8987	336	renamed_GCF_000008685.2	cp32-3	15755	16091	336	100.0	5.348e-69
UWI263P	contig_8	9867	9663	204	renamed_GCF_000008685.2	cp32-9	15311	15515	204	100.0	2.578e-39
UWI263P	contig_8	10762	9949	813	renamed_GCF_000008685.2	cp32-4	14276	15092	813	70.2	3.654e-117
UWI263P	contig_8	12591	12258	333	renamed_GCF_000008685.2	cp32-1	12494	12827	333	100.0	8.424e-72
UWI263P	contig_8	13175	12620	555	renamed_GCF_000008685.2	cp32-6	11929	12484	555	100.0	3.12e-119
UWI263P	contig_8	21093	20133	960	renamed_GCF_000008685.2	cp32-1	3962	4922	960	98.4	3.919e-210
UWI263P	contig_8	22486	21718	768	renamed_GCF_000008685.2	cp32-6	2576	3344	768	98.8	8.033e-170
UWI263P	contig_8	23757	23064	693	renamed_GCF_000008685.2	cp32-3	1305	1998	693	100.0	2.582e-144
UWI263P	contig_8	24997	23773	1224	renamed_GCF_000008685.2	cp32-1	65	1289	1224	99.7	4.655e-270
UWI263P	contig_8	26415	25062	1353	renamed_GCF_000008685.2	cp32-6	28485	29838	1353	99.5	3.089e-305
UWI263P	contig_8	26978	26411	567	renamed_GCF_000008685.2	cp32-7	28884	29451	567	100.0	5.734e-123
UWI263P	contig_8	27687	27159	528	renamed_GCF_000008685.2	cp32-4	27675	28203	528	90.2	1.565e-105
UWI263P	contig_9	12425	12983	558	renamed_GCF_000008685.2	cp32-9	26209	26770	558	85.0	3.671e-101
UWI263P	contig_9	13010	14141	1131	renamed_GCF_000008685.2	cp32-9	26797	27829	1131	63.0	6.242e-136
UWI263P	contig_9	16121	17411	1290	renamed_GCF_000008685.2	cp32-4	8977	10273	1290	81.49	7.054e-224
UWI263P	contig_9	17432	18116	684	renamed_GCF_000008685.2	lp56	13754	14438	684	95.5	5.476e-143
UWI263P	contig_10	7881	7596	285	renamed_GCF_000008685.2	cp9	4788	4503	285	96.8	6.987e-58
UWI263P	contig_11	781	1012	231	renamed_GCF_000008685.2	lp17	16119	15888	231	98.6	8.774e-47
UWI263P	contig_11	2830	2560	270	renamed_GCF_000008685.2	lp17	14069	14339	270	100.0	1.489e-55
UWI263P	contig_11	3561	2820	741	renamed_GCF_000008685.2	lp17	13338	14079	741	100.0	7.64e-166
UWI263P	contig_11	5258	5921	663	renamed_GCF_000008685.2	lp17	11646	10983	663	100.0	1.005e-149
UWI263P	contig_11	6777	7071	294	renamed_GCF_000008685.2	lp17	9980	9590	294	95.8	5.989e-61
UWI263P	contig_11	8398	7285	1113	renamed_GCF_000008685.2	lp17	8266	9379	1113	93.7	5.062e-233
UWI263P	contig_11	8880	8553	327	renamed_GCF_000008685.2	lp17	7784	8111	327	100.0	1.029e-68
UWI263P	contig_11	10211	10790	579	renamed_GCF_000008685.2	lp17	6452	5873	579	99.4	1.16e-125
UWI263P	contig_11	11619	10935	684	renamed_GCF_000008685.2	lp17	5055	5739	684	99.5	1.274e-150
UWI263P	contig_12	20271	19539	732	renamed_GCF_000008685.2	lp25	22677	21945	732	83.1	7.896e-130
UWI263P	contig_12	22756	22252	504	renamed_GCF_000008685.2	lp56	3622	4108	504	93.0	3.962e-83
UWI263P	contig_12	23801	22931	870	renamed_GCF_000008685.2	lp28-2	1046	1928	870	97.9	2.768e-190
UWI263P	contig_12	24744	23850	894	renamed_GCF_000008685.2	lp28-2	115	1009	894	98.9	1.652e-191
UWI263P	contig_13	1208	80	1128	renamed_GCF_000008685.2	lp28-1	26996	28073	1128	54.3	3.318e-105
UWI263P	contig_14	274	865	591	renamed_GCF_000008685.2	lp56	52608	52134	591	98.7	7.4e-99
UWI263P	contig_14	1051	1375	324	renamed_GCF_000008685.2	lp28-3	1044	1368	324	99.0	8.87e-70
UWI263P	contig_14	2976	2265	711	renamed_GCF_000008685.2	lp28-3	2970	2259	711	98.7	4.333e-150
UWI263P	contig_14	7731	3894	3837	renamed_GCF_000008685.2	lp28-3	7728	3891	3837	99.8	0.0
UWI263P	contig_14	8207	8003	204	renamed_GCF_000008685.2	lp36	17379	17583	204	82.0	8.778e-35
UWI263P	contig_14	10512	9843	669	renamed_GCF_000008685.2	lp28-3	10516	9847	669	99.5	5.739e-140
UWI263P	contig_14	15132	15342	210	renamed_GCF_000008685.2	lp28-2	22259	19619	210	52.8	1.99e-13
UWI263P	contig_14	16516	17425	909	renamed_GCF_000008685.2	lp28-3	16518	17415	909	98.6	9.928e-200
UWI263P	contig_15	3863	4730	867	renamed_GCF_000008685.2	lp28-4	25089	24222	867	96.1	1.236e-181
UWI263P	contig_15	4957	5794	837	renamed_GCF_000008685.2	lp28-4	22931	22094	837	98.9	7.731e-182
UWI263P	contig_15	6326	7079	753	renamed_GCF_000008685.2	lp28-4	21562	20770	753	97.9	1.343e-161
UWI263P	contig_15	8705	9371	666	renamed_GCF_000008685.2	lp28-4	19183	18517	666	99.5	1.537e-145
UWI263P	contig_15	12531	11352	1179	renamed_GCF_000008685.2	lp28-4	15351	16530	1179	99.2	5.451e-252
UWI263P	contig_15	14621	14048	573	renamed_GCF_000008685.2	lp28-4	13264	13837	573	100.0	2.579e-124
UWI263P	contig_15	29357	28592	765	renamed_GCF_000008685.2	lp28-2	29618	28853	765	75.9	7.774e-127
UWI263P	contig_16	303	684	381	renamed_GCF_000008685.2	lp28-4	173	608	381	68.0	3.224e-49
UWI263P	contig_16	781	1135	354	renamed_GCF_000008685.2	lp5	743	1097	354	99.1	7.983e-76
UWI263P	contig_16	1203	1572	369	renamed_GCF_000008685.2	lp5	1207	1576	369	91.8	3.043e-72
UWI263P	contig_17	335	581	246	renamed_GCF_000008685.2	lp21	16548	16227	246	90.7	5.597e-46
UWI263P	contig_17	888	1440	552	renamed_GCF_000008685.2	lp56	855	1407	552	96.7	3.6e-117
UWI263P	contig_17	1436	2285	849	renamed_GCF_000008685.2	lp36	35443	34594	849	98.2	2.634e-187
UWI263P	contig_17	3226	3568	342	renamed_GCF_000008685.2	lp28-3	8017	8431	342	61.5	0.0002439
UWI263P	contig_17	5329	5035	294	renamed_GCF_000008685.2	lp28-1	10895	10697	294	98.4	2.041e-40
UWI263P	contig_17	16851	16452	399	renamed_GCF_000008685.2	lp36	9372	9999	399	99.1	1.114e-79
UWI263P	contig_17	17364	18060	696	renamed_GCF_000008685.2	lp36	8859	8163	696	97.8	8.359e-149
UWI263P	contig_17	19852	19576	276	renamed_GCF_000008685.2	lp36	6365	6650	276	98.9	6.026e-58
UWI263P	contig_17	20186	20939	753	renamed_GCF_000008685.2	lp36	6040	5287	753	99.6	3.6e-159
UWI263P	contig_18	7959	7152	807	renamed_GCF_000008685.2	lp56	2743	3496	807	55.3	2.863e-83
UWI263P	contig_18	12516	12225	291	renamed_GCF_000008685.2	lp5	4387	4819	291	64.8	7.26e-35
UWI263P	contig_18	25679	26273	594	renamed_GCF_000008685.2	lp38	11105	10517	594	89.3	1.877e-114
UWI263P	contig_18	28753	27667	1086	renamed_GCF_000008685.2	lp38	26407	25336	1086	71.9	9.594e-160
UWI263P	contig_19	972	174	798	renamed_GCF_000008685.2	lp54	52705	53503	798	99.2	6.687e-177
UWI263P	contig_19	1972	1198	774	renamed_GCF_000008685.2	lp54	51705	52479	774	100.0	9.219e-161
UWI263P	contig_19	2501	3392	891	renamed_GCF_000008685.2	lp54	51176	50285	891	98.9	9.9e-197
UWI263P	contig_19	3600	3825	225	renamed_GCF_000008685.2	lp54	50077	49852	225	98.6	4.854e-44
UWI263P	contig_19	4462	5254	792	renamed_GCF_000008685.2	lp54	48267	47475	792	99.2	2.37e-170
UWI263P	contig_19	17598	17331	267	renamed_GCF_000008685.2	lp54	36255	36534	267	98.8	1.568e-54
UWI263P	contig_19	17912	17636	276	renamed_GCF_000008685.2	lp54	35953	36229	276	100.0	3.31e-56
UWI263P	contig_19	18878	18032	846	renamed_GCF_000008685.2	lp54	34987	35833	846	98.9	6.73e-185
UWI263P	contig_19	19481	18917	564	renamed_GCF_000008685.2	lp54	34384	34948	564	99.4	3.599e-119
UWI263P	contig_19	21124	20905	219	renamed_GCF_000008685.2	lp54	32741	32960	219	98.6	1.775e-45
UWI263P	contig_19	21605	21116	489	renamed_GCF_000008685.2	lp54	32260	32749	489	100.0	3.125e-108
UWI263P	contig_19	22086	21663	423	renamed_GCF_000008685.2	lp54	31779	32202	423	100.0	5.086e-92
UWI263P	contig_19	23156	22085	1071	renamed_GCF_000008685.2	lp54	30709	31780	1071	99.7	4.869e-235
UWI263P	contig_19	23772	23232	540	renamed_GCF_000008685.2	lp54	30093	30633	540	100.0	4.969e-120
UWI263P	contig_19	24482	24107	375	renamed_GCF_000008685.2	lp54	29383	29758	375	100.0	1.685e-79
UWI263P	contig_19	24931	24478	453	renamed_GCF_000008685.2	lp54	28934	29387	453	100.0	2.51e-96
UWI263P	contig_19	25852	24934	918	renamed_GCF_000008685.2	lp54	28013	28931	918	100.0	2.109e-201
UWI263P	contig_19	26476	25867	609	renamed_GCF_000008685.2	lp54	27389	27998	609	100.0	2.346e-131
UWI263P	contig_19	28403	27161	1242	renamed_GCF_000008685.2	lp54	25467	26694	1242	100.0	1.5e-268
UWI263P	contig_19	29358	28752	606	renamed_GCF_000008685.2	lp54	24497	25103	606	98.5	3.594e-126
UWI263P	contig_19	39491	38945	546	renamed_GCF_000008685.2	lp54	14337	14883	546	100.0	1.338e-118
UWI263P	contig_19	40274	39521	753	renamed_GCF_000008685.2	lp54	13554	14307	753	100.0	4.561e-165
UWI263P	contig_19	40834	40249	585	renamed_GCF_000008685.2	lp54	12994	13579	585	99.4	8.719e-130
UWI263P	contig_19	43613	42722	891	renamed_GCF_000008685.2	lp54	10287	11178	891	99.3	4.629e-188
UWI263P	contig_19	44444	43622	822	renamed_GCF_000008685.2	lp54	9456	10278	822	98.9	1.553e-171
UWI263P	contig_19	45459	45033	426	renamed_GCF_000008685.2	lp54	8441	8867	426	100.0	3.21e-89
UWI263P	contig_19	45635	45455	180	renamed_GCF_000008685.2	lp54	8265	8445	180	100.0	1.452e-33
UWI263P	contig_19	46692	45657	1035	renamed_GCF_000008685.2	lp54	7208	8243	1035	100.0	8.138e-232