QUERY_ID	QUERY_NAME	QUERY_START	QUERY_END	QUERY_LENGTH	REF_ID	REF_NAME	REF_START	REF_END	REF_LENGTH	IDENTITY	EVALUE
URI41H	contig_1	22739	22145	594	renamed_GCF_000008685.2	chromosome	22739	22145	594	100.0	3.27e-125
URI41H	contig_1	25623	24696	927	renamed_GCF_000008685.2	chromosome	25623	24696	927	100.0	1.199e-200
URI41H	contig_1	25752	26391	639	renamed_GCF_000008685.2	chromosome	25752	26391	639	100.0	1.211e-143
URI41H	contig_1	27865	27433	432	renamed_GCF_000008685.2	chromosome	27865	27433	432	100.0	2.641e-92
URI41H	contig_1	29472	28491	981	renamed_GCF_000008685.2	chromosome	29472	28491	981	100.0	8.047e-223
URI41H	contig_1	31026	31479	453	renamed_GCF_000008685.2	chromosome	31026	31479	453	100.0	2.279e-97
URI41H	contig_1	34037	32156	1881	renamed_GCF_000008685.2	chromosome	34037	32156	1881	100.0	0.0
URI41H	contig_1	36609	35856	753	renamed_GCF_000008685.2	chromosome	36609	35856	753	100.0	1.343e-161
URI41H	contig_1	39825	40677	852	renamed_GCF_000008685.2	chromosome	39825	40677	852	100.0	1.031e-189
URI41H	contig_1	93422	92876	546	renamed_GCF_000008685.2	chromosome	93423	92877	546	100.0	2.704e-119
URI41H	contig_1	94604	94217	387	renamed_GCF_000008685.2	chromosome	94605	94218	387	100.0	1.031e-86
URI41H	contig_1	97865	96941	924	renamed_GCF_000008685.2	chromosome	97866	96942	924	100.0	7.888e-205
URI41H	contig_1	98815	100204	1389	renamed_GCF_000008685.2	chromosome	98816	100205	1389	100.0	9.726e-316
URI41H	contig_1	101338	100744	594	renamed_GCF_000008685.2	chromosome	101339	100745	594	100.0	6.255e-135
URI41H	contig_1	112768	112348	420	renamed_GCF_000008685.2	chromosome	112769	112349	420	100.0	6.488e-89
URI41H	contig_1	114805	115507	702	renamed_GCF_000008685.2	chromosome	114806	115508	702	100.0	2.35e-155
URI41H	contig_1	118928	118373	555	renamed_GCF_000008685.2	chromosome	118929	118374	555	100.0	1.543e-118
URI41H	contig_1	120588	119805	783	renamed_GCF_000008685.2	chromosome	120589	119806	783	100.0	5.024e-169
URI41H	contig_1	157627	158062	435	renamed_GCF_000008685.2	chromosome	157626	158061	435	100.0	6.167e-92
URI41H	contig_1	181406	179540	1866	renamed_GCF_000008685.2	chromosome	181405	179539	1866	100.0	0.0
URI41H	contig_1	182886	183381	495	renamed_GCF_000008685.2	chromosome	182885	183380	495	100.0	9.271e-106
URI41H	contig_1	186554	186947	393	renamed_GCF_000008685.2	chromosome	186553	186946	393	100.0	5.626e-86
URI41H	contig_1	187832	187178	654	renamed_GCF_000008685.2	chromosome	187831	187177	654	100.0	1.397e-144
URI41H	contig_1	188495	188234	261	renamed_GCF_000008685.2	chromosome	188494	188233	261	100.0	7.054e-54
URI41H	contig_1	202579	201052	1527	renamed_GCF_000008685.2	chromosome	202578	201051	1527	100.0	0.0
URI41H	contig_1	204137	205073	936	renamed_GCF_000008685.2	chromosome	204136	205072	936	100.0	4.7e-204
URI41H	contig_1	206529	208107	1578	renamed_GCF_000008685.2	chromosome	206528	208106	1578	100.0	0.0
URI41H	contig_1	254945	255650	705	renamed_GCF_000008685.2	chromosome	254944	255649	705	100.0	7.263e-152
URI41H	contig_1	255646	256261	615	renamed_GCF_000008685.2	chromosome	255645	256260	615	100.0	1.16e-131
URI41H	contig_1	263988	266115	2127	renamed_GCF_000008685.2	chromosome	263987	266114	2127	100.0	0.0
URI41H	contig_1	267066	267276	210	renamed_GCF_000008685.2	chromosome	267065	267275	210	100.0	4.647e-42
URI41H	contig_1	270474	269673	801	renamed_GCF_000008685.2	chromosome	270473	269672	801	100.0	6.66e-169
URI41H	contig_1	283866	282699	1167	renamed_GCF_000008685.2	chromosome	283865	282698	1167	100.0	1.172e-258
URI41H	contig_1	287090	285971	1119	renamed_GCF_000008685.2	chromosome	287089	285970	1119	100.0	9.957e-244
URI41H	contig_1	288174	287910	264	renamed_GCF_000008685.2	chromosome	288173	287909	264	100.0	2.025e-51
URI41H	contig_1	289584	288957	627	renamed_GCF_000008685.2	chromosome	289583	288956	627	100.0	2.836e-132
URI41H	contig_1	291022	289963	1059	renamed_GCF_000008685.2	chromosome	291021	289962	1059	100.0	3.164e-229
URI41H	contig_1	300765	299730	1035	renamed_GCF_000008685.2	chromosome	300764	299729	1035	100.0	3.255e-216
URI41H	contig_1	302837	302504	333	renamed_GCF_000008685.2	chromosome	302839	302503	333	99.0	1.253e-67
URI41H	contig_1	305121	303774	1347	renamed_GCF_000008685.2	chromosome	305120	303773	1347	100.0	1.016e-290
URI41H	contig_1	305662	305113	549	renamed_GCF_000008685.2	chromosome	305661	305112	549	100.0	9.24e-115
URI41H	contig_1	307318	306625	693	renamed_GCF_000008685.2	chromosome	307317	306624	693	100.0	2.971e-151
URI41H	contig_1	319118	318278	840	renamed_GCF_000008685.2	chromosome	319116	318276	840	99.6	1.977e-180
URI41H	contig_1	320260	319681	579	renamed_GCF_000008685.2	chromosome	320249	319679	579	99.4	6.936e-123
URI41H	contig_1	322848	322041	807	renamed_GCF_000008685.2	chromosome	322846	322039	807	99.6	2.064e-174
URI41H	contig_1	325238	323777	1461	renamed_GCF_000008685.2	chromosome	325236	323775	1461	100.0	0.0
URI41H	contig_1	327729	326700	1029	renamed_GCF_000008685.2	chromosome	327757	326698	1029	99.7	7.409e-232
URI41H	contig_1	343209	344181	972	renamed_GCF_000008685.2	chromosome	343207	344179	972	100.0	3.579e-213
URI41H	contig_1	346843	346432	411	renamed_GCF_000008685.2	chromosome	346841	346430	411	100.0	6.821e-87
URI41H	contig_1	348162	347352	810	renamed_GCF_000008685.2	chromosome	348160	347350	810	100.0	1.888e-184
URI41H	contig_1	351050	349601	1449	renamed_GCF_000008685.2	chromosome	351045	349599	1449	99.7	6.4e-322
URI41H	contig_1	365082	364131	951	renamed_GCF_000008685.2	chromosome	364972	364129	951	99.6	1.174e-187
URI41H	contig_1	366962	366230	732	renamed_GCF_000008685.2	chromosome	366960	366228	732	100.0	5.239e-160
URI41H	contig_1	368886	370029	1143	renamed_GCF_000008685.2	chromosome	368884	370027	1143	100.0	3.212e-243
URI41H	contig_1	371035	373048	2013	renamed_GCF_000008685.2	chromosome	371033	373046	2013	100.0	0.0
URI41H	contig_1	385450	386164	714	renamed_GCF_000008685.2	chromosome	385448	386162	714	100.0	3.427e-153
URI41H	contig_1	386160	387339	1179	renamed_GCF_000008685.2	chromosome	386158	387337	1179	100.0	1.981e-263
URI41H	contig_1	387335	387809	474	renamed_GCF_000008685.2	chromosome	387333	387807	474	100.0	1.339e-106
URI41H	contig_1	388482	387819	663	renamed_GCF_000008685.2	chromosome	388480	387817	663	100.0	4.965e-149
URI41H	contig_1	388928	388508	420	renamed_GCF_000008685.2	chromosome	388926	388506	420	100.0	9.787e-93
URI41H	contig_1	390343	388978	1365	renamed_GCF_000008685.2	chromosome	390341	388976	1365	99.5	7.255e-289
URI41H	contig_1	391821	390396	1425	renamed_GCF_000008685.2	chromosome	391819	390391	1425	100.0	0.0
URI41H	contig_1	392959	391933	1026	renamed_GCF_000008685.2	chromosome	392957	391931	1026	100.0	1.232e-225
URI41H	contig_1	394065	393045	1020	renamed_GCF_000008685.2	chromosome	394063	393043	1020	99.7	1.481e-222
URI41H	contig_1	395168	394106	1062	renamed_GCF_000008685.2	chromosome	395166	394104	1062	100.0	1.904e-235
URI41H	contig_1	408094	407923	171	renamed_GCF_000008685.2	chromosome	408092	407921	171	100.0	1.118e-34
URI41H	contig_1	408382	408202	180	renamed_GCF_000008685.2	chromosome	408380	408200	180	100.0	2.118e-37
URI41H	contig_1	409404	408555	849	renamed_GCF_000008685.2	chromosome	409402	408553	849	100.0	9.834e-190
URI41H	contig_1	410449	409417	1032	renamed_GCF_000008685.2	chromosome	410447	409415	1032	100.0	9.895e-238
URI41H	contig_1	410788	411448	660	renamed_GCF_000008685.2	chromosome	410786	411446	660	100.0	1.008e-140
URI41H	contig_1	413002	411457	1545	renamed_GCF_000008685.2	chromosome	413006	411455	1545	99.8	0.0
URI41H	contig_1	413114	414317	1203	renamed_GCF_000008685.2	chromosome	413112	414315	1203	100.0	6.394e-263
URI41H	contig_1	415795	414328	1467	renamed_GCF_000008685.2	chromosome	415793	414326	1467	100.0	0.0
URI41H	contig_1	416525	415847	678	renamed_GCF_000008685.2	chromosome	416478	415845	678	99.5	1.008e-143
URI41H	contig_1	416690	417107	417	renamed_GCF_000008685.2	chromosome	416688	417105	417	100.0	1.248e-89
URI41H	contig_1	426739	427954	1215	renamed_GCF_000008685.2	chromosome	426735	427950	1215	100.0	1.711e-262
URI41H	contig_1	427990	428626	636	renamed_GCF_000008685.2	chromosome	427986	428622	636	100.0	3.41e-140
URI41H	contig_1	428649	429678	1029	renamed_GCF_000008685.2	chromosome	428645	429674	1029	100.0	3.872e-239
URI41H	contig_1	430620	429696	924	renamed_GCF_000008685.2	chromosome	430616	429692	924	100.0	4.275e-203
URI41H	contig_1	435107	430622	4485	renamed_GCF_000008685.2	chromosome	435103	430618	4485	100.0	0.0
URI41H	contig_1	442556	441716	840	renamed_GCF_000008685.2	chromosome	442552	441712	840	100.0	1.361e-184
URI41H	contig_1	443252	442691	561	renamed_GCF_000008685.2	chromosome	443248	442687	561	100.0	1.054e-123
URI41H	contig_1	446879	446330	549	renamed_GCF_000008685.2	chromosome	446875	446326	549	100.0	4.738e-122
URI41H	contig_1	447764	446972	792	renamed_GCF_000008685.2	chromosome	447736	446968	792	99.6	3.782e-165
URI41H	contig_1	459528	459828	300	renamed_GCF_000008685.2	chromosome	459524	459824	300	100.0	7.304e-60
URI41H	contig_1	459919	460075	156	renamed_GCF_000008685.2	chromosome	459915	460071	156	100.0	2.965e-30
URI41H	contig_1	460055	460415	360	renamed_GCF_000008685.2	chromosome	460051	460411	360	100.0	4.812e-74
URI41H	contig_1	462048	462777	729	renamed_GCF_000008685.2	chromosome	462044	462773	729	100.0	2.248e-160
URI41H	contig_1	462822	463890	1068	renamed_GCF_000008685.2	chromosome	462818	463886	1068	100.0	4.491e-244
URI41H	contig_1	464056	465136	1080	renamed_GCF_000008685.2	chromosome	464052	465132	1080	100.0	9.122e-247
URI41H	contig_1	467282	465521	1761	renamed_GCF_000008685.2	chromosome	467278	465517	1761	100.0	0.0
URI41H	contig_1	469391	467285	2106	renamed_GCF_000008685.2	chromosome	469387	467281	2106	100.0	0.0
URI41H	contig_1	469669	469393	276	renamed_GCF_000008685.2	chromosome	469665	469389	276	100.0	1.644e-55
URI41H	contig_1	497898	498195	297	renamed_GCF_000008685.2	chromosome	497894	498191	297	100.0	5.69e-62
URI41H	contig_1	498216	499050	834	renamed_GCF_000008685.2	chromosome	498212	499046	834	100.0	1.895e-188
URI41H	contig_1	499059	499338	279	renamed_GCF_000008685.2	chromosome	499055	499334	279	100.0	1.411e-57
URI41H	contig_1	499344	499707	363	renamed_GCF_000008685.2	chromosome	499340	499703	363	100.0	3.407e-78
URI41H	contig_1	499710	500592	882	renamed_GCF_000008685.2	chromosome	499706	500588	882	100.0	1.248e-192
URI41H	contig_1	500596	501013	417	renamed_GCF_000008685.2	chromosome	500592	501009	417	100.0	2.778e-89
URI41H	contig_1	501015	501216	201	renamed_GCF_000008685.2	chromosome	501014	501212	201	98.4	1.098e-39
URI41H	contig_1	501218	501473	255	renamed_GCF_000008685.2	chromosome	501214	501469	255	100.0	1.745e-51
URI41H	contig_1	501500	501869	369	renamed_GCF_000008685.2	chromosome	501496	501865	369	100.0	9.223e-77
URI41H	contig_1	501883	502189	306	renamed_GCF_000008685.2	chromosome	501879	502185	306	100.0	2.959e-62
URI41H	contig_1	534300	535155	855	renamed_GCF_000008685.2	chromosome	534300	535155	855	100.0	8.967e-192
URI41H	contig_1	535600	535177	423	renamed_GCF_000008685.2	chromosome	535600	535177	423	100.0	5.606e-91
URI41H	contig_1	535703	537527	1824	renamed_GCF_000008685.2	chromosome	535703	537527	1824	100.0	0.0
URI41H	contig_1	537519	538308	789	renamed_GCF_000008685.2	chromosome	537543	538308	789	99.6	2.994e-167
URI41H	contig_1	539275	538327	948	renamed_GCF_000008685.2	chromosome	539275	538327	948	100.0	1.008e-214
URI41H	contig_1	542262	543024	762	renamed_GCF_000008685.2	chromosome	542262	543024	762	100.0	5.516e-173
URI41H	contig_1	543048	543816	768	renamed_GCF_000008685.2	chromosome	543048	543816	768	100.0	8.433e-178
URI41H	contig_1	577393	577936	543	renamed_GCF_000008685.2	chromosome	577394	577937	543	100.0	3.121e-117
URI41H	contig_1	577948	578260	312	renamed_GCF_000008685.2	chromosome	577949	578261	312	100.0	5.387e-65
URI41H	contig_1	578275	580420	2145	renamed_GCF_000008685.2	chromosome	578276	580421	2145	100.0	0.0
URI41H	contig_1	580484	581642	1158	renamed_GCF_000008685.2	chromosome	580485	581643	1158	100.0	7.971e-253
URI41H	contig_1	581643	583416	1773	renamed_GCF_000008685.2	chromosome	581644	583417	1773	100.0	0.0
URI41H	contig_1	583456	583831	375	renamed_GCF_000008685.2	chromosome	583457	583832	375	100.0	8.349e-79
URI41H	contig_1	584879	584189	690	renamed_GCF_000008685.2	chromosome	584880	584190	690	100.0	9.609e-155
URI41H	contig_1	585090	586155	1065	renamed_GCF_000008685.2	chromosome	585079	586156	1065	99.7	1.659e-237
URI41H	contig_1	587029	587881	852	renamed_GCF_000008685.2	chromosome	587030	587882	852	100.0	3.506e-193
URI41H	contig_1	630767	631985	1218	renamed_GCF_000008685.2	chromosome	630795	631986	1218	99.7	8.847e-262
URI41H	contig_1	631989	632481	492	renamed_GCF_000008685.2	chromosome	631990	632482	492	100.0	1.786e-106
URI41H	contig_1	632483	634463	1980	renamed_GCF_000008685.2	chromosome	632484	634464	1980	100.0	0.0
URI41H	contig_1	634579	636010	1431	renamed_GCF_000008685.2	chromosome	634580	636011	1431	100.0	1.295e-319
URI41H	contig_1	636590	637955	1365	renamed_GCF_000008685.2	chromosome	636592	637957	1365	100.0	3.184e-298
URI41H	contig_1	637960	638554	594	renamed_GCF_000008685.2	chromosome	637971	638556	594	100.0	1.47e-125
URI41H	contig_1	638577	639870	1293	renamed_GCF_000008685.2	chromosome	638579	639872	1293	100.0	3.129e-286
URI41H	contig_1	639838	642247	2409	renamed_GCF_000008685.2	chromosome	639858	642249	2409	100.0	0.0
URI41H	contig_1	642286	642439	153	renamed_GCF_000008685.2	chromosome	642288	642441	153	100.0	5.64e-31
URI41H	contig_1	643124	642497	627	renamed_GCF_000008685.2	chromosome	643126	642499	627	100.0	8.735e-137
URI41H	contig_1	686504	685973	531	renamed_GCF_000008685.2	chromosome	686507	685976	531	100.0	1.053e-118
URI41H	contig_1	688486	690124	1638	renamed_GCF_000008685.2	chromosome	688489	690127	1638	100.0	0.0
URI41H	contig_1	690189	690486	297	renamed_GCF_000008685.2	chromosome	690192	690489	297	100.0	1.037e-63
URI41H	contig_1	690499	690796	297	renamed_GCF_000008685.2	chromosome	690481	690799	297	98.9	6.955e-60
URI41H	contig_1	690881	692642	1761	renamed_GCF_000008685.2	chromosome	690884	692645	1761	100.0	0.0
URI41H	contig_1	692625	693525	900	renamed_GCF_000008685.2	chromosome	692628	693528	900	100.0	8.957e-191
URI41H	contig_1	693550	694693	1143	renamed_GCF_000008685.2	chromosome	693553	694696	1143	100.0	3.979e-258
URI41H	contig_1	695520	694689	831	renamed_GCF_000008685.2	chromosome	695523	694692	831	100.0	5.839e-184
URI41H	contig_1	695627	696761	1134	renamed_GCF_000008685.2	chromosome	695630	696764	1134	100.0	1.419e-259
URI41H	contig_1	771136	769543	1593	renamed_GCF_000008685.2	chromosome	771139	769546	1593	100.0	0.0
URI41H	contig_1	771560	771158	402	renamed_GCF_000008685.2	chromosome	771563	771161	402	100.0	3.917e-83
URI41H	contig_1	774365	771566	2799	renamed_GCF_000008685.2	chromosome	774368	771569	2799	100.0	0.0
URI41H	contig_1	774673	775459	786	renamed_GCF_000008685.2	chromosome	774676	775462	786	100.0	1.17e-168
URI41H	contig_1	776676	775662	1014	renamed_GCF_000008685.2	chromosome	776679	775665	1014	100.0	1.623e-220
URI41H	contig_1	776781	777570	789	renamed_GCF_000008685.2	chromosome	776784	777573	789	100.0	8.439e-173
URI41H	contig_1	777761	778751	990	renamed_GCF_000008685.2	chromosome	777764	778754	990	100.0	1.559e-225
URI41H	contig_1	778754	781382	2628	renamed_GCF_000008685.2	chromosome	778757	781385	2628	100.0	0.0
URI41H	contig_1	782826	782148	678	renamed_GCF_000008685.2	chromosome	782829	782151	678	100.0	4.744e-152
URI41H	contig_1	830948	830324	624	renamed_GCF_000008685.2	chromosome	830941	830317	624	100.0	5.187e-142
URI41H	contig_1	831570	830961	609	renamed_GCF_000008685.2	chromosome	831563	830954	609	100.0	7.938e-135
URI41H	contig_1	836067	838533	2466	renamed_GCF_000008685.2	chromosome	836060	838526	2466	100.0	0.0
URI41H	contig_1	838553	839087	534	renamed_GCF_000008685.2	chromosome	838546	839080	534	100.0	7.282e-115
URI41H	contig_1	839250	841839	2589	renamed_GCF_000008685.2	chromosome	839243	841832	2589	100.0	0.0
URI41H	contig_1	841840	842458	618	renamed_GCF_000008685.2	chromosome	841833	842451	618	100.0	1.393e-138
URI41H	contig_1	842558	842996	438	renamed_GCF_000008685.2	chromosome	842500	842989	438	99.3	1.307e-92
URI41H	contig_1	843009	844458	1449	renamed_GCF_000008685.2	chromosome	843002	844451	1449	100.0	7.712e-320
URI41H	contig_1	844460	847109	2649	renamed_GCF_000008685.2	chromosome	844453	847102	2649	100.0	0.0
URI41H	contig_1	860118	858945	1173	renamed_GCF_000008685.2	chromosome	860111	858938	1173	100.0	1.287e-258
URI41H	contig_1	860446	861781	1335	renamed_GCF_000008685.2	chromosome	860439	861774	1335	100.0	8.434e-291
URI41H	contig_1	862706	863654	948	renamed_GCF_000008685.2	chromosome	862698	863646	948	100.0	4.292e-207
URI41H	contig_1	863643	865050	1407	renamed_GCF_000008685.2	chromosome	863635	865042	1407	100.0	1.287e-315
URI41H	contig_1	865069	865927	858	renamed_GCF_000008685.2	chromosome	865052	865919	858	100.0	6.741e-187
URI41H	contig_1	865923	866466	543	renamed_GCF_000008685.2	chromosome	865915	866458	543	100.0	2.343e-120
URI41H	contig_1	866501	866702	201	renamed_GCF_000008685.2	chromosome	866493	866694	201	100.0	2.206e-40
URI41H	contig_1	866688	867609	921	renamed_GCF_000008685.2	chromosome	866680	867601	921	100.0	3.086e-206
URI41H	contig_1	868122	867750	372	renamed_GCF_000008685.2	chromosome	868114	867742	372	100.0	7.954e-79
URI41H	contig_2	16471	16819	348	renamed_GCF_000008685.2	cp32-1	15421	15769	348	100.0	3.962e-74
URI41H	contig_2	16808	17144	336	renamed_GCF_000008685.2	lp56	19256	19592	336	100.0	5.348e-69
URI41H	contig_2	17136	17490	354	renamed_GCF_000008685.2	lp56	19584	19938	354	100.0	1.459e-77
URI41H	contig_2	18277	18889	612	renamed_GCF_000008685.2	lp56	20843	21455	612	100.0	1.152e-139
URI41H	contig_2	19913	18965	948	renamed_GCF_000008685.2	lp56	22479	21531	948	100.0	7.628e-218
URI41H	contig_2	20302	21400	1098	renamed_GCF_000008685.2	lp56	22868	23966	1098	100.0	9.161e-250
URI41H	contig_2	21409	21976	567	renamed_GCF_000008685.2	lp56	23975	24542	567	100.0	1.456e-129
URI41H	contig_2	21951	22707	756	renamed_GCF_000008685.2	lp56	24517	25273	756	100.0	1.063e-164
URI41H	contig_2	39517	39973	456	renamed_GCF_000008685.2	cp32-6	8281	8737	456	100.0	1.971e-99
URI41H	contig_2	39969	40206	237	renamed_GCF_000008685.2	cp32-3	8723	8960	237	100.0	7.893e-49
URI41H	contig_2	40213	41488	1275	renamed_GCF_000008685.2	cp32-3	8967	10242	1275	100.0	2.667e-276
URI41H	contig_2	41510	42194	684	renamed_GCF_000008685.2	cp32-3	10264	10948	684	99.5	3.113e-149
URI41H	contig_2	42197	43148	951	renamed_GCF_000008685.2	cp32-3	10951	11902	951	100.0	4.333e-216
URI41H	contig_2	43165	43720	555	renamed_GCF_000008685.2	cp32-4	11863	12418	555	100.0	3.12e-119
URI41H	contig_2	43749	44082	333	renamed_GCF_000008685.2	cp32-8	12494	12827	333	100.0	8.424e-72
URI41H	contig_2	44078	44954	876	renamed_GCF_000008685.2	cp32-3	12823	13699	876	100.0	5.609e-192
URI41H	contig_2	44963	45569	606	renamed_GCF_000008685.2	cp32-8	13708	14314	606	100.0	5.47e-130
URI41H	contig_2	45578	46391	813	renamed_GCF_000008685.2	cp32-8	14323	15139	813	98.1	2.489e-173
URI41H	contig_3	17249	16685	564	renamed_GCF_000008685.2	lp54	17259	16695	564	100.0	1.065e-115
URI41H	contig_3	18117	18711	594	renamed_GCF_000008685.2	lp54	18127	18721	594	100.0	1.47e-125
URI41H	contig_3	18714	20067	1353	renamed_GCF_000008685.2	lp54	18724	20077	1353	100.0	1.524e-304
URI41H	contig_3	20707	20902	195	renamed_GCF_000008685.2	lp54	20717	20912	195	100.0	2.214e-39
URI41H	contig_3	21076	21616	540	renamed_GCF_000008685.2	lp54	21086	21626	540	100.0	8.011e-115
URI41H	contig_3	23263	21673	1590	renamed_GCF_000008685.2	lp54	23273	21683	1590	100.0	0.0
URI41H	contig_3	23766	24405	639	renamed_GCF_000008685.2	lp54	23776	24415	639	100.0	9.606e-138
URI41H	contig_3	24487	25093	606	renamed_GCF_000008685.2	lp54	24497	25103	606	100.0	6.612e-128
URI41H	contig_3	25442	26684	1242	renamed_GCF_000008685.2	lp54	25467	26694	1242	100.0	1.5e-268
URI41H	contig_4	11806	11449	357	renamed_GCF_000008685.2	lp17	1409	1766	357	100.0	1.532e-77
URI41H	contig_4	12886	12412	474	renamed_GCF_000008685.2	lp17	329	803	474	100.0	1.788e-103
URI41H	contig_4	13655	14123	468	renamed_GCF_000008685.2	lp28-3	390	858	468	100.0	3.979e-102
URI41H	contig_4	16232	15521	711	renamed_GCF_000008685.2	lp28-3	2970	2259	711	100.0	1.615e-152
URI41H	contig_4	20989	17152	3837	renamed_GCF_000008685.2	lp28-3	7728	3891	3837	100.0	0.0
URI41H	contig_4	23777	23108	669	renamed_GCF_000008685.2	lp28-3	10516	9847	669	100.0	5.739e-140
URI41H	contig_5	21911	22133	222	renamed_GCF_000008685.2	lp36	21911	22133	222	100.0	1.866e-45
URI41H	contig_5	22293	22467	174	renamed_GCF_000008685.2	lp36	22293	22467	174	100.0	8.56e-38
URI41H	contig_5	24066	24243	177	renamed_GCF_000008685.2	lp36	24066	24243	177	100.0	7.659e-32
URI41H	contig_5	24292	24670	378	renamed_GCF_000008685.2	lp38	23365	24088	378	39.2	3.947e-22
URI41H	contig_5	25102	25657	555	renamed_GCF_000008685.2	lp36	25102	25657	555	100.0	3.12e-119
URI41H	contig_5	26358	25812	546	renamed_GCF_000008685.2	lp36	26358	25812	546	100.0	8.009e-116
URI41H	contig_5	26803	26584	219	renamed_GCF_000008685.2	lp36	26803	26584	219	100.0	9.792e-44
URI41H	contig_5	28288	27382	906	renamed_GCF_000008685.2	lp36	28288	27382	906	100.0	5.634e-197
URI41H	contig_6	28710	27711	999	renamed_GCF_000008685.2	lp28-1	466	1465	999	100.0	6.954e-219
URI41H	contig_6	33321	32805	516	renamed_GCF_000008685.2	lp28-1	2619	2097	516	100.0	2.617e-106
URI41H	contig_6	33484	33784	300	renamed_GCF_000008685.2	lp28-3	1044	1368	300	89.8	8.93e-58
URI41H	contig_7	28899	29505	606	renamed_GCF_000008685.2	lp56	17207	17813	606	100.0	5.47e-130
URI41H	contig_7	30611	30959	348	renamed_GCF_000008685.2	cp32-8	15421	15769	348	100.0	8.822e-74
URI41H	contig_8	8755	9145	390	renamed_GCF_000008685.2	cp32-9	5783	6173	390	100.0	3.229e-83
URI41H	contig_8	11714	11951	237	renamed_GCF_000008685.2	cp32-7	8725	8962	237	97.4	1.95e-47
URI41H	contig_8	13281	14868	1587	renamed_GCF_000008685.2	cp32-7	10961	11903	1587	99.6	9.214e-207
URI41H	contig_9	21633	22017	384	renamed_GCF_000008685.2	cp32-9	5412	5796	384	100.0	2.931e-83
URI41H	contig_9	22390	22957	567	renamed_GCF_000008685.2	cp32-9	6169	6736	567	100.0	2.131e-125
URI41H	contig_9	25206	26481	1275	renamed_GCF_000008685.2	cp32-9	8985	10260	1275	100.0	5.405e-277
URI41H	contig_10	1695	2196	501	renamed_GCF_000008685.2	cp32-4	16496	16997	501	100.0	5.048e-105
URI41H	contig_10	3782	2771	1011	renamed_GCF_000008685.2	cp32-4	18583	17572	1011	100.0	1.362e-230
URI41H	contig_10	5265	5832	567	renamed_GCF_000008685.2	cp32-4	20066	20633	567	100.0	2.944e-130
URI41H	contig_10	6613	7159	546	renamed_GCF_000008685.2	cp32-4	21414	21960	546	100.0	3.273e-117
URI41H	contig_11	457	1567	1110	renamed_GCF_000008685.2	lp21	1485	2628	1110	98.9	8.376e-253
URI41H	contig_11	26647	26215	432	renamed_GCF_000008685.2	lp5	4387	4819	432	99.3	2.641e-92
URI41H	contig_11	28068	28353	285	renamed_GCF_000008685.2	lp21	16548	16227	285	98.9	2.097e-62
URI41H	contig_11	29232	28767	465	renamed_GCF_000008685.2	lp21	15348	15813	465	99.3	4.176e-101
URI41H	contig_12	706	277	429	renamed_GCF_000008685.2	cp32-6	7837	8266	429	100.0	5.601e-92
URI41H	contig_12	17661	16911	750	renamed_GCF_000008685.2	cp32-6	20720	21470	750	100.0	4.35e-165
URI41H	contig_12	19313	18212	1101	renamed_GCF_000008685.2	cp32-6	19068	20169	1101	100.0	1.945e-250
URI41H	contig_12	27420	26469	951	renamed_GCF_000008685.2	cp32-6	10961	11912	951	100.0	4.333e-216
URI41H	contig_12	29404	28129	1275	renamed_GCF_000008685.2	cp32-6	8977	10252	1275	100.0	5.405e-277
URI41H	contig_14	5799	5451	348	renamed_GCF_000008685.2	cp26	4083	4431	348	100.0	1.075e-71
URI41H	contig_14	7696	9046	1350	renamed_GCF_000008685.2	cp26	2186	836	1350	100.0	7.868e-303
URI41H	contig_14	9837	9558	279	renamed_GCF_000008685.2	cp26	45	324	279	100.0	2.323e-60
URI41H	contig_14	24367	22774	1593	renamed_GCF_000008685.2	cp26	12013	13606	1593	100.0	0.0
URI41H	contig_14	26277	25728	549	renamed_GCF_000008685.2	cp26	10103	10652	549	100.0	6.94e-118
URI41H	contig_15	2173	3010	837	renamed_GCF_000008685.2	lp28-4	23995	23158	837	100.0	6.415e-184
URI41H	contig_15	4606	5398	792	renamed_GCF_000008685.2	lp28-4	21562	20770	792	100.0	1.631e-174
URI41H	contig_15	21203	20984	219	renamed_GCF_000008685.2	lp28-4	5127	5346	219	100.0	1.443e-47
URI41H	contig_15	23795	22979	816	renamed_GCF_000008685.2	lp28-4	2535	3351	816	100.0	8.08e-178
URI41H	contig_1	65290	65752	462	renamed_GCF_000008685.2	chromosome	65290	65752	462	100.0	3.193e-95
URI41H	contig_1	69565	70126	561	renamed_GCF_000008685.2	chromosome	69565	70126	561	100.0	3.775e-118
URI41H	contig_1	80981	81407	426	renamed_GCF_000008685.2	chromosome	80982	81408	426	100.0	5.338e-92
URI41H	contig_1	83919	82968	951	renamed_GCF_000008685.2	chromosome	83920	82969	951	99.6	3.736e-209
URI41H	contig_1	87359	86924	435	renamed_GCF_000008685.2	chromosome	87360	86925	435	100.0	2.772e-92
URI41H	contig_1	89807	89198	609	renamed_GCF_000008685.2	chromosome	89808	89199	609	100.0	1.275e-129
URI41H	contig_1	105430	103762	1668	renamed_GCF_000008685.2	chromosome	105299	103763	1668	100.0	0.0
URI41H	contig_1	106893	105882	1011	renamed_GCF_000008685.2	chromosome	106894	105883	1011	100.0	4.14e-218
URI41H	contig_1	108305	109670	1365	renamed_GCF_000008685.2	chromosome	108306	109671	1365	100.0	4.349e-312
URI41H	contig_1	167760	165915	1845	renamed_GCF_000008685.2	chromosome	167759	165914	1845	100.0	0.0
URI41H	contig_1	169539	170709	1170	renamed_GCF_000008685.2	chromosome	169562	170708	1170	99.7	6.062e-258
URI41H	contig_1	171251	171485	234	renamed_GCF_000008685.2	chromosome	171262	171484	234	98.6	1.134e-44
URI41H	contig_1	174117	173529	588	renamed_GCF_000008685.2	chromosome	174116	173528	588	100.0	1.529e-132
URI41H	contig_1	176975	176069	906	renamed_GCF_000008685.2	chromosome	176974	176068	906	100.0	1.374e-195
URI41H	contig_1	179544	178917	627	renamed_GCF_000008685.2	chromosome	179543	178916	627	100.0	1.275e-132
URI41H	contig_1	189277	189076	201	renamed_GCF_000008685.2	chromosome	189276	189075	201	100.0	9.889e-41
URI41H	contig_1	190064	190718	654	renamed_GCF_000008685.2	chromosome	190186	190717	654	100.0	6.314e-111
URI41H	contig_1	192328	191518	810	renamed_GCF_000008685.2	chromosome	192327	191517	810	100.0	2.276e-182
URI41H	contig_1	242290	240283	2007	renamed_GCF_000008685.2	chromosome	242289	240282	2007	100.0	0.0
URI41H	contig_1	244714	243943	771	renamed_GCF_000008685.2	chromosome	244713	243942	771	100.0	4.161e-169
URI41H	contig_1	273854	275237	1383	renamed_GCF_000008685.2	chromosome	273856	275236	1383	99.7	2.662e-303
URI41H	contig_1	276558	277065	507	renamed_GCF_000008685.2	chromosome	276671	277064	507	100.0	6.298e-87
URI41H	contig_1	279059	278537	522	renamed_GCF_000008685.2	chromosome	279058	278536	522	100.0	3.966e-111
URI41H	contig_1	281312	279407	1905	renamed_GCF_000008685.2	chromosome	281311	279406	1905	100.0	0.0
URI41H	contig_1	282688	281800	888	renamed_GCF_000008685.2	chromosome	282687	281799	888	100.0	4.025e-189
URI41H	contig_1	293209	292426	783	renamed_GCF_000008685.2	chromosome	293208	292425	783	100.0	6.057e-167
URI41H	contig_1	294781	293452	1329	renamed_GCF_000008685.2	chromosome	294780	293451	1329	100.0	2.397e-295
URI41H	contig_1	296421	295242	1179	renamed_GCF_000008685.2	chromosome	296420	295241	1179	100.0	1.072e-261
URI41H	contig_1	449422	450175	753	renamed_GCF_000008685.2	chromosome	449418	450171	753	100.0	3.278e-160
URI41H	contig_1	451925	451142	783	renamed_GCF_000008685.2	chromosome	451921	451138	783	100.0	1.017e-169
URI41H	contig_1	456392	454487	1905	renamed_GCF_000008685.2	chromosome	456388	454483	1905	100.0	0.0
URI41H	contig_1	458280	459438	1158	renamed_GCF_000008685.2	chromosome	458276	459434	1158	100.0	2.482e-257
URI41H	contig_1	471224	469964	1260	renamed_GCF_000008685.2	chromosome	471220	469960	1260	100.0	2.539e-274
URI41H	contig_1	472479	471774	705	renamed_GCF_000008685.2	chromosome	472358	471770	705	99.4	1.099e-121
URI41H	contig_1	474560	473408	1152	renamed_GCF_000008685.2	chromosome	474556	473404	1152	100.0	7.714e-261
URI41H	contig_1	475609	476215	606	renamed_GCF_000008685.2	chromosome	475605	476211	606	100.0	1.006e-131
URI41H	contig_1	488986	489499	513	renamed_GCF_000008685.2	chromosome	488982	489495	513	100.0	1.545e-111
URI41H	contig_1	516492	522993	6501	renamed_GCF_000008685.2	chromosome	516492	522993	6501	100.0	0.0
URI41H	contig_1	529197	528102	1095	renamed_GCF_000008685.2	chromosome	529198	528103	1095	100.0	3.934e-250
URI41H	contig_1	531691	531127	564	renamed_GCF_000008685.2	chromosome	531692	531128	564	100.0	2.704e-122
URI41H	contig_1	544585	547387	2802	renamed_GCF_000008685.2	chromosome	544585	547387	2802	99.8	0.0
URI41H	contig_1	548885	548486	399	renamed_GCF_000008685.2	chromosome	548885	548486	399	100.0	1.521e-84
URI41H	contig_1	551723	549641	2082	renamed_GCF_000008685.2	chromosome	551723	549641	2082	100.0	0.0
URI41H	contig_1	553137	553788	651	renamed_GCF_000008685.2	chromosome	553138	553789	651	100.0	1.464e-143
URI41H	contig_1	567808	568276	468	renamed_GCF_000008685.2	chromosome	567809	568277	468	100.0	1.969e-101
URI41H	contig_1	569557	571279	1722	renamed_GCF_000008685.2	chromosome	569558	571280	1722	100.0	0.0
URI41H	contig_1	648324	646656	1668	renamed_GCF_000008685.2	chromosome	648254	646658	1668	100.0	0.0
URI41H	contig_1	648550	649105	555	renamed_GCF_000008685.2	chromosome	648552	649107	555	100.0	3.12e-119
URI41H	contig_1	650385	649167	1218	renamed_GCF_000008685.2	chromosome	650387	649169	1218	100.0	2.758e-266
URI41H	contig_1	653788	650410	3378	renamed_GCF_000008685.2	chromosome	653790	650412	3378	100.0	0.0
URI41H	contig_1	653884	654847	963	renamed_GCF_000008685.2	chromosome	653886	654849	963	100.0	5.23e-216
URI41H	contig_1	654806	656900	2094	renamed_GCF_000008685.2	chromosome	654862	656902	2094	99.8	0.0
URI41H	contig_1	675031	676375	1344	renamed_GCF_000008685.2	chromosome	675034	676378	1344	100.0	3.635e-293
URI41H	contig_1	676468	677857	1389	renamed_GCF_000008685.2	chromosome	676471	677860	1389	100.0	1.442e-302
URI41H	contig_1	678935	677888	1047	renamed_GCF_000008685.2	chromosome	678938	677891	1047	100.0	5.633e-238
URI41H	contig_1	679747	678955	792	renamed_GCF_000008685.2	chromosome	679750	678958	792	100.0	1.55e-166
URI41H	contig_1	701025	701382	357	renamed_GCF_000008685.2	chromosome	701028	701385	357	100.0	2.301e-81
URI41H	contig_1	701391	701802	411	renamed_GCF_000008685.2	chromosome	701394	701805	411	100.0	2.78e-88
URI41H	contig_1	701821	702271	450	renamed_GCF_000008685.2	chromosome	701824	702274	450	100.0	9.762e-98
URI41H	contig_1	702963	702279	684	renamed_GCF_000008685.2	chromosome	702951	702282	684	100.0	4.537e-145
URI41H	contig_1	703005	703965	960	renamed_GCF_000008685.2	chromosome	703008	703968	960	100.0	6.008e-214
URI41H	contig_1	703927	704956	1029	renamed_GCF_000008685.2	chromosome	703960	704959	1029	99.6	3.451e-223
URI41H	contig_1	704945	705497	552	renamed_GCF_000008685.2	chromosome	704948	705500	552	100.0	2.458e-121
URI41H	contig_1	705576	706602	1026	renamed_GCF_000008685.2	chromosome	705579	706605	1026	100.0	2.737e-225
URI41H	contig_1	706669	709264	2595	renamed_GCF_000008685.2	chromosome	706672	709267	2595	100.0	0.0
URI41H	contig_1	709270	710671	1401	renamed_GCF_000008685.2	chromosome	709273	710674	1401	100.0	3.758e-311
URI41H	contig_1	736694	736955	261	renamed_GCF_000008685.2	chromosome	736698	736959	261	100.0	3.165e-54
URI41H	contig_1	737207	737708	501	renamed_GCF_000008685.2	chromosome	737211	737712	501	100.0	9.268e-107
URI41H	contig_1	737704	738424	720	renamed_GCF_000008685.2	chromosome	737708	738428	720	100.0	9.639e-160
URI41H	contig_1	739139	739679	540	renamed_GCF_000008685.2	chromosome	739143	739683	540	100.0	2.458e-119
URI41H	contig_1	740235	740418	183	renamed_GCF_000008685.2	chromosome	740239	740422	183	100.0	1.805e-39
URI41H	contig_1	740683	741421	738	renamed_GCF_000008685.2	chromosome	740687	741425	738	100.0	4.772e-162
URI41H	contig_1	742739	744512	1773	renamed_GCF_000008685.2	chromosome	742743	744516	1773	100.0	0.0
URI41H	contig_1	760198	761644	1446	renamed_GCF_000008685.2	chromosome	760225	761647	1446	99.7	9.686e-317
URI41H	contig_1	811508	810467	1041	renamed_GCF_000008685.2	chromosome	811510	810469	1041	100.0	2.778e-236
URI41H	contig_1	813237	812436	801	renamed_GCF_000008685.2	chromosome	813239	812438	801	100.0	9.279e-174
URI41H	contig_1	820613	821195	582	renamed_GCF_000008685.2	chromosome	820606	821188	582	100.0	9.143e-129
URI41H	contig_1	821191	822376	1185	renamed_GCF_000008685.2	chromosome	821184	822369	1185	100.0	1.177e-261
URI41H	contig_1	822816	823110	294	renamed_GCF_000008685.2	chromosome	822809	823103	294	100.0	1.207e-61
URI41H	contig_1	823822	824389	567	renamed_GCF_000008685.2	chromosome	823815	824382	567	100.0	1.275e-122
URI41H	contig_1	825707	827627	1920	renamed_GCF_000008685.2	chromosome	825700	827620	1920	100.0	0.0
URI41H	contig_1	829224	830328	1104	renamed_GCF_000008685.2	chromosome	829217	830321	1104	100.0	4.529e-250
URI41H	contig_1	847497	848346	849	renamed_GCF_000008685.2	chromosome	847490	848339	849	100.0	6.426e-186
URI41H	contig_1	848825	850994	2169	renamed_GCF_000008685.2	chromosome	848836	850987	2169	99.8	0.0
URI41H	contig_2	1262	1748	486	renamed_GCF_000008685.2	lp56	3622	4108	486	100.0	4.376e-104
URI41H	contig_2	3470	2708	762	renamed_GCF_000008685.2	lp56	5830	5068	762	100.0	1.784e-168
URI41H	contig_2	9832	10069	237	renamed_GCF_000008685.2	cp32-9	8741	8978	237	100.0	1.76e-48
URI41H	contig_2	11993	12944	951	renamed_GCF_000008685.2	lp56	14441	15392	951	99.6	1.057e-214
URI41H	contig_2	13545	13878	333	renamed_GCF_000008685.2	cp32-3	12494	12827	333	100.0	8.424e-72
URI41H	contig_2	15374	16190	816	renamed_GCF_000008685.2	lp56	17822	18638	816	99.6	1.49e-179
URI41H	contig_2	33256	33814	558	renamed_GCF_000008685.2	cp32-7	2009	2567	558	100.0	1.105e-122
URI41H	contig_2	33820	34585	765	renamed_GCF_000008685.2	cp32-7	2573	3338	765	99.6	3.139e-171
URI41H	contig_2	36187	36643	456	renamed_GCF_000008685.2	cp32-1	4941	5397	456	100.0	1.075e-97
URI41H	contig_2	37013	37403	390	renamed_GCF_000008685.2	cp32-4	5777	6167	390	100.0	3.229e-83
URI41H	contig_3	8255	8435	180	renamed_GCF_000008685.2	lp54	8265	8445	180	100.0	1.452e-33
URI41H	contig_3	27379	27988	609	renamed_GCF_000008685.2	lp54	27389	27998	609	100.0	2.346e-131
URI41H	contig_3	28924	29377	453	renamed_GCF_000008685.2	lp54	28934	29387	453	100.0	2.51e-96
URI41H	contig_3	30709	31780	1071	renamed_GCF_000008685.2	lp54	30709	31780	1071	99.7	4.869e-235
URI41H	contig_3	32260	32749	489	renamed_GCF_000008685.2	lp54	32260	32749	489	100.0	3.125e-108
URI41H	contig_3	34384	34948	564	renamed_GCF_000008685.2	lp54	34384	34948	564	99.4	3.599e-119
URI41H	contig_3	35953	36229	276	renamed_GCF_000008685.2	lp54	35953	36229	276	100.0	3.31e-56
URI41H	contig_5	14326	13576	750	renamed_GCF_000008685.2	lp36	14326	13576	750	100.0	1.062e-163
URI41H	contig_5	15760	14833	927	renamed_GCF_000008685.2	lp36	15760	14833	927	100.0	2.815e-208
URI41H	contig_5	17379	17583	204	renamed_GCF_000008685.2	lp36	17379	17583	204	100.0	8.441e-43
URI41H	contig_5	20388	21453	1065	renamed_GCF_000008685.2	lp36	20388	21453	1065	100.0	2.633e-232
URI41H	contig_6	14847	15408	561	renamed_GCF_000008685.2	lp28-1	14329	13768	561	100.0	4.308e-125
URI41H	contig_6	16184	16736	552	renamed_GCF_000008685.2	lp28-1	12992	12440	552	100.0	6.015e-120
URI41H	contig_6	18185	18479	294	renamed_GCF_000008685.2	lp28-1	10895	10697	294	100.0	9.155e-41
URI41H	contig_8	20198	20624	426	renamed_GCF_000008685.2	cp32-7	17244	17667	426	72.1	3.006e-65
URI41H	contig_9	6389	7145	756	renamed_GCF_000008685.2	cp32-9	20816	21572	756	100.0	2.151e-165
URI41H	contig_9	7756	8296	540	renamed_GCF_000008685.2	cp32-9	22183	22723	540	100.0	1.782e-114
URI41H	contig_9	10144	10570	426	renamed_GCF_000008685.2	cp32-9	24571	24997	426	100.0	1.627e-96
URI41H	contig_9	12370	13402	1032	renamed_GCF_000008685.2	cp32-9	26797	27829	1032	100.0	2.498e-227
URI41H	contig_9	14308	14875	567	renamed_GCF_000008685.2	cp32-3	28235	28874	567	90.4	1.633e-111
URI41H	contig_9	16289	17516	1227	renamed_GCF_000008685.2	cp32-9	65	1292	1227	100.0	9.884e-271
URI41H	contig_9	18236	18803	567	renamed_GCF_000008685.2	cp32-9	2012	2579	567	100.0	4.74e-125
URI41H	contig_9	20199	21159	960	renamed_GCF_000008685.2	cp32-4	3972	4932	960	100.0	6.008e-214
URI41H	contig_9	27261	28212	951	renamed_GCF_000008685.2	cp32-9	11040	11991	951	100.0	9.63e-216
URI41H	contig_9	28813	29146	333	renamed_GCF_000008685.2	cp32-9	12592	12925	333	100.0	1.876e-71
URI41H	contig_10	365	569	204	renamed_GCF_000008685.2	cp32-1	15214	15418	204	100.0	2.578e-39
URI41H	contig_10	1237	1591	354	renamed_GCF_000008685.2	cp32-4	16038	16392	354	100.0	6.554e-78
URI41H	contig_10	17510	18074	564	renamed_GCF_000008685.2	cp32-4	2012	2576	564	100.0	2.235e-124
URI41H	contig_10	18873	19449	576	renamed_GCF_000008685.2	cp32-4	3375	3951	576	100.0	1.005e-126
URI41H	contig_10	20449	20905	456	renamed_GCF_000008685.2	cp32-4	4951	5407	456	100.0	1.075e-97
URI41H	contig_12	3595	3139	456	renamed_GCF_000008685.2	cp32-6	4948	5404	456	100.0	1.075e-97
URI41H	contig_12	5171	4595	576	renamed_GCF_000008685.2	cp32-6	3372	3948	576	100.0	4.521e-127
URI41H	contig_12	6534	5970	564	renamed_GCF_000008685.2	cp32-6	2009	2573	564	100.0	2.235e-124
URI41H	contig_12	8478	7254	1224	renamed_GCF_000008685.2	cp32-6	65	1289	1224	100.0	2.096e-270
URI41H	contig_12	10459	9892	567	renamed_GCF_000008685.2	cp32-6	27922	28489	567	100.0	2.836e-122
URI41H	contig_12	21135	20685	450	renamed_GCF_000008685.2	cp32-6	17246	17696	450	100.0	3.616e-100
URI41H	contig_12	22279	21925	354	renamed_GCF_000008685.2	cp32-6	16102	16456	354	100.0	1.459e-77
URI41H	contig_12	22944	22596	348	renamed_GCF_000008685.2	cp32-6	15437	15785	348	100.0	8.822e-74
URI41H	contig_14	14556	15042	486	renamed_GCF_000008685.2	cp26	21833	21338	486	100.0	3.279e-107
URI41H	contig_14	15594	16950	1356	renamed_GCF_000008685.2	cp26	20786	19430	1356	100.0	1.798e-294
URI41H	contig_14	19478	18845	633	renamed_GCF_000008685.2	cp26	16902	17535	633	100.0	1.275e-133
URI41H	contig_15	12904	12331	573	renamed_GCF_000008685.2	lp28-4	13264	13837	573	100.0	2.579e-124
URI41H	contig_15	14245	13690	555	renamed_GCF_000008685.2	lp28-4	11923	12478	555	100.0	3.559e-126
URI41H	contig_15	19148	17630	1518	renamed_GCF_000008685.2	lp28-4	7182	8538	1518	89.3	3.728e-287
URI41H	contig_16	11974	11392	582	renamed_GCF_000008685.2	lp25	12079	11497	582	100.0	4.521e-128
URI41H	contig_1	6306	5250	1056	renamed_GCF_000008685.2	chromosome	6306	5250	1056	99.7	7.804e-236
URI41H	contig_1	8315	7457	858	renamed_GCF_000008685.2	chromosome	8315	7457	858	100.0	6.472e-196
URI41H	contig_1	9201	10206	1005	renamed_GCF_000008685.2	chromosome	9201	10206	1005	100.0	1.697e-218
URI41H	contig_1	10580	11420	840	renamed_GCF_000008685.2	chromosome	10580	11420	840	100.0	7.775e-191
URI41H	contig_1	12153	12753	600	renamed_GCF_000008685.2	chromosome	12153	12753	600	100.0	4.114e-132
URI41H	contig_1	15345	14724	621	renamed_GCF_000008685.2	chromosome	15345	14724	621	100.0	3.249e-138
URI41H	contig_1	15994	16804	810	renamed_GCF_000008685.2	chromosome	15994	16804	810	100.0	1.068e-173
URI41H	contig_1	18304	17791	513	renamed_GCF_000008685.2	chromosome	18304	17791	513	100.0	1.701e-110
URI41H	contig_1	22101	21057	1044	renamed_GCF_000008685.2	chromosome	22101	21057	1044	100.0	6.693e-227
URI41H	contig_1	52434	51252	1182	renamed_GCF_000008685.2	chromosome	52434	51252	1182	100.0	6.664e-259
URI41H	contig_1	56280	55500	780	renamed_GCF_000008685.2	chromosome	56280	55500	780	99.6	1.628e-172
URI41H	contig_1	56748	56280	468	renamed_GCF_000008685.2	chromosome	56748	56280	468	100.0	3.979e-102
URI41H	contig_1	57258	57975	717	renamed_GCF_000008685.2	chromosome	57258	57975	717	100.0	1.471e-154
URI41H	contig_1	70172	71219	1047	renamed_GCF_000008685.2	chromosome	70141	71219	1047	100.0	1.295e-228
URI41H	contig_1	72646	73492	846	renamed_GCF_000008685.2	chromosome	72646	73492	846	100.0	5.813e-178
URI41H	contig_1	75772	76453	681	renamed_GCF_000008685.2	chromosome	75773	76454	681	100.0	3.584e-147
URI41H	contig_1	79008	77709	1299	renamed_GCF_000008685.2	chromosome	79009	77710	1299	100.0	8.363e-285
URI41H	contig_1	79503	80772	1269	renamed_GCF_000008685.2	chromosome	79504	80773	1269	100.0	1.4e-282
URI41H	contig_1	94031	93431	600	renamed_GCF_000008685.2	chromosome	94032	93432	600	100.0	1.47e-126
URI41H	contig_1	138744	138432	312	renamed_GCF_000008685.2	chromosome	138745	138433	312	100.0	1.981e-67
URI41H	contig_1	144267	142944	1323	renamed_GCF_000008685.2	chromosome	144230	142943	1323	99.7	1.75e-280
URI41H	contig_1	145459	144586	873	renamed_GCF_000008685.2	chromosome	145458	144585	873	100.0	2.787e-199
URI41H	contig_1	148660	147649	1011	renamed_GCF_000008685.2	chromosome	148659	147648	1011	100.0	5.463e-215
URI41H	contig_1	150974	152180	1206	renamed_GCF_000008685.2	chromosome	150973	152179	1206	100.0	4.93e-275
URI41H	contig_1	153687	153075	612	renamed_GCF_000008685.2	chromosome	153686	153074	612	100.0	4.712e-141
URI41H	contig_1	156462	157599	1137	renamed_GCF_000008685.2	chromosome	156461	157598	1137	100.0	1.164e-253
URI41H	contig_1	158058	158475	417	renamed_GCF_000008685.2	chromosome	158075	158474	417	100.0	2.72e-81
URI41H	contig_1	182803	181408	1395	renamed_GCF_000008685.2	chromosome	182802	181407	1395	100.0	4.219e-300
URI41H	contig_1	229217	230225	1008	renamed_GCF_000008685.2	chromosome	229216	230224	1008	100.0	1.228e-222
URI41H	contig_1	231621	232323	702	renamed_GCF_000008685.2	chromosome	231620	232322	702	100.0	1.161e-154
URI41H	contig_1	245380	244777	603	renamed_GCF_000008685.2	chromosome	245382	244776	603	99.5	7.936e-134
URI41H	contig_1	248527	250090	1563	renamed_GCF_000008685.2	chromosome	248505	250089	1563	100.0	0.0
URI41H	contig_1	250671	250176	495	renamed_GCF_000008685.2	chromosome	250670	250175	495	100.0	5.051e-104
URI41H	contig_1	252238	251212	1026	renamed_GCF_000008685.2	chromosome	252237	251211	1026	100.0	5.545e-226
URI41H	contig_1	253159	254932	1773	renamed_GCF_000008685.2	chromosome	253158	254931	1773	100.0	0.0
URI41H	contig_1	256463	258986	2523	renamed_GCF_000008685.2	chromosome	256462	258985	2523	100.0	0.0
URI41H	contig_1	263713	261292	2421	renamed_GCF_000008685.2	chromosome	263712	261291	2421	100.0	0.0
URI41H	contig_1	303741	303333	408	renamed_GCF_000008685.2	chromosome	303740	303332	408	100.0	2.649e-88
URI41H	contig_1	306619	305671	948	renamed_GCF_000008685.2	chromosome	306615	305670	948	100.0	3.249e-210
URI41H	contig_1	308518	307318	1200	renamed_GCF_000008685.2	chromosome	308517	307317	1200	100.0	3.302e-261
URI41H	contig_1	319638	319107	531	renamed_GCF_000008685.2	chromosome	319636	319105	531	100.0	1.699e-113
URI41H	contig_1	320310	321354	1044	renamed_GCF_000008685.2	chromosome	320308	321352	1044	100.0	3.013e-227
URI41H	contig_1	321353	322040	687	renamed_GCF_000008685.2	chromosome	321351	322038	687	100.0	1.336e-150
URI41H	contig_1	323781	322848	933	renamed_GCF_000008685.2	chromosome	323779	322846	933	100.0	1.839e-205
URI41H	contig_1	326290	325237	1053	renamed_GCF_000008685.2	chromosome	326288	325235	1053	100.0	4.032e-234
URI41H	contig_1	342336	343209	873	renamed_GCF_000008685.2	chromosome	342334	343207	873	100.0	1.573e-188
URI41H	contig_7	27685	28018	333	renamed_GCF_000008685.2	cp32-4	12447	12780	333	100.0	8.424e-72
URI41H	contig_7	30404	30608	204	renamed_GCF_000008685.2	cp32-7	15221	15425	204	100.0	2.578e-39
URI41H	contig_8	9691	10804	1113	renamed_GCF_000008685.2	cp32-7	6702	7815	1113	100.0	3.095e-247
URI41H	contig_8	11958	13269	1311	renamed_GCF_000008685.2	cp32-7	8969	10304	1311	81.0	8.725e-234
URI41H	contig_8	14892	15438	546	renamed_GCF_000008685.2	cp32-7	11927	12473	546	100.0	8.009e-116
URI41H	contig_8	15467	15800	333	renamed_GCF_000008685.2	cp32-7	12502	12835	333	100.0	1.876e-71
URI41H	contig_9	24065	24494	429	renamed_GCF_000008685.2	cp32-9	7844	8273	429	100.0	5.601e-92
URI41H	contig_9	24962	25199	237	renamed_GCF_000008685.2	cp32-4	8733	8970	237	100.0	1.76e-48
URI41H	contig_10	2301	2724	423	renamed_GCF_000008685.2	cp32-4	17102	17525	423	100.0	4.616e-93
URI41H	contig_10	4158	5256	1098	renamed_GCF_000008685.2	cp32-4	18959	20057	1098	100.0	8.352e-251
URI41H	contig_10	5807	6563	756	renamed_GCF_000008685.2	cp32-4	20608	21364	756	100.0	8.022e-168
URI41H	contig_10	8029	9355	1326	renamed_GCF_000008685.2	cp32-4	22830	24156	1326	100.0	6.506e-301
URI41H	contig_10	10634	9839	795	renamed_GCF_000008685.2	cp32-4	25435	24640	795	100.0	5.809e-178
URI41H	contig_10	12051	12726	675	renamed_GCF_000008685.2	cp32-4	26852	27527	675	100.0	3.937e-145
URI41H	contig_11	29933	29345	588	renamed_GCF_000008685.2	lp21	14647	15235	588	100.0	4.973e-128
URI41H	contig_12	1833	720	1113	renamed_GCF_000008685.2	cp32-6	6710	7823	1113	100.0	1.393e-247
URI41H	contig_12	2383	1813	570	renamed_GCF_000008685.2	cp32-6	6160	6730	570	100.0	2.235e-125
URI41H	contig_12	2769	2379	390	renamed_GCF_000008685.2	cp32-6	5774	6164	390	100.0	1.451e-83
URI41H	contig_12	10636	11305	669	renamed_GCF_000008685.2	cp32-6	27745	27076	669	100.0	4.521e-151
URI41H	contig_12	12125	11366	759	renamed_GCF_000008685.2	cp32-6	26256	27015	759	100.0	2.986e-162
URI41H	contig_12	12555	13332	777	renamed_GCF_000008685.2	cp32-7	25720	24943	777	100.0	1.414e-173
URI41H	contig_12	13763	13337	426	renamed_GCF_000008685.2	cp32-6	24618	25044	426	100.0	8.056e-96
URI41H	contig_12	15141	13815	1326	renamed_GCF_000008685.2	cp32-6	23240	24566	1326	99.3	7.819e-299
URI41H	contig_12	16280	15611	669	renamed_GCF_000008685.2	cp32-6	22101	22770	669	100.0	2.138e-142
URI41H	contig_13	17489	18308	819	renamed_GCF_000008685.2	lp28-2	12319	11500	819	100.0	1.075e-183
URI41H	contig_14	2047	1117	930	renamed_GCF_000008685.2	cp26	7835	8765	930	100.0	7.897e-206
URI41H	contig_14	5443	5125	318	renamed_GCF_000008685.2	cp26	4481	4757	318	100.0	7.253e-55
URI41H	contig_14	6084	7407	1323	renamed_GCF_000008685.2	cp26	3798	2475	1323	100.0	1.419e-291
URI41H	contig_14	9131	9575	444	renamed_GCF_000008685.2	cp26	751	307	444	100.0	2.98e-101
URI41H	contig_14	21273	22488	1215	renamed_GCF_000008685.2	cp26	15107	13892	1215	100.0	5.333e-267
URI41H	contig_14	24963	25461	498	renamed_GCF_000008685.2	cp26	11417	10919	498	100.0	3.608e-108
URI41H	contig_15	132	375	243	renamed_GCF_000008685.2	lp28-4	26036	25793	243	100.0	2.599e-53
URI41H	contig_15	1079	1946	867	renamed_GCF_000008685.2	lp28-4	25089	24222	867	100.0	1.188e-190
URI41H	contig_26	759	402	357	renamed_GCF_000008685.2	cp32-7	15428	15785	357	99.1	1.866e-75
URI41H	contig_1	41432	40760	672	renamed_GCF_000008685.2	chromosome	41432	40760	672	100.0	1.856e-144
URI41H	contig_1	42881	42479	402	renamed_GCF_000008685.2	chromosome	42881	42479	402	100.0	2.405e-88
URI41H	contig_1	45354	42906	2448	renamed_GCF_000008685.2	chromosome	45354	42906	2448	100.0	0.0
URI41H	contig_1	85719	84039	1680	renamed_GCF_000008685.2	chromosome	85720	84040	1680	100.0	0.0
URI41H	contig_1	86853	85878	975	renamed_GCF_000008685.2	chromosome	86854	85879	975	100.0	4.354e-220
URI41H	contig_1	91114	89809	1305	renamed_GCF_000008685.2	chromosome	91115	89810	1305	100.0	2.863e-289
URI41H	contig_1	103770	103014	756	renamed_GCF_000008685.2	chromosome	103771	103015	756	100.0	4.353e-166
URI41H	contig_1	105854	105416	438	renamed_GCF_000008685.2	chromosome	105846	105417	438	100.0	3.53e-90
URI41H	contig_1	108169	106972	1197	renamed_GCF_000008685.2	chromosome	108170	106973	1197	100.0	8.414e-259
URI41H	contig_1	111041	109673	1368	renamed_GCF_000008685.2	chromosome	111042	109674	1368	100.0	1.976e-295
URI41H	contig_1	111874	111583	291	renamed_GCF_000008685.2	chromosome	111875	111584	291	100.0	1.894e-64
URI41H	contig_1	121822	121099	723	renamed_GCF_000008685.2	chromosome	121823	121100	723	100.0	1.695e-162
URI41H	contig_1	173581	171532	2049	renamed_GCF_000008685.2	chromosome	173535	171531	2049	99.8	0.0
URI41H	contig_1	175085	174098	987	renamed_GCF_000008685.2	chromosome	174970	174097	987	100.0	1.551e-190
URI41H	contig_1	177854	176978	876	renamed_GCF_000008685.2	chromosome	177853	176977	876	100.0	9.427e-195
URI41H	contig_1	178861	177868	993	renamed_GCF_000008685.2	chromosome	178860	177867	993	100.0	4.528e-214
URI41H	contig_1	189860	189299	561	renamed_GCF_000008685.2	chromosome	189859	189298	561	100.0	1.275e-121
URI41H	contig_1	190719	191460	741	renamed_GCF_000008685.2	chromosome	190718	191459	741	100.0	7.281e-158
URI41H	contig_1	193464	192324	1140	renamed_GCF_000008685.2	chromosome	193463	192323	1140	100.0	4.164e-257
URI41H	contig_1	194876	195737	861	renamed_GCF_000008685.2	chromosome	194875	195736	861	99.6	3.179e-187
URI41H	contig_1	211301	212069	768	renamed_GCF_000008685.2	chromosome	211300	212068	768	100.0	8.822e-169
URI41H	contig_1	276497	275243	1254	renamed_GCF_000008685.2	chromosome	276496	275242	1254	100.0	4.99e-283
URI41H	contig_1	278560	277090	1470	renamed_GCF_000008685.2	chromosome	278559	277089	1470	100.0	8.9e-322
URI41H	contig_1	279381	279078	303	renamed_GCF_000008685.2	chromosome	279380	279077	303	100.0	2.087e-65
URI41H	contig_1	281794	281314	480	renamed_GCF_000008685.2	chromosome	281793	281313	480	100.0	1.072e-101
URI41H	contig_1	292427	291644	783	renamed_GCF_000008685.2	chromosome	292426	291643	783	100.0	1.874e-171
URI41H	contig_1	293430	293205	225	renamed_GCF_000008685.2	chromosome	293429	293204	225	100.0	8.8e-46
URI41H	contig_1	295229	294785	444	renamed_GCF_000008685.2	chromosome	295228	294784	444	100.0	1.185e-94
URI41H	contig_1	297046	296428	618	renamed_GCF_000008685.2	chromosome	297045	296427	618	100.0	5.47e-132
URI41H	contig_1	298777	297466	1311	renamed_GCF_000008685.2	chromosome	298776	297465	1311	100.0	6.981e-289
URI41H	contig_1	309781	308539	1242	renamed_GCF_000008685.2	chromosome	309780	308538	1242	100.0	1.368e-269
URI41H	contig_1	354638	353441	1197	renamed_GCF_000008685.2	chromosome	354636	353439	1197	100.0	5.312e-264
URI41H	contig_1	355300	354649	651	renamed_GCF_000008685.2	chromosome	355298	354647	651	100.0	1.769e-141
URI41H	contig_1	355492	356911	1419	renamed_GCF_000008685.2	chromosome	355490	356909	1419	100.0	1.415e-316
URI41H	contig_1	357008	358442	1434	renamed_GCF_000008685.2	chromosome	357006	358440	1434	100.0	9.657e-315
URI41H	contig_1	358459	359200	741	renamed_GCF_000008685.2	chromosome	358457	359198	741	100.0	9.218e-164
URI41H	contig_1	359497	359218	279	renamed_GCF_000008685.2	chromosome	359495	359216	279	100.0	2.841e-58
URI41H	contig_1	361080	359514	1566	renamed_GCF_000008685.2	chromosome	361078	359512	1566	100.0	0.0
URI41H	contig_1	364119	362319	1800	renamed_GCF_000008685.2	chromosome	364117	362317	1800	100.0	0.0
URI41H	contig_1	374278	375655	1377	renamed_GCF_000008685.2	chromosome	374276	375653	1377	100.0	1.277e-310
URI41H	contig_1	377021	375962	1059	renamed_GCF_000008685.2	chromosome	377019	375960	1059	100.0	5.328e-232
URI41H	contig_1	424450	423826	624	renamed_GCF_000008685.2	chromosome	424442	423821	624	100.0	2.036e-135
URI41H	contig_1	424697	425555	858	renamed_GCF_000008685.2	chromosome	424693	425551	858	100.0	1.579e-194
URI41H	contig_1	447858	448176	318	renamed_GCF_000008685.2	chromosome	447854	448172	318	100.0	8.883e-69
URI41H	contig_1	448708	449314	606	renamed_GCF_000008685.2	chromosome	448707	449310	606	100.0	1.106e-130
URI41H	contig_1	454476	452043	2433	renamed_GCF_000008685.2	chromosome	454472	452039	2433	100.0	0.0
URI41H	contig_1	456579	458040	1461	renamed_GCF_000008685.2	chromosome	456575	458036	1461	100.0	0.0
URI41H	contig_1	469975	469681	294	renamed_GCF_000008685.2	chromosome	469971	469677	294	100.0	2.2e-63
URI41H	contig_1	471760	471226	534	renamed_GCF_000008685.2	chromosome	471756	471222	534	100.0	8.816e-113
URI41H	contig_1	472569	473412	843	renamed_GCF_000008685.2	chromosome	472565	473408	843	100.0	5.328e-187
URI41H	contig_1	505107	505545	438	renamed_GCF_000008685.2	chromosome	505103	505541	438	100.0	1.186e-93
URI41H	contig_1	506874	506988	114	renamed_GCF_000008685.2	chromosome	506864	506984	114	100.0	7.638e-22
URI41H	contig_1	524553	526254	1701	renamed_GCF_000008685.2	chromosome	524553	526254	1701	100.0	0.0
URI41H	contig_1	531104	529196	1908	renamed_GCF_000008685.2	chromosome	531105	529197	1908	100.0	0.0
URI41H	contig_1	543831	544605	774	renamed_GCF_000008685.2	chromosome	543831	544605	774	100.0	1.787e-170
URI41H	contig_1	548490	547845	645	renamed_GCF_000008685.2	chromosome	548490	547845	645	100.0	1.056e-137
URI41H	contig_1	549618	548919	699	renamed_GCF_000008685.2	chromosome	549618	548919	699	100.0	1.058e-146
URI41H	contig_1	591186	592356	1170	renamed_GCF_000008685.2	chromosome	591187	592357	1170	100.0	9.606e-253
URI41H	contig_1	592486	595930	3444	renamed_GCF_000008685.2	chromosome	592445	595931	3444	100.0	0.0
URI41H	contig_1	595941	596520	579	renamed_GCF_000008685.2	chromosome	595942	596521	579	100.0	3.772e-121
URI41H	contig_1	596529	598590	2061	renamed_GCF_000008685.2	chromosome	596530	598591	2061	100.0	0.0
URI41H	contig_1	599375	598586	789	renamed_GCF_000008685.2	chromosome	599376	598587	789	100.0	1.07e-178
URI41H	contig_1	599493	600843	1350	renamed_GCF_000008685.2	chromosome	599494	600844	1350	100.0	3.989e-293
URI41H	contig_1	601008	602343	1335	renamed_GCF_000008685.2	chromosome	601009	602344	1335	100.0	3.161e-293
URI41H	contig_1	616389	615762	627	renamed_GCF_000008685.2	chromosome	616390	615763	627	100.0	5.736e-133
URI41H	contig_1	618558	616410	2148	renamed_GCF_000008685.2	chromosome	618559	616411	2148	100.0	0.0
URI41H	contig_1	618826	621034	2208	renamed_GCF_000008685.2	chromosome	618827	621035	2208	100.0	0.0
URI41H	contig_1	724219	725443	1224	renamed_GCF_000008685.2	chromosome	724223	725447	1224	100.0	3.222e-274
URI41H	contig_1	725426	726491	1065	renamed_GCF_000008685.2	chromosome	725430	726495	1065	100.0	4.042e-236
URI41H	contig_1	726453	727749	1296	renamed_GCF_000008685.2	chromosome	726457	727753	1296	100.0	7.283e-286
URI41H	contig_1	727732	728671	939	renamed_GCF_000008685.2	chromosome	727736	728675	939	100.0	1.678e-207
URI41H	contig_1	728661	729615	954	renamed_GCF_000008685.2	chromosome	728665	729619	954	100.0	1.334e-212
URI41H	contig_1	731095	730627	468	renamed_GCF_000008685.2	chromosome	731099	730631	468	100.0	1.969e-101
URI41H	contig_1	731789	733799	2010	renamed_GCF_000008685.2	chromosome	731793	733803	2010	100.0	0.0
URI41H	contig_1	735347	736682	1335	renamed_GCF_000008685.2	chromosome	735351	736686	1335	100.0	6.003e-286
URI41H	contig_1	736955	737204	249	renamed_GCF_000008685.2	chromosome	736959	737208	249	100.0	2.148e-48
URI41H	contig_1	738401	738767	366	renamed_GCF_000008685.2	chromosome	738405	738771	366	100.0	9.695e-76
URI41H	contig_1	786856	788959	2103	renamed_GCF_000008685.2	chromosome	786859	788962	2103	100.0	0.0
URI41H	contig_1	790804	789943	861	renamed_GCF_000008685.2	chromosome	790807	789946	861	100.0	1.57e-186
URI41H	contig_1	792249	791790	459	renamed_GCF_000008685.2	chromosome	792252	791793	459	100.0	5.068e-98
URI41H	contig_1	794852	793838	1014	renamed_GCF_000008685.2	chromosome	794855	793841	1014	100.0	1.719e-228
URI41H	contig_1	806921	805772	1149	renamed_GCF_000008685.2	chromosome	806923	805774	1149	100.0	1.098e-247
URI41H	contig_1	808462	807973	489	renamed_GCF_000008685.2	chromosome	808464	807975	489	100.0	6.125e-101
URI41H	contig_1	810493	809698	795	renamed_GCF_000008685.2	chromosome	810495	809700	795	100.0	1.877e-173
URI41H	contig_1	812386	811504	882	renamed_GCF_000008685.2	chromosome	812388	811506	882	100.0	2.526e-193
URI41H	contig_1	813713	813383	330	renamed_GCF_000008685.2	chromosome	813706	813385	330	97.2	1.608e-64
URI41H	contig_1	822350	822701	351	renamed_GCF_000008685.2	chromosome	822343	822694	351	100.0	6.889e-77
URI41H	contig_1	875140	872593	2547	renamed_GCF_000008685.2	chromosome	875132	872585	2547	100.0	0.0
URI41H	contig_1	875214	876456	1242	renamed_GCF_000008685.2	chromosome	875206	876448	1242	100.0	1.008e-281
URI41H	contig_1	879322	880258	936	renamed_GCF_000008685.2	chromosome	879314	880250	936	100.0	3.242e-208
URI41H	contig_1	884221	881092	3129	renamed_GCF_000008685.2	chromosome	884213	881084	3129	100.0	0.0
URI41H	contig_1	904908	903936	972	renamed_GCF_000008685.2	chromosome	904900	903928	972	100.0	2.334e-209
URI41H	contig_1	913563	913293	270	renamed_GCF_000008685.2	lp17	14069	14339	270	100.0	1.489e-55
URI41H	contig_2	383	1136	753	renamed_GCF_000008685.2	lp56	2743	3496	753	100.0	1.868e-166
URI41H	contig_2	2626	1888	738	renamed_GCF_000008685.2	lp56	4986	4248	738	100.0	1.779e-164
URI41H	contig_2	3979	3442	537	renamed_GCF_000008685.2	lp56	6339	5802	537	100.0	1.599e-123
URI41H	contig_2	10076	11372	1296	renamed_GCF_000008685.2	lp56	12436	13732	1296	98.8	6.829e-278
URI41H	contig_2	46673	47021	348	renamed_GCF_000008685.2	lp56	18919	19267	348	100.0	3.962e-74
URI41H	contig_2	47338	47692	354	renamed_GCF_000008685.2	cp32-3	16083	16437	354	100.0	1.459e-77
URI41H	contig_2	48343	48952	609	renamed_GCF_000008685.2	cp32-3	17088	17697	609	100.0	2.836e-129
URI41H	contig_2	50483	49541	942	renamed_GCF_000008685.2	cp32-3	19228	18286	942	100.0	4.129e-215
URI41H	contig_2	51969	52536	567	renamed_GCF_000008685.2	cp32-3	20714	21281	567	100.0	2.944e-130
URI41H	contig_3	2883	2034	849	renamed_GCF_000008685.2	lp54	2893	2044	849	100.0	5.332e-188
URI41H	contig_3	5130	4656	474	renamed_GCF_000008685.2	lp54	5140	4666	474	100.0	5.31e-100
URI41H	contig_3	5635	6508	873	renamed_GCF_000008685.2	lp54	5645	6518	873	100.0	2.408e-192
URI41H	contig_3	7198	8233	1035	renamed_GCF_000008685.2	lp54	7208	8243	1035	100.0	8.138e-232
URI41H	contig_3	8431	8857	426	renamed_GCF_000008685.2	lp54	8441	8867	426	100.0	3.21e-89
URI41H	contig_4	3328	3625	297	renamed_GCF_000008685.2	lp17	9980	9590	297	100.0	9.385e-65
URI41H	contig_4	4949	3836	1113	renamed_GCF_000008685.2	lp17	8266	9379	1113	100.0	6.27e-248
URI41H	contig_4	5431	5104	327	renamed_GCF_000008685.2	lp17	7784	8111	327	100.0	1.029e-68
URI41H	contig_4	6763	7342	579	renamed_GCF_000008685.2	lp17	6452	5873	579	100.0	2.345e-126
URI41H	contig_4	8160	7476	684	renamed_GCF_000008685.2	lp17	5055	5739	684	100.0	2.578e-151
URI41H	contig_4	30668	31235	567	renamed_GCF_000008685.2	lp28-3	17407	17974	567	100.0	1.938e-126
URI41H	contig_4	32058	32688	630	renamed_GCF_000008685.2	lp28-3	18797	19427	630	100.0	1.007e-135
URI41H	contig_4	35938	36214	276	renamed_GCF_000008685.2	lp28-3	22677	22953	276	100.0	6.026e-58
URI41H	contig_6	20405	20147	258	renamed_GCF_000008685.2	lp28-1	8771	9029	258	100.0	1.351e-54
URI41H	contig_6	21265	21823	558	renamed_GCF_000008685.2	lp28-1	7869	7353	558	100.0	3.959e-117
URI41H	contig_7	6318	6840	522	renamed_GCF_000008685.2	cp32-7	21521	22076	522	100.0	1.473e-113
URI41H	contig_7	20666	21050	384	renamed_GCF_000008685.2	cp32-4	5406	5790	384	100.0	2.931e-83
URI41H	contig_7	21423	21990	567	renamed_GCF_000008685.2	lp56	9623	10190	567	98.4	5.734e-123
URI41H	contig_7	23096	23525	429	renamed_GCF_000008685.2	cp32-1	7827	8256	429	100.0	5.601e-92
URI41H	contig_8	4293	4986	693	renamed_GCF_000008685.2	cp32-7	1304	1997	693	99.5	2.837e-143
URI41H	contig_9	8766	10092	1326	renamed_GCF_000008685.2	cp32-9	23193	24519	1326	100.0	7.132e-300
URI41H	contig_9	11782	12343	561	renamed_GCF_000008685.2	cp32-9	26209	26770	561	100.0	4.739e-124
URI41H	contig_9	13598	14117	519	renamed_GCF_000008685.2	cp32-9	28025	28544	519	99.4	3.122e-113
URI41H	contig_9	14871	16224	1353	renamed_GCF_000008685.2	cp32-9	29298	30651	1353	100.0	6.259e-306
URI41H	contig_9	17532	18225	693	renamed_GCF_000008685.2	cp32-9	1308	2001	693	100.0	5.226e-145
URI41H	contig_9	18806	19574	768	renamed_GCF_000008685.2	cp32-9	2582	3350	768	100.0	6.66e-172
URI41H	contig_9	21178	21634	456	renamed_GCF_000008685.2	cp32-9	4957	5413	456	100.0	4.83e-98
URI41H	contig_11	11329	11860	531	renamed_GCF_000008685.2	cp9	4377	3852	531	66.4	4.169e-70
URI41H	contig_11	13281	14397	1116	renamed_GCF_000008685.2	cp9	162	1272	1116	88.3	1.916e-218
URI41H	contig_11	15017	15578	561	renamed_GCF_000008685.2	cp9	1891	2452	561	96.2	1.697e-118
URI41H	contig_11	22814	23108	294	renamed_GCF_000008685.2	lp21	15790	16084	294	100.0	2.432e-62
URI41H	contig_11	23909	24902	993	renamed_GCF_000008685.2	lp5	3339	4332	993	100.0	1.858e-215
URI41H	contig_12	4574	3614	960	renamed_GCF_000008685.2	cp32-6	3969	4929	960	100.0	6.008e-214
URI41H	contig_12	5967	5199	768	renamed_GCF_000008685.2	cp32-6	2576	3344	768	100.0	1.48e-171
URI41H	contig_12	7238	6545	693	renamed_GCF_000008685.2	cp32-6	1305	1998	693	100.0	1.162e-144
URI41H	contig_12	9896	8543	1353	renamed_GCF_000008685.2	cp32-6	28485	29838	1353	100.0	6.259e-306
URI41H	contig_12	19701	20649	948	renamed_GCF_000008685.2	cp32-6	18680	17732	948	100.0	7.628e-218
URI41H	contig_12	21306	21789	483	renamed_GCF_000008685.2	cp32-6	17075	16592	483	100.0	5.056e-102
URI41H	contig_12	22607	22271	336	renamed_GCF_000008685.2	cp32-8	15758	16094	336	100.0	5.348e-69
URI41H	contig_12	25539	24663	876	renamed_GCF_000008685.2	cp32-6	12842	13718	876	100.0	5.609e-192
URI41H	contig_15	13715	12962	753	renamed_GCF_000008685.2	lp28-4	12453	13206	753	100.0	4.561e-165
URI41H	contig_15	15354	14241	1113	renamed_GCF_000008685.2	lp28-4	10814	11927	1113	100.0	3.951e-253
URI41H	contig_16	10604	10094	510	renamed_GCF_000008685.2	lp25	10694	10199	510	99.3	8.021e-110
URI41H	contig_16	12749	11990	759	renamed_GCF_000008685.2	lp25	12854	12095	759	100.0	2.255e-165
URI41H	contig_16	14371	13297	1074	renamed_GCF_000008685.2	lp25	14530	13402	1074	99.7	2.22e-244
URI41H	contig_1	112	676	564	renamed_GCF_000008685.2	chromosome	104	677	564	100.0	4.108e-126
URI41H	contig_1	3394	5188	1794	renamed_GCF_000008685.2	chromosome	3418	5188	1794	100.0	0.0
URI41H	contig_1	7397	6308	1089	renamed_GCF_000008685.2	chromosome	7397	6308	1089	100.0	1.828e-240
URI41H	contig_1	8426	9197	771	renamed_GCF_000008685.2	chromosome	8426	9197	771	100.0	1.781e-161
URI41H	contig_1	10202	10577	375	renamed_GCF_000008685.2	chromosome	10202	10577	375	100.0	3.75e-79
URI41H	contig_1	11420	12161	741	renamed_GCF_000008685.2	chromosome	11420	12161	741	100.0	4.147e-164
URI41H	contig_1	12745	14728	1983	renamed_GCF_000008685.2	chromosome	12745	14728	1983	100.0	0.0
URI41H	contig_1	15722	15344	378	renamed_GCF_000008685.2	chromosome	15716	15344	378	100.0	1.768e-79
URI41H	contig_1	51251	50489	762	renamed_GCF_000008685.2	chromosome	51251	50489	762	100.0	1.168e-164
URI41H	contig_1	53461	52453	1008	renamed_GCF_000008685.2	chromosome	53461	52453	1008	100.0	6.65e-221
URI41H	contig_1	55504	53533	1971	renamed_GCF_000008685.2	chromosome	55504	53533	1971	100.0	0.0
URI41H	contig_1	57185	56831	354	renamed_GCF_000008685.2	chromosome	57185	56831	354	100.0	1.322e-78
URI41H	contig_1	59036	58028	1008	renamed_GCF_000008685.2	chromosome	58982	58028	1008	100.0	2.425e-206
URI41H	contig_1	71200	72610	1410	renamed_GCF_000008685.2	chromosome	71200	72610	1410	100.0	2.56e-308
URI41H	contig_1	76449	77700	1251	renamed_GCF_000008685.2	chromosome	76450	77701	1251	100.0	1.724e-268
URI41H	contig_1	79351	79000	351	renamed_GCF_000008685.2	chromosome	79322	79001	351	100.0	3.732e-67
URI41H	contig_1	133841	132470	1371	renamed_GCF_000008685.2	chromosome	133842	132471	1371	100.0	2.422e-302
URI41H	contig_1	137765	135872	1893	renamed_GCF_000008685.2	chromosome	137766	135873	1893	100.0	0.0
URI41H	contig_1	142933	141979	954	renamed_GCF_000008685.2	chromosome	142932	141978	954	100.0	1.517e-202
URI41H	contig_1	146371	145471	900	renamed_GCF_000008685.2	chromosome	146370	145470	900	100.0	6.779e-194
URI41H	contig_1	147496	146377	1119	renamed_GCF_000008685.2	chromosome	147495	146376	1119	100.0	3.727e-246
URI41H	contig_1	152206	153013	807	renamed_GCF_000008685.2	chromosome	152205	153012	807	100.0	9.769e-183
URI41H	contig_1	156401	153701	2700	renamed_GCF_000008685.2	chromosome	156400	153700	2700	100.0	0.0
URI41H	contig_1	226611	224826	1785	renamed_GCF_000008685.2	chromosome	226610	224825	1785	100.0	0.0
URI41H	contig_1	228522	227814	708	renamed_GCF_000008685.2	chromosome	228521	227813	708	100.0	8.763e-159
URI41H	contig_1	231492	230214	1278	renamed_GCF_000008685.2	chromosome	231491	230213	1278	100.0	4.58e-288
URI41H	contig_1	232338	235254	2916	renamed_GCF_000008685.2	chromosome	232337	235253	2916	100.0	0.0
URI41H	contig_1	245790	246555	765	renamed_GCF_000008685.2	chromosome	245789	246554	765	100.0	7.663e-170
URI41H	contig_1	246597	248103	1506	renamed_GCF_000008685.2	chromosome	246596	248102	1506	100.0	0.0
URI41H	contig_1	251212	250657	555	renamed_GCF_000008685.2	chromosome	251211	250656	555	100.0	3.12e-119
URI41H	contig_1	252434	253040	606	renamed_GCF_000008685.2	chromosome	252433	253039	606	100.0	4.115e-133
URI41H	contig_1	479712	481023	1311	renamed_GCF_000008685.2	chromosome	479708	481019	1311	100.0	7.438e-297
URI41H	contig_1	482061	481347	714	renamed_GCF_000008685.2	chromosome	482057	481343	714	100.0	3.944e-160
URI41H	contig_1	482603	484286	1683	renamed_GCF_000008685.2	chromosome	482599	484282	1683	100.0	0.0
URI41H	contig_1	484290	484590	300	renamed_GCF_000008685.2	chromosome	484286	484586	300	100.0	5.976e-62
URI41H	contig_1	484760	485270	510	renamed_GCF_000008685.2	chromosome	484756	485266	510	100.0	1.216e-113
URI41H	contig_1	485553	486081	528	renamed_GCF_000008685.2	chromosome	485549	486077	528	100.0	1.004e-118
URI41H	contig_1	486077	486773	696	renamed_GCF_000008685.2	chromosome	486073	486769	696	100.0	2.835e-152
URI41H	contig_1	486720	487542	822	renamed_GCF_000008685.2	chromosome	486746	487538	822	100.0	1.872e-169
URI41H	contig_1	487538	488228	690	renamed_GCF_000008685.2	chromosome	487534	488224	690	100.0	9.609e-155
URI41H	contig_1	488229	488976	747	renamed_GCF_000008685.2	chromosome	488225	488972	747	100.0	3.778e-166
URI41H	contig_1	507005	507383	378	renamed_GCF_000008685.2	chromosome	507001	507379	378	100.0	8.763e-79
URI41H	contig_1	507409	507802	393	renamed_GCF_000008685.2	chromosome	507405	507798	393	100.0	3.073e-84
URI41H	contig_1	507817	508852	1035	renamed_GCF_000008685.2	chromosome	507813	508848	1035	100.0	4.156e-222
URI41H	contig_1	508873	509245	372	renamed_GCF_000008685.2	chromosome	508869	509241	372	100.0	8.775e-78
URI41H	contig_1	509317	510850	1533	renamed_GCF_000008685.2	chromosome	509313	510846	1533	100.0	0.0
URI41H	contig_1	510839	511628	789	renamed_GCF_000008685.2	chromosome	510835	511624	789	100.0	3.149e-175
URI41H	contig_1	513143	512396	747	renamed_GCF_000008685.2	chromosome	513139	512392	747	100.0	7.284e-159
URI41H	contig_1	513229	514531	1302	renamed_GCF_000008685.2	chromosome	513225	514527	1302	100.0	1.62e-286
URI41H	contig_1	514527	515787	1260	renamed_GCF_000008685.2	chromosome	514523	515783	1260	100.0	5.48e-283
URI41H	contig_1	555214	556579	1365	renamed_GCF_000008685.2	chromosome	555215	556580	1365	100.0	6.28e-308
URI41H	contig_1	557422	556561	861	renamed_GCF_000008685.2	chromosome	557423	556562	861	100.0	5.864e-189
URI41H	contig_1	558023	557405	618	renamed_GCF_000008685.2	chromosome	558024	557406	618	100.0	1.216e-131
URI41H	contig_1	560731	558004	2727	renamed_GCF_000008685.2	chromosome	560732	558005	2727	100.0	0.0
URI41H	contig_1	561126	560727	399	renamed_GCF_000008685.2	chromosome	561127	560728	399	100.0	7.535e-84
URI41H	contig_1	561553	561115	438	renamed_GCF_000008685.2	chromosome	561554	561116	438	100.0	1.44e-91
URI41H	contig_1	561942	561561	381	renamed_GCF_000008685.2	chromosome	561943	561562	381	100.0	2.258e-77
URI41H	contig_1	562183	564166	1983	renamed_GCF_000008685.2	chromosome	562184	564167	1983	100.0	0.0
URI41H	contig_1	565968	567822	1854	renamed_GCF_000008685.2	chromosome	565954	567823	1854	99.8	0.0
URI41H	contig_1	602372	603728	1356	renamed_GCF_000008685.2	chromosome	602373	603729	1356	100.0	2.305e-300
URI41H	contig_1	604768	603724	1044	renamed_GCF_000008685.2	chromosome	604769	603725	1044	100.0	3.194e-235
URI41H	contig_1	606982	604777	2205	renamed_GCF_000008685.2	chromosome	606983	604778	2205	100.0	0.0
URI41H	contig_1	607136	607934	798	renamed_GCF_000008685.2	chromosome	607137	607935	798	100.0	9.72e-173
URI41H	contig_1	609905	609059	846	renamed_GCF_000008685.2	chromosome	609906	609060	846	100.0	3.324e-184
URI41H	contig_1	611192	609941	1251	renamed_GCF_000008685.2	chromosome	611193	609942	1251	100.0	7.081e-270
URI41H	contig_1	611307	612021	714	renamed_GCF_000008685.2	chromosome	611308	612022	714	100.0	1.949e-159
URI41H	contig_1	612046	613984	1938	renamed_GCF_000008685.2	chromosome	612047	613985	1938	100.0	0.0
URI41H	contig_1	615770	614012	1758	renamed_GCF_000008685.2	chromosome	615771	614013	1758	100.0	0.0
URI41H	contig_1	658895	659621	726	renamed_GCF_000008685.2	chromosome	658897	659623	726	100.0	3.429e-155
URI41H	contig_1	661513	659641	1872	renamed_GCF_000008685.2	chromosome	661515	659643	1872	100.0	0.0
URI41H	contig_1	661603	662527	924	renamed_GCF_000008685.2	chromosome	661605	662529	924	100.0	4.691e-202
URI41H	contig_1	662915	662600	315	renamed_GCF_000008685.2	chromosome	662917	662602	315	100.0	5.657e-65
URI41H	contig_1	665009	663176	1833	renamed_GCF_000008685.2	chromosome	665011	663178	1833	100.0	0.0
URI41H	contig_1	668515	665005	3510	renamed_GCF_000008685.2	chromosome	668517	665007	3510	100.0	0.0
URI41H	contig_1	673209	671763	1446	renamed_GCF_000008685.2	chromosome	673167	671766	1446	100.0	1.676e-310
URI41H	contig_1	673338	674775	1437	renamed_GCF_000008685.2	chromosome	673341	674778	1437	100.0	0.0
URI41H	contig_1	745297	746329	1032	renamed_GCF_000008685.2	chromosome	745301	746333	1032	100.0	2.498e-227
URI41H	contig_1	748119	750015	1896	renamed_GCF_000008685.2	chromosome	748122	750018	1896	100.0	0.0
URI41H	contig_1	750027	750786	759	renamed_GCF_000008685.2	chromosome	750030	750789	759	100.0	2.255e-165
URI41H	contig_1	751187	752156	969	renamed_GCF_000008685.2	chromosome	751190	752159	969	100.0	4.772e-218
URI41H	contig_1	752166	753216	1050	renamed_GCF_000008685.2	chromosome	752169	753219	1050	100.0	6.109e-229
URI41H	contig_1	753219	754065	846	renamed_GCF_000008685.2	chromosome	753291	754068	846	100.0	1.342e-168
URI41H	contig_1	754064	754547	483	renamed_GCF_000008685.2	chromosome	754067	754550	483	100.0	1.405e-107
URI41H	contig_1	754546	756346	1800	renamed_GCF_000008685.2	chromosome	754636	756349	1800	100.0	0.0
URI41H	contig_1	756350	757667	1317	renamed_GCF_000008685.2	chromosome	756353	757670	1317	100.0	1.293e-291
URI41H	contig_1	798045	797115	930	renamed_GCF_000008685.2	chromosome	798048	797118	930	100.0	3.063e-199
URI41H	contig_1	799013	798053	960	renamed_GCF_000008685.2	chromosome	799016	798056	960	100.0	6.008e-214
URI41H	contig_1	800272	799204	1068	renamed_GCF_000008685.2	chromosome	800275	799207	1068	100.0	8.292e-246
URI41H	contig_1	800472	801069	597	renamed_GCF_000008685.2	chromosome	800475	801072	597	100.0	2.836e-127
URI41H	contig_1	801007	801775	768	renamed_GCF_000008685.2	chromosome	801118	801778	768	99.5	4.938e-141
URI41H	contig_1	802796	801938	858	renamed_GCF_000008685.2	chromosome	802798	801940	858	100.0	3.462e-177
URI41H	contig_1	803165	802835	330	renamed_GCF_000008685.2	chromosome	803167	802837	330	100.0	2.178e-69
URI41H	contig_1	814704	813696	1008	renamed_GCF_000008685.2	chromosome	814697	813689	1008	100.0	5.214e-215
URI41H	contig_1	815309	814874	435	renamed_GCF_000008685.2	chromosome	815302	814867	435	100.0	4.611e-95
URI41H	contig_1	816306	815508	798	renamed_GCF_000008685.2	chromosome	816299	815501	798	100.0	1.968e-173
URI41H	contig_1	817209	816318	891	renamed_GCF_000008685.2	chromosome	817160	816311	891	99.6	1.029e-187
URI41H	contig_1	817402	817963	561	renamed_GCF_000008685.2	chromosome	817395	817956	561	100.0	3.237e-128
URI41H	contig_1	818024	818555	531	renamed_GCF_000008685.2	chromosome	818017	818548	531	100.0	1.403e-115
URI41H	contig_1	818611	818923	312	renamed_GCF_000008685.2	chromosome	818604	818916	312	100.0	1.086e-65
URI41H	contig_1	818928	819249	321	renamed_GCF_000008685.2	chromosome	819035	819242	321	98.5	2.552e-42
URI41H	contig_1	819248	819494	246	renamed_GCF_000008685.2	chromosome	819241	819487	246	100.0	8.275e-50
URI41H	contig_1	819548	820535	987	renamed_GCF_000008685.2	chromosome	819541	820528	987	100.0	5.255e-220
URI41H	contig_1	886455	884235	2220	renamed_GCF_000008685.2	chromosome	886447	884227	2220	100.0	0.0
URI41H	contig_1	888187	886477	1710	renamed_GCF_000008685.2	chromosome	888179	886469	1710	100.0	0.0
URI41H	contig_1	890329	893182	2853	renamed_GCF_000008685.2	chromosome	890321	893174	2853	100.0	0.0
URI41H	contig_1	893136	896577	3441	renamed_GCF_000008685.2	chromosome	893128	896569	3441	100.0	0.0
URI41H	contig_1	897135	896586	549	renamed_GCF_000008685.2	chromosome	897127	896578	549	100.0	1.159e-120
URI41H	contig_1	897703	897103	600	renamed_GCF_000008685.2	chromosome	897695	897095	600	100.0	6.881e-135
URI41H	contig_1	899328	897711	1617	renamed_GCF_000008685.2	chromosome	899320	897703	1617	100.0	0.0
URI41H	contig_1	899506	900739	1233	renamed_GCF_000008685.2	chromosome	899498	900731	1233	100.0	1.522e-275
URI41H	contig_1	900806	901790	984	renamed_GCF_000008685.2	chromosome	900798	901782	984	100.0	5.014e-220
URI41H	contig_2	4475	5051	576	renamed_GCF_000008685.2	lp56	6835	7411	576	99.4	1.005e-126
URI41H	contig_2	5072	6032	960	renamed_GCF_000008685.2	lp56	7432	8392	960	100.0	6.008e-214
URI41H	contig_2	6506	6890	384	renamed_GCF_000008685.2	lp56	8866	9250	384	100.0	2.931e-83
URI41H	contig_2	6877	7267	390	renamed_GCF_000008685.2	cp32-1	5767	6157	390	100.0	3.229e-83
URI41H	contig_2	7810	8923	1113	renamed_GCF_000008685.2	lp56	10170	11283	1113	99.1	4.082e-244
URI41H	contig_2	8936	9365	429	renamed_GCF_000008685.2	lp56	11296	11725	429	100.0	5.601e-92
URI41H	contig_2	23323	23860	537	renamed_GCF_000008685.2	lp56	25889	26426	537	100.0	1.544e-115
URI41H	contig_2	24357	25683	1326	renamed_GCF_000008685.2	lp56	26920	28246	1326	99.7	7.132e-300
URI41H	contig_2	25735	26161	426	renamed_GCF_000008685.2	lp56	28298	28724	426	100.0	8.877e-95
URI41H	contig_2	26943	26166	777	renamed_GCF_000008685.2	lp56	29506	28729	777	100.0	6.363e-174
URI41H	contig_2	27373	28411	1038	renamed_GCF_000008685.2	lp56	29936	30974	1038	100.0	2.28e-229
URI41H	contig_2	28574	29147	573	renamed_GCF_000008685.2	lp56	31167	31710	573	100.0	2.482e-116
URI41H	contig_2	29328	29895	567	renamed_GCF_000008685.2	lp56	31891	32458	567	100.0	5.734e-123
URI41H	contig_2	29891	31244	1353	renamed_GCF_000008685.2	lp56	32454	33807	1353	100.0	5.71e-307
URI41H	contig_2	32551	33244	693	renamed_GCF_000008685.2	lp56	35114	35807	693	98.2	1.402e-142
URI41H	contig_2	52511	53252	741	renamed_GCF_000008685.2	cp32-3	21256	21997	741	100.0	5.003e-162
URI41H	contig_2	53292	53835	543	renamed_GCF_000008685.2	cp32-1	21560	22118	543	64.0	6.304e-76
URI41H	contig_2	53847	54438	591	renamed_GCF_000008685.2	cp32-3	22592	23183	591	100.0	1.16e-127
URI41H	contig_2	54945	56271	1326	renamed_GCF_000008685.2	cp32-3	23690	25016	1326	100.0	1.445e-300
URI41H	contig_2	56323	56749	426	renamed_GCF_000008685.2	cp32-3	25068	25494	426	100.0	3.62e-96
URI41H	contig_2	57531	56754	777	renamed_GCF_000008685.2	cp32-3	26276	25499	777	100.0	3.144e-173
URI41H	contig_2	57962	58553	591	renamed_GCF_000008685.2	cp32-3	26707	27298	591	100.0	2.345e-128
URI41H	contig_2	58664	59174	510	renamed_GCF_000008685.2	cp32-3	27409	27919	510	100.0	3.969e-109
URI41H	contig_3	9446	10268	822	renamed_GCF_000008685.2	lp54	9456	10278	822	100.0	5.801e-174
URI41H	contig_3	10277	11168	891	renamed_GCF_000008685.2	lp54	10287	11178	891	100.0	1.898e-189
URI41H	contig_3	12984	13569	585	renamed_GCF_000008685.2	lp54	12994	13579	585	100.0	1.763e-130
URI41H	contig_3	13544	14297	753	renamed_GCF_000008685.2	lp54	13554	14307	753	100.0	4.561e-165
URI41H	contig_3	14327	14873	546	renamed_GCF_000008685.2	lp54	14337	14883	546	100.0	1.338e-118
URI41H	contig_3	15359	15791	432	renamed_GCF_000008685.2	lp54	15369	15801	432	100.0	1.792e-96
URI41H	contig_3	16566	15990	576	renamed_GCF_000008685.2	lp54	16576	16000	576	100.0	1.337e-123
URI41H	contig_3	42019	41395	624	renamed_GCF_000008685.2	lp54	42019	41395	624	100.0	3.1e-139
URI41H	contig_3	42266	42473	207	renamed_GCF_000008685.2	lp54	42266	42473	207	100.0	9.856e-42
URI41H	contig_3	43532	42623	909	renamed_GCF_000008685.2	lp54	43532	42623	909	100.0	1.089e-198
URI41H	contig_3	44533	43684	849	renamed_GCF_000008685.2	lp54	44533	43684	849	100.0	7.054e-185
URI41H	contig_3	45941	44711	1230	renamed_GCF_000008685.2	lp54	45947	44711	1230	98.7	1.97e-263
URI41H	contig_3	47222	46466	756	renamed_GCF_000008685.2	lp54	47228	46472	756	100.0	2.151e-165
URI41H	contig_3	48261	47469	792	renamed_GCF_000008685.2	lp54	48267	47475	792	100.0	4.37e-172
URI41H	contig_3	50089	49846	243	renamed_GCF_000008685.2	lp54	50077	49852	243	98.6	5.904e-45
URI41H	contig_3	51170	50279	891	renamed_GCF_000008685.2	lp54	51176	50285	891	100.0	3.698e-199
URI41H	contig_4	42298	42871	573	renamed_GCF_000008685.2	lp28-3	28197	27624	573	100.0	5.735e-124
URI41H	contig_5	187	1081	894	renamed_GCF_000008685.2	lp36	187	1081	894	100.0	7.433e-192
URI41H	contig_5	6040	5287	753	renamed_GCF_000008685.2	lp36	6040	5287	753	100.0	7.287e-160
URI41H	contig_5	6374	6650	276	renamed_GCF_000008685.2	lp36	6365	6650	276	100.0	1.214e-58
URI41H	contig_5	8859	8163	696	renamed_GCF_000008685.2	lp36	8859	8163	696	100.0	1.275e-152
URI41H	contig_5	9372	9999	627	renamed_GCF_000008685.2	lp36	9372	9999	627	100.0	1.942e-136
URI41H	contig_5	30463	29476	987	renamed_GCF_000008685.2	lp36	30463	29476	987	100.0	5.255e-220
URI41H	contig_5	31585	30718	867	renamed_GCF_000008685.2	lp36	31585	30718	867	100.0	3.181e-188
URI41H	contig_5	32822	31826	996	renamed_GCF_000008685.2	lp36	32822	31826	996	100.0	2.481e-221
URI41H	contig_5	34079	33080	999	renamed_GCF_000008685.2	lp36	34079	33080	999	100.0	2.04e-215
URI41H	contig_6	1373	7700	6327	renamed_GCF_000008685.2	lp28-1	26996	28073	6327	55.8	2.643e-94
URI41H	contig_6	11370	11625	255	renamed_GCF_000008685.2	lp28-1	17805	17550	255	100.0	1.423e-53
URI41H	contig_7	12619	13159	540	renamed_GCF_000008685.2	cp32-8	28250	28790	540	98.3	8.011e-115
URI41H	contig_8	21997	23095	1098	renamed_GCF_000008685.2	cp32-7	19116	20214	1098	96.7	8.634e-242
URI41H	contig_9	884	1088	204	renamed_GCF_000008685.2	lp56	18712	18916	204	100.0	2.578e-39
URI41H	contig_9	1756	2110	354	renamed_GCF_000008685.2	cp32-9	16183	16537	354	100.0	1.459e-77
URI41H	contig_9	2874	3303	429	renamed_GCF_000008685.2	cp32-9	17301	17730	429	100.0	2.284e-93
URI41H	contig_10	9408	9834	426	renamed_GCF_000008685.2	cp32-4	24209	24635	426	100.0	8.056e-96
URI41H	contig_10	11203	12019	816	renamed_GCF_000008685.2	cp32-4	26004	26820	816	100.0	2.075e-184
URI41H	contig_10	12874	13402	528	renamed_GCF_000008685.2	cp32-4	27675	28203	528	100.0	1.105e-117
URI41H	contig_10	14145	15498	1353	renamed_GCF_000008685.2	cp32-4	28946	30299	1353	99.7	6.259e-306
URI41H	contig_10	23779	24235	456	renamed_GCF_000008685.2	cp32-4	8281	8737	456	100.0	1.971e-99
URI41H	contig_10	24475	25771	1296	renamed_GCF_000008685.2	cp32-4	8977	10273	1296	100.0	2.13e-282
URI41H	contig_10	26393	27344	951	renamed_GCF_000008685.2	cp32-4	10895	11846	951	100.0	4.333e-216
URI41H	contig_10	27945	28278	333	renamed_GCF_000008685.2	cp32-6	12513	12846	333	100.0	8.424e-72
URI41H	contig_12	29648	29411	237	renamed_GCF_000008685.2	cp32-6	8733	8970	237	100.0	7.893e-49
URI41H	contig_13	1778	977	801	renamed_GCF_000008685.2	lp28-2	28030	28831	801	100.0	3.29e-168
URI41H	contig_13	3152	2723	429	renamed_GCF_000008685.2	lp28-2	26569	27085	429	100.0	3.799e-96
URI41H	contig_13	13326	14352	1026	renamed_GCF_000008685.2	lp28-2	16482	15456	1026	100.0	1.723e-230
URI41H	contig_13	14923	15433	510	renamed_GCF_000008685.2	lp28-2	14885	14375	510	100.0	3.606e-110
URI41H	contig_13	16313	16652	339	renamed_GCF_000008685.2	lp28-2	13495	13156	339	100.0	3.422e-74
URI41H	contig_13	17056	17500	444	renamed_GCF_000008685.2	lp28-2	12752	12308	444	100.0	8.866e-98
URI41H	contig_13	18317	18746	429	renamed_GCF_000008685.2	lp28-2	11491	11062	429	100.0	3.057e-90
URI41H	contig_14	3206	2168	1038	renamed_GCF_000008685.2	cp26	6676	7714	1038	100.0	8.529e-232
URI41H	contig_14	5114	4016	1098	renamed_GCF_000008685.2	cp26	4768	5866	1098	100.0	2.035e-249
URI41H	contig_16	10082	9461	621	renamed_GCF_000008685.2	lp25	10187	9566	621	100.0	1.329e-139
URI41H	contig_26	422	86	336	renamed_GCF_000008685.2	cp32-7	15765	16101	336	98.1	5.906e-68
URI41H	contig_1	42483	41442	1041	renamed_GCF_000008685.2	chromosome	42483	41442	1041	100.0	8.938e-232
URI41H	contig_1	47166	47841	675	renamed_GCF_000008685.2	chromosome	47166	47841	675	100.0	3.937e-145
URI41H	contig_1	49259	48602	657	renamed_GCF_000008685.2	chromosome	49259	48602	657	100.0	2.137e-140
URI41H	contig_1	60039	59100	939	renamed_GCF_000008685.2	chromosome	60039	59100	939	100.0	4.091e-206
URI41H	contig_1	61257	60567	690	renamed_GCF_000008685.2	chromosome	61257	60567	690	100.0	1.401e-150
URI41H	contig_1	63146	64028	882	renamed_GCF_000008685.2	chromosome	63146	64028	882	100.0	1.369e-191
URI41H	contig_1	111566	111044	522	renamed_GCF_000008685.2	chromosome	111567	111045	522	100.0	1.783e-111
URI41H	contig_1	112337	111887	450	renamed_GCF_000008685.2	chromosome	112338	111888	450	100.0	4.387e-98
URI41H	contig_1	122490	121878	612	renamed_GCF_000008685.2	chromosome	122491	121879	612	100.0	3.269e-128
URI41H	contig_1	124813	124147	666	renamed_GCF_000008685.2	chromosome	124814	124148	666	100.0	8.347e-144
URI41H	contig_1	126300	125532	768	renamed_GCF_000008685.2	chromosome	126301	125533	768	100.0	3.291e-171
URI41H	contig_1	130131	127425	2706	renamed_GCF_000008685.2	chromosome	130132	127426	2706	100.0	0.0
URI41H	contig_1	131296	132424	1128	renamed_GCF_000008685.2	chromosome	131297	132425	1128	100.0	3.566e-248
URI41H	contig_1	159368	160043	675	renamed_GCF_000008685.2	chromosome	159367	160042	675	100.0	1.946e-144
URI41H	contig_1	162802	161200	1602	renamed_GCF_000008685.2	chromosome	162801	161199	1602	100.0	0.0
URI41H	contig_1	164821	163072	1749	renamed_GCF_000008685.2	chromosome	164820	163071	1749	100.0	0.0
URI41H	contig_1	195693	197697	2004	renamed_GCF_000008685.2	chromosome	195692	197696	2004	100.0	0.0
URI41H	contig_1	217281	218313	1032	renamed_GCF_000008685.2	chromosome	217277	218312	1032	100.0	9.666e-221
URI41H	contig_1	219635	219056	579	renamed_GCF_000008685.2	chromosome	219634	219055	579	100.0	8.388e-121
URI41H	contig_1	220729	221638	909	renamed_GCF_000008685.2	chromosome	220728	221637	909	100.0	9.393e-192
URI41H	contig_1	223179	223962	783	renamed_GCF_000008685.2	chromosome	223178	223961	783	100.0	3.455e-173
URI41H	contig_1	237143	235595	1548	renamed_GCF_000008685.2	chromosome	237142	235594	1548	100.0	0.0
URI41H	contig_1	237957	237630	327	renamed_GCF_000008685.2	chromosome	237956	237629	327	100.0	8.435e-71
URI41H	contig_1	239129	238301	828	renamed_GCF_000008685.2	chromosome	239128	238300	828	100.0	9.354e-187
URI41H	contig_1	297470	297038	432	renamed_GCF_000008685.2	chromosome	297469	297037	432	100.0	1.974e-95
URI41H	contig_1	299716	298795	921	renamed_GCF_000008685.2	chromosome	299715	298794	921	100.0	4.644e-193
URI41H	contig_1	310524	309780	744	renamed_GCF_000008685.2	chromosome	310523	309779	744	100.0	5.245e-162
URI41H	contig_1	312716	311660	1056	renamed_GCF_000008685.2	chromosome	312715	311659	1056	100.0	1.239e-230
URI41H	contig_1	314429	314147	282	renamed_GCF_000008685.2	chromosome	314427	314145	282	100.0	2.699e-59
URI41H	contig_1	316145	315308	837	renamed_GCF_000008685.2	chromosome	316143	315306	837	100.0	2.887e-184
URI41H	contig_1	318007	317248	759	renamed_GCF_000008685.2	chromosome	318005	317246	759	100.0	1.223e-163
URI41H	contig_1	329263	329623	360	renamed_GCF_000008685.2	chromosome	329261	329621	360	100.0	1.609e-77
URI41H	contig_1	333600	330804	2796	renamed_GCF_000008685.2	chromosome	333598	330802	2796	100.0	0.0
URI41H	contig_1	334938	336510	1572	renamed_GCF_000008685.2	chromosome	334936	336508	1572	99.8	0.0
URI41H	contig_1	338359	339985	1626	renamed_GCF_000008685.2	chromosome	338357	339983	1626	100.0	0.0
URI41H	contig_1	353442	351342	2100	renamed_GCF_000008685.2	chromosome	353437	351340	2100	100.0	0.0
URI41H	contig_1	361201	362323	1122	renamed_GCF_000008685.2	chromosome	361187	362321	1122	100.0	1.01e-252
URI41H	contig_1	374153	373568	585	renamed_GCF_000008685.2	chromosome	374151	373566	585	100.0	4.312e-129
URI41H	contig_1	375662	375941	279	renamed_GCF_000008685.2	chromosome	375660	375939	279	100.0	3.143e-57
URI41H	contig_1	379332	377040	2292	renamed_GCF_000008685.2	chromosome	379258	377038	2292	99.8	0.0
URI41H	contig_1	381894	380556	1338	renamed_GCF_000008685.2	chromosome	381892	380554	1338	100.0	1.408e-311
URI41H	contig_1	384164	383396	768	renamed_GCF_000008685.2	chromosome	384162	383394	768	100.0	1.961e-168
URI41H	contig_1	396508	395482	1026	renamed_GCF_000008685.2	chromosome	396506	395480	1026	100.0	3.003e-224
URI41H	contig_1	397478	397103	375	renamed_GCF_000008685.2	chromosome	397476	397101	375	100.0	1.385e-81
URI41H	contig_1	405619	405244	375	renamed_GCF_000008685.2	chromosome	405617	405242	375	100.0	5.555e-75
URI41H	contig_1	406863	406182	681	renamed_GCF_000008685.2	chromosome	406861	406180	681	100.0	2.702e-150
URI41H	contig_1	407900	407345	555	renamed_GCF_000008685.2	chromosome	407898	407343	555	100.0	5.734e-121
URI41H	contig_1	417725	418337	612	renamed_GCF_000008685.2	chromosome	417723	418335	612	100.0	3.097e-137
URI41H	contig_1	421382	419504	1878	renamed_GCF_000008685.2	chromosome	421380	419502	1878	100.0	0.0
URI41H	contig_1	423059	423839	780	renamed_GCF_000008685.2	chromosome	423054	423834	780	100.0	3.296e-173
URI41H	contig_1	425587	426715	1128	renamed_GCF_000008685.2	chromosome	425583	426711	1128	100.0	1.044e-244
URI41H	contig_1	448595	448205	390	renamed_GCF_000008685.2	chromosome	448591	448201	390	100.0	7.926e-82
URI41H	contig_1	489736	490558	822	renamed_GCF_000008685.2	chromosome	489732	490554	822	100.0	2.749e-182
URI41H	contig_1	492591	493956	1365	renamed_GCF_000008685.2	chromosome	492587	493952	1365	100.0	1.721e-296
URI41H	contig_1	495036	496221	1185	renamed_GCF_000008685.2	chromosome	495032	496217	1185	100.0	4.832e-263
URI41H	contig_1	496618	497239	621	renamed_GCF_000008685.2	chromosome	496614	497235	621	100.0	8.732e-136
URI41H	contig_1	502194	502743	549	renamed_GCF_000008685.2	chromosome	502190	502739	549	100.0	1.698e-116
URI41H	contig_1	502954	503353	399	renamed_GCF_000008685.2	chromosome	502950	503349	399	100.0	3.071e-85
URI41H	contig_1	503929	504289	360	renamed_GCF_000008685.2	chromosome	503925	504285	360	100.0	4.361e-75
URI41H	contig_1	504802	505108	306	renamed_GCF_000008685.2	chromosome	504798	505104	306	100.0	1.468e-61
URI41H	contig_1	505557	506862	1305	renamed_GCF_000008685.2	chromosome	505553	506858	1305	100.0	4.133e-285
URI41H	contig_1	573739	571888	1851	renamed_GCF_000008685.2	chromosome	573740	571889	1851	100.0	0.0
URI41H	contig_1	575815	575272	543	renamed_GCF_000008685.2	chromosome	575816	575273	543	100.0	3.121e-117
URI41H	contig_1	577186	576580	606	renamed_GCF_000008685.2	chromosome	577187	576581	606	100.0	4.975e-131
URI41H	contig_1	590207	589682	525	renamed_GCF_000008685.2	chromosome	590208	589683	525	100.0	5.037e-109
URI41H	contig_1	628947	627090	1857	renamed_GCF_000008685.2	chromosome	628948	627091	1857	100.0	0.0
URI41H	contig_1	630697	629194	1503	renamed_GCF_000008685.2	chromosome	630698	629195	1503	100.0	0.0
URI41H	contig_1	644648	643292	1356	renamed_GCF_000008685.2	chromosome	644650	643294	1356	100.0	1.597e-304
URI41H	contig_1	644769	645138	369	renamed_GCF_000008685.2	chromosome	644771	645140	369	100.0	1.529e-79
URI41H	contig_1	645599	645134	465	renamed_GCF_000008685.2	chromosome	645601	645136	465	100.0	4.176e-101
URI41H	contig_1	645716	646679	963	renamed_GCF_000008685.2	chromosome	645718	646681	963	100.0	1.162e-215
URI41H	contig_1	680560	679750	810	renamed_GCF_000008685.2	chromosome	680557	679753	810	99.6	5.278e-173
URI41H	contig_1	681603	680559	1044	renamed_GCF_000008685.2	chromosome	681606	680562	1044	100.0	8.539e-233
URI41H	contig_1	682521	681681	840	renamed_GCF_000008685.2	chromosome	682524	681684	840	100.0	1.641e-182
URI41H	contig_1	682675	683374	699	renamed_GCF_000008685.2	chromosome	682678	683377	699	100.0	1.337e-152
URI41H	contig_1	683419	684964	1545	renamed_GCF_000008685.2	chromosome	683422	684967	1545	100.0	0.0
URI41H	contig_1	685977	684993	984	renamed_GCF_000008685.2	chromosome	685980	684996	984	100.0	1.708e-223
URI41H	contig_1	697434	696747	687	renamed_GCF_000008685.2	chromosome	697437	696750	687	100.0	2.97e-150
URI41H	contig_1	697582	698329	747	renamed_GCF_000008685.2	chromosome	697585	698332	747	100.0	1.547e-167
URI41H	contig_1	699962	698396	1566	renamed_GCF_000008685.2	chromosome	699965	698399	1566	100.0	0.0
URI41H	contig_1	700921	700048	873	renamed_GCF_000008685.2	chromosome	700924	700051	873	100.0	5.874e-191
URI41H	contig_1	710682	711168	486	renamed_GCF_000008685.2	chromosome	710685	711171	486	100.0	5.304e-102
URI41H	contig_1	711207	711648	441	renamed_GCF_000008685.2	chromosome	711210	711651	441	100.0	1.245e-93
URI41H	contig_1	712204	711688	516	renamed_GCF_000008685.2	chromosome	712207	711691	516	100.0	1.621e-111
URI41H	contig_1	713247	712200	1047	renamed_GCF_000008685.2	chromosome	713250	712203	1047	100.0	1.709e-225
URI41H	contig_1	714104	713240	864	renamed_GCF_000008685.2	chromosome	714107	713243	864	100.0	1.134e-190
URI41H	contig_1	715005	716616	1611	renamed_GCF_000008685.2	chromosome	715008	716619	1611	100.0	0.0
URI41H	contig_1	717739	718642	903	renamed_GCF_000008685.2	chromosome	717742	718669	903	100.0	1.36e-186
URI41H	contig_1	729608	730502	894	renamed_GCF_000008685.2	chromosome	729612	730506	894	100.0	2.531e-195
URI41H	contig_1	731179	731716	537	renamed_GCF_000008685.2	chromosome	731183	731720	537	100.0	1.936e-121
URI41H	contig_1	734076	735285	1209	renamed_GCF_000008685.2	chromosome	734080	735289	1209	100.0	8.188e-270
URI41H	contig_1	764367	765339	972	renamed_GCF_000008685.2	chromosome	764370	765342	972	100.0	2.973e-215
URI41H	contig_1	768061	766729	1332	renamed_GCF_000008685.2	chromosome	768064	766732	1332	100.0	1.239e-294
URI41H	contig_1	783245	782972	273	renamed_GCF_000008685.2	chromosome	783248	782975	273	100.0	3.858e-54
URI41H	contig_1	785053	786751	1698	renamed_GCF_000008685.2	chromosome	785056	786754	1698	100.0	0.0
URI41H	contig_1	789317	789935	618	renamed_GCF_000008685.2	chromosome	789302	789938	618	100.0	3.406e-137
URI41H	contig_1	791784	790803	981	renamed_GCF_000008685.2	chromosome	791787	790806	981	100.0	5.759e-218
URI41H	contig_1	792347	793622	1275	renamed_GCF_000008685.2	chromosome	792350	793625	1275	100.0	1.279e-284
URI41H	contig_1	807964	806917	1047	renamed_GCF_000008685.2	chromosome	807966	806919	1047	100.0	5.315e-230
URI41H	contig_1	809550	808458	1092	renamed_GCF_000008685.2	chromosome	809552	808460	1092	100.0	7.863e-242
URI41H	contig_1	852495	853785	1290	renamed_GCF_000008685.2	chromosome	852488	853778	1290	100.0	6.634e-286
URI41H	contig_1	854875	856003	1128	renamed_GCF_000008685.2	chromosome	854868	855996	1128	100.0	2.385e-261
URI41H	contig_1	857512	858922	1410	renamed_GCF_000008685.2	chromosome	857505	858915	1410	100.0	1.384e-306
URI41H	contig_1	869523	868740	783	renamed_GCF_000008685.2	chromosome	869380	868732	783	99.5	1.931e-145
URI41H	contig_1	872591	870119	2472	renamed_GCF_000008685.2	chromosome	872583	870111	2472	100.0	0.0
URI41H	contig_1	876436	879289	2853	renamed_GCF_000008685.2	chromosome	876491	879281	2853	99.8	0.0
URI41H	contig_1	881099	880274	825	renamed_GCF_000008685.2	chromosome	881091	880266	825	100.0	2.882e-182
URI41H	contig_1	901841	903266	1425	renamed_GCF_000008685.2	chromosome	901833	903258	1425	100.0	1.211e-310
URI41H	contig_1	908414	909599	1185	renamed_GCF_000008685.2	chromosome	908406	909591	1185	100.0	8.142e-266
URI41H	contig_1	914294	913553	741	renamed_GCF_000008685.2	lp17	13338	14079	741	100.0	7.64e-166
URI41H	contig_2	37946	39059	1113	renamed_GCF_000008685.2	cp32-1	6700	7813	1113	100.0	6.876e-247
URI41H	contig_2	46466	46670	204	renamed_GCF_000008685.2	cp32-3	15211	15415	204	100.0	2.578e-39
URI41H	contig_2	47010	47346	336	renamed_GCF_000008685.2	cp32-3	15755	16091	336	100.0	5.348e-69
URI41H	contig_2	47840	48158	318	renamed_GCF_000008685.2	cp32-3	16585	16903	318	100.0	2.414e-66
URI41H	contig_2	49057	49504	447	renamed_GCF_000008685.2	cp32-3	17802	18249	447	100.0	7.667e-100
URI41H	contig_2	50859	51960	1101	renamed_GCF_000008685.2	cp32-3	19604	20705	1101	100.0	1.773e-251
URI41H	contig_3	1450	1960	510	renamed_GCF_000008685.2	lp54	1460	1970	510	100.0	8.829e-109
URI41H	contig_3	4246	2992	1254	renamed_GCF_000008685.2	lp54	4256	3002	1254	100.0	3.245e-279
URI41H	contig_3	5303	5639	336	renamed_GCF_000008685.2	lp54	5313	5649	336	100.0	1.784e-72
URI41H	contig_3	6510	7137	627	renamed_GCF_000008685.2	lp54	6520	7147	627	100.0	4.747e-135
URI41H	contig_3	40112	39872	240	renamed_GCF_000008685.2	lp54	40112	39872	240	100.0	3.722e-49
URI41H	contig_3	51699	52473	774	renamed_GCF_000008685.2	lp54	51705	52479	774	100.0	9.219e-161
URI41H	contig_4	1569	2232	663	renamed_GCF_000008685.2	lp17	11646	10983	663	100.0	1.005e-149
URI41H	contig_4	9618	9396	222	renamed_GCF_000008685.2	lp17	3651	3819	222	100.0	6.565e-33
URI41H	contig_4	29779	30676	897	renamed_GCF_000008685.2	lp28-3	16518	17415	897	100.0	1.518e-201
URI41H	contig_4	31207	31963	756	renamed_GCF_000008685.2	lp28-3	17946	18702	756	100.0	8.81e-167
URI41H	contig_4	34730	35480	750	renamed_GCF_000008685.2	lp28-3	21469	22219	750	100.0	6.33e-161
URI41H	contig_4	39605	38693	912	renamed_GCF_000008685.2	lp28-3	26371	25432	912	100.0	5.639e-198
URI41H	contig_5	10300	11947	1647	renamed_GCF_000008685.2	lp36	10300	11947	1647	100.0	0.0
URI41H	contig_6	25327	25495	168	renamed_GCF_000008685.2	lp28-1	3849	3681	168	100.0	3.274e-31
URI41H	contig_7	5529	6279	750	renamed_GCF_000008685.2	cp32-7	20765	21515	750	100.0	2.593e-162
URI41H	contig_7	6851	7424	573	renamed_GCF_000008685.2	cp32-7	22087	22660	573	100.0	7.629e-121
URI41H	contig_7	21037	21427	390	renamed_GCF_000008685.2	cp32-8	5767	6157	390	100.0	3.229e-83
URI41H	contig_7	23992	24229	237	renamed_GCF_000008685.2	lp56	12192	12429	237	100.0	1.76e-48
URI41H	contig_8	1072	1639	567	renamed_GCF_000008685.2	cp32-1	28834	29401	567	94.1	1.228e-114
URI41H	contig_8	4998	5556	558	renamed_GCF_000008685.2	cp32-3	2010	2568	558	100.0	1.105e-122
URI41H	contig_8	18185	18389	204	renamed_GCF_000008685.2	cp32-8	15214	15418	204	100.0	2.578e-39
URI41H	contig_10	21275	21665	390	renamed_GCF_000008685.2	cp32-3	5767	6157	390	100.0	3.229e-83
URI41H	contig_10	23335	23764	429	renamed_GCF_000008685.2	cp32-4	7837	8266	429	100.0	5.601e-92
URI41H	contig_11	10922	11207	285	renamed_GCF_000008685.2	cp9	4788	4503	285	96.8	3.136e-58
URI41H	contig_11	12913	12001	912	renamed_GCF_000008685.2	cp9	2803	3712	912	99.3	1.323e-205
URI41H	contig_11	14524	14965	441	renamed_GCF_000008685.2	cp9	1281	1839	441	98.6	4.183e-97
URI41H	contig_11	18293	18833	540	renamed_GCF_000008685.2	cp9	6808	6280	540	87.1	4.907e-95
URI41H	contig_12	23151	22947	204	renamed_GCF_000008685.2	cp32-9	15311	15515	204	100.0	2.578e-39
URI41H	contig_13	7149	7536	387	renamed_GCF_000008685.2	lp28-2	22659	22272	387	100.0	4.63e-87
URI41H	contig_13	10189	10972	783	renamed_GCF_000008685.2	lp28-2	19619	18836	783	100.0	1.354e-183
URI41H	contig_13	11789	12128	339	renamed_GCF_000008685.2	lp28-2	18019	17680	339	100.0	5.085e-70
URI41H	contig_13	23072	22520	552	renamed_GCF_000008685.2	lp28-2	6736	7288	552	100.0	2.704e-120
URI41H	contig_13	24431	23858	573	renamed_GCF_000008685.2	lp28-2	5377	5950	573	100.0	1.602e-129
URI41H	contig_13	29693	28799	894	renamed_GCF_000008685.2	lp28-2	115	1009	894	100.0	3.048e-193
URI41H	contig_14	11556	9927	1629	renamed_GCF_000008685.2	cp26	24824	26453	1629	100.0	0.0
URI41H	contig_14	13226	13778	552	renamed_GCF_000008685.2	cp26	23154	22602	552	100.0	6.015e-120
URI41H	contig_16	13288	12724	564	renamed_GCF_000008685.2	lp25	13393	12829	564	100.0	4.519e-125
URI41H	contig_16	15473	14936	537	renamed_GCF_000008685.2	lp25	15545	15041	537	99.4	7.638e-115
URI41H	contig_16	22583	21851	732	renamed_GCF_000008685.2	lp25	22677	21945	732	100.0	5.239e-160
URI41H	contig_1	1795	766	1029	renamed_GCF_000008685.2	chromosome	1796	767	1029	100.0	4.829e-228
URI41H	contig_1	22818	23958	1140	renamed_GCF_000008685.2	chromosome	22818	23958	1140	100.0	2.624e-262
URI41H	contig_1	24696	23964	732	renamed_GCF_000008685.2	chromosome	24696	23964	732	100.0	2.844e-158
URI41H	contig_1	26398	27448	1050	renamed_GCF_000008685.2	chromosome	26398	27448	1050	100.0	7.794e-235
URI41H	contig_1	28490	27854	636	renamed_GCF_000008685.2	chromosome	28490	27854	636	100.0	8.334e-139
URI41H	contig_1	29542	31015	1473	renamed_GCF_000008685.2	chromosome	29542	31015	1473	99.7	0.0
URI41H	contig_1	32089	31549	540	renamed_GCF_000008685.2	chromosome	32089	31549	540	100.0	3.274e-116
URI41H	contig_1	35836	34036	1800	renamed_GCF_000008685.2	chromosome	35836	34036	1800	100.0	0.0
URI41H	contig_1	39638	38135	1503	renamed_GCF_000008685.2	chromosome	39638	38135	1503	100.0	0.0
URI41H	contig_1	50474	50111	363	renamed_GCF_000008685.2	chromosome	50474	50111	363	100.0	4.578e-75
URI41H	contig_1	96952	94609	2343	renamed_GCF_000008685.2	chromosome	96953	94610	2343	100.0	0.0
URI41H	contig_1	98647	97861	786	renamed_GCF_000008685.2	chromosome	98648	97862	786	100.0	2.735e-176
URI41H	contig_1	100226	100748	522	renamed_GCF_000008685.2	chromosome	100227	100749	522	100.0	2.976e-114
URI41H	contig_1	102948	101523	1425	renamed_GCF_000008685.2	chromosome	102949	101524	1425	100.0	1.009e-312
URI41H	contig_1	114602	112907	1695	renamed_GCF_000008685.2	chromosome	114603	112908	1695	100.0	0.0
URI41H	contig_1	116805	115503	1302	renamed_GCF_000008685.2	chromosome	116806	115504	1302	100.0	1.776e-285
URI41H	contig_1	118369	117676	693	renamed_GCF_000008685.2	chromosome	118370	117677	693	100.0	4.532e-155
URI41H	contig_1	119802	118962	840	renamed_GCF_000008685.2	chromosome	119803	118963	840	100.0	4.393e-180
URI41H	contig_1	121081	120802	279	renamed_GCF_000008685.2	chromosome	121082	120803	279	100.0	1.411e-57
URI41H	contig_1	133973	135863	1890	renamed_GCF_000008685.2	chromosome	133974	135864	1890	100.0	0.0
URI41H	contig_1	186949	187195	246	renamed_GCF_000008685.2	chromosome	186948	187194	246	100.0	9.168e-49
URI41H	contig_1	188238	187824	414	renamed_GCF_000008685.2	chromosome	188237	187823	414	100.0	2.918e-88
URI41H	contig_1	201051	199965	1086	renamed_GCF_000008685.2	chromosome	201050	199964	1086	100.0	2.679e-244
URI41H	contig_1	202850	204089	1239	renamed_GCF_000008685.2	chromosome	202849	204088	1239	100.0	5.514e-262
URI41H	contig_1	205073	206045	972	renamed_GCF_000008685.2	chromosome	205174	206044	972	99.6	3.289e-188
URI41H	contig_1	208621	208084	537	renamed_GCF_000008685.2	chromosome	208581	208083	537	99.3	7.373e-107
URI41H	contig_1	224786	223964	822	renamed_GCF_000008685.2	chromosome	224785	223963	822	100.0	3.638e-179
URI41H	contig_1	227828	226610	1218	renamed_GCF_000008685.2	chromosome	227827	226609	1218	100.0	6.126e-266
URI41H	contig_1	266107	267052	945	renamed_GCF_000008685.2	chromosome	266106	267051	945	100.0	6.277e-211
URI41H	contig_1	272681	270488	2193	renamed_GCF_000008685.2	chromosome	272641	270487	2193	100.0	0.0
URI41H	contig_1	285960	283869	2091	renamed_GCF_000008685.2	chromosome	285962	283868	2091	99.8	0.0
URI41H	contig_1	287878	287089	789	renamed_GCF_000008685.2	chromosome	287877	287088	789	100.0	1.783e-164
URI41H	contig_1	288947	288182	765	renamed_GCF_000008685.2	chromosome	288946	288181	765	100.0	2.478e-165
URI41H	contig_1	289918	289576	342	renamed_GCF_000008685.2	chromosome	289917	289575	342	100.0	1.077e-70
URI41H	contig_1	291596	291059	537	renamed_GCF_000008685.2	chromosome	291595	291058	537	100.0	7.638e-115
URI41H	contig_1	302490	300780	1710	renamed_GCF_000008685.2	chromosome	302489	300779	1710	100.0	0.0
URI41H	contig_1	303310	302851	459	renamed_GCF_000008685.2	chromosome	303309	302850	459	100.0	4.601e-99
URI41H	contig_1	345064	346366	1302	renamed_GCF_000008685.2	chromosome	345062	346364	1302	100.0	6.07e-289
URI41H	contig_1	347303	346862	441	renamed_GCF_000008685.2	chromosome	347301	346860	441	100.0	1.706e-98
URI41H	contig_1	349612	348154	1458	renamed_GCF_000008685.2	chromosome	349610	348152	1458	100.0	0.0
URI41H	contig_1	351333	351057	276	renamed_GCF_000008685.2	chromosome	351331	351055	276	100.0	8.162e-55
URI41H	contig_1	365605	365116	489	renamed_GCF_000008685.2	chromosome	365603	365114	489	100.0	3.787e-106
URI41H	contig_1	368457	368883	426	renamed_GCF_000008685.2	chromosome	368455	368881	426	100.0	3.899e-87
URI41H	contig_1	370028	371015	987	renamed_GCF_000008685.2	chromosome	370026	371013	987	100.0	7.343e-225
URI41H	contig_1	373141	373522	381	renamed_GCF_000008685.2	chromosome	373139	373520	381	100.0	1.683e-80
URI41H	contig_8	29021	29729	708	renamed_GCF_000008685.2	cp32-7	26151	26841	708	83.9	2.557e-121
URI41H	contig_9	1091	1439	348	renamed_GCF_000008685.2	cp32-9	15518	15866	348	100.0	8.822e-74
URI41H	contig_9	1428	1764	336	renamed_GCF_000008685.2	cp32-9	15855	16191	336	100.0	5.348e-69
URI41H	contig_9	2214	2769	555	renamed_GCF_000008685.2	cp32-9	16641	17196	555	100.0	1.867e-116
URI41H	contig_9	4736	5837	1101	renamed_GCF_000008685.2	cp32-9	19163	20264	1101	100.0	3.592e-252
URI41H	contig_10	13582	14149	567	renamed_GCF_000008685.2	cp32-4	28383	28950	567	100.0	1.275e-122
URI41H	contig_10	15563	16787	1224	renamed_GCF_000008685.2	cp32-4	65	1289	1224	100.0	4.655e-270
URI41H	contig_10	25793	26390	597	renamed_GCF_000008685.2	cp32-4	10295	10892	597	100.0	4.743e-130
URI41H	contig_10	28274	29150	876	renamed_GCF_000008685.2	cp32-4	12776	13652	876	100.0	5.609e-192
URI41H	contig_10	29159	29765	606	renamed_GCF_000008685.2	cp32-4	13661	14267	606	100.0	5.47e-130
URI41H	contig_11	27695	26702	993	renamed_GCF_000008685.2	lp21	16885	17878	993	100.0	1.858e-215
URI41H	contig_12	16862	16283	579	renamed_GCF_000008685.2	cp32-6	21519	22098	579	100.0	5.735e-125
URI41H	contig_12	18203	17636	567	renamed_GCF_000008685.2	cp32-6	20178	20745	567	100.0	6.547e-130
URI41H	contig_12	25868	25535	333	renamed_GCF_000008685.2	cp32-1	12494	12827	333	100.0	8.424e-72
URI41H	contig_12	28107	27423	684	renamed_GCF_000008685.2	cp32-8	10264	10948	684	100.0	3.113e-149
URI41H	contig_13	190	955	765	renamed_GCF_000008685.2	lp28-2	29618	28853	765	100.0	1.703e-169
URI41H	contig_13	2696	1868	828	renamed_GCF_000008685.2	lp28-2	27112	27940	828	100.0	3.316e-181
URI41H	contig_13	12124	13315	1191	renamed_GCF_000008685.2	lp28-2	17684	16493	1191	100.0	6.781e-269
URI41H	contig_13	14377	14923	546	renamed_GCF_000008685.2	lp28-2	15431	14885	546	100.0	8.811e-115
URI41H	contig_13	15467	16301	834	renamed_GCF_000008685.2	lp28-2	14341	13507	834	100.0	1.239e-184
URI41H	contig_13	16667	17060	393	renamed_GCF_000008685.2	lp28-2	13141	12748	393	100.0	6.841e-84
URI41H	contig_15	3237	4074	837	renamed_GCF_000008685.2	lp28-4	22931	22094	837	100.0	1.426e-183
URI41H	contig_16	6792	7656	864	renamed_GCF_000008685.2	lp25	6897	7761	864	97.5	5.599e-190
URI41H	contig_16	24100	23734	366	renamed_GCF_000008685.2	lp21	252	618	366	98.3	7.963e-78
URI41H	contig_17	6825	3564	3261	renamed_GCF_000008685.2	lp56	43696	40435	3261	100.0	0.0
URI41H	contig_1	45445	45991	546	renamed_GCF_000008685.2	chromosome	45445	45991	546	100.0	3.273e-117
URI41H	contig_1	46379	46010	369	renamed_GCF_000008685.2	chromosome	46379	46010	369	100.0	3.085e-80
URI41H	contig_1	47904	48606	702	renamed_GCF_000008685.2	chromosome	47916	48606	702	100.0	4.54e-148
URI41H	contig_1	49340	50012	672	renamed_GCF_000008685.2	chromosome	49340	50012	672	100.0	9.591e-152
URI41H	contig_1	60533	60035	498	renamed_GCF_000008685.2	chromosome	60533	60035	498	100.0	3.278e-109
URI41H	contig_1	64037	65276	1239	renamed_GCF_000008685.2	chromosome	64037	65276	1239	100.0	5.707e-279
URI41H	contig_1	67247	69569	2322	renamed_GCF_000008685.2	chromosome	67247	69569	2322	100.0	0.0
URI41H	contig_1	81403	82939	1536	renamed_GCF_000008685.2	chromosome	81404	82940	1536	100.0	0.0
URI41H	contig_1	124145	122489	1656	renamed_GCF_000008685.2	chromosome	124146	122490	1656	100.0	0.0
URI41H	contig_1	125546	124796	750	renamed_GCF_000008685.2	chromosome	125547	124797	750	100.0	1.281e-161
URI41H	contig_1	127412	126314	1098	renamed_GCF_000008685.2	chromosome	127413	126315	1098	100.0	1.369e-236
URI41H	contig_1	131113	130168	945	renamed_GCF_000008685.2	chromosome	131114	130169	945	100.0	6.888e-210
URI41H	contig_1	158628	159345	717	renamed_GCF_000008685.2	chromosome	158627	159344	717	100.0	1.01e-158
URI41H	contig_1	160090	161209	1119	renamed_GCF_000008685.2	chromosome	160089	161208	1119	100.0	2.349e-251
URI41H	contig_1	162878	163046	168	renamed_GCF_000008685.2	chromosome	162877	163045	168	100.0	5.294e-34
URI41H	contig_1	165888	164901	987	renamed_GCF_000008685.2	chromosome	165887	164900	987	100.0	2.687e-210
URI41H	contig_1	169400	167879	1521	renamed_GCF_000008685.2	chromosome	169399	167878	1521	100.0	0.0
URI41H	contig_1	171098	170720	378	renamed_GCF_000008685.2	chromosome	171097	170719	378	100.0	1.603e-80
URI41H	contig_1	215427	217260	1833	renamed_GCF_000008685.2	chromosome	215426	217259	1833	100.0	0.0
URI41H	contig_1	219079	218425	654	renamed_GCF_000008685.2	chromosome	219078	218424	654	100.0	1.052e-147
URI41H	contig_1	219800	220640	840	renamed_GCF_000008685.2	chromosome	219799	220639	840	100.0	1.641e-182
URI41H	contig_1	221634	223179	1545	renamed_GCF_000008685.2	chromosome	221741	223178	1545	99.7	1.424e-311
URI41H	contig_1	235535	235289	246	renamed_GCF_000008685.2	chromosome	235534	235288	246	100.0	3.025e-52
URI41H	contig_1	237630	237222	408	renamed_GCF_000008685.2	chromosome	237629	237221	408	100.0	2.649e-88
URI41H	contig_1	238227	237969	258	renamed_GCF_000008685.2	chromosome	238226	237968	258	100.0	9.113e-51
URI41H	contig_1	240251	239144	1107	renamed_GCF_000008685.2	chromosome	240250	239143	1107	100.0	3.718e-244
URI41H	contig_1	242438	244004	1566	renamed_GCF_000008685.2	chromosome	242437	244003	1566	100.0	0.0
URI41H	contig_1	273648	272634	1014	renamed_GCF_000008685.2	chromosome	273647	272633	1014	100.0	5.532e-224
URI41H	contig_1	311654	310559	1095	renamed_GCF_000008685.2	chromosome	311617	310558	1095	99.7	2.491e-229
URI41H	contig_1	314125	312733	1392	renamed_GCF_000008685.2	chromosome	314123	312728	1392	100.0	1.047e-306
URI41H	contig_1	315316	314425	891	renamed_GCF_000008685.2	chromosome	315314	314423	891	100.0	4.455e-197
URI41H	contig_1	317218	316141	1077	renamed_GCF_000008685.2	chromosome	317216	316139	1077	100.0	1.824e-238
URI41H	contig_1	328033	329167	1134	renamed_GCF_000008685.2	chromosome	328031	329165	1134	100.0	5.485e-253
URI41H	contig_1	330754	329644	1110	renamed_GCF_000008685.2	chromosome	330752	329642	1110	100.0	1.105e-249
URI41H	contig_1	334517	333620	897	renamed_GCF_000008685.2	chromosome	334515	333618	897	100.0	1.666e-200
URI41H	contig_1	340342	341263	921	renamed_GCF_000008685.2	chromosome	340340	341261	921	100.0	2.92e-198
URI41H	contig_1	341275	342325	1050	renamed_GCF_000008685.2	chromosome	341273	342323	1050	100.0	1.489e-227
URI41H	contig_1	380560	379342	1218	renamed_GCF_000008685.2	chromosome	380558	379340	1218	100.0	1.741e-271
URI41H	contig_1	383384	381911	1473	renamed_GCF_000008685.2	chromosome	383382	381909	1473	100.0	0.0
URI41H	contig_1	384288	385428	1140	renamed_GCF_000008685.2	chromosome	384286	385426	1140	100.0	7.242e-251
URI41H	contig_1	397079	396605	474	renamed_GCF_000008685.2	chromosome	397077	396603	474	100.0	4.822e-101
URI41H	contig_1	401679	397545	4134	renamed_GCF_000008685.2	chromosome	401677	397543	4134	100.0	0.0
URI41H	contig_1	406178	405689	489	renamed_GCF_000008685.2	chromosome	406176	405687	489	100.0	1.238e-101
URI41H	contig_1	407294	406862	432	renamed_GCF_000008685.2	chromosome	407292	406860	432	100.0	3.534e-89
URI41H	contig_1	417103	417715	612	renamed_GCF_000008685.2	chromosome	417101	417713	612	100.0	4.975e-132
URI41H	contig_1	419508	418389	1119	renamed_GCF_000008685.2	chromosome	419506	418387	1119	100.0	8.015e-255
URI41H	contig_1	421555	422185	630	renamed_GCF_000008685.2	chromosome	421553	422183	630	100.0	5.705e-142
URI41H	contig_1	474616	475606	990	renamed_GCF_000008685.2	chromosome	474612	475602	990	100.0	3.939e-215
URI41H	contig_1	478078	476266	1812	renamed_GCF_000008685.2	chromosome	478005	476262	1812	100.0	0.0
URI41H	contig_1	489495	489723	228	renamed_GCF_000008685.2	chromosome	489539	489719	228	100.0	1.455e-33
URI41H	contig_1	490647	491931	1284	renamed_GCF_000008685.2	chromosome	490643	491927	1284	100.0	9.564e-281
URI41H	contig_1	494546	494153	393	renamed_GCF_000008685.2	chromosome	494539	494149	393	100.0	4.545e-80
URI41H	contig_1	496271	496583	312	renamed_GCF_000008685.2	chromosome	496267	496579	312	100.0	2.953e-63
URI41H	contig_1	497248	497878	630	renamed_GCF_000008685.2	chromosome	497244	497874	630	100.0	4.528e-136
URI41H	contig_1	502759	502945	186	renamed_GCF_000008685.2	chromosome	502755	502941	186	100.0	7.664e-41
URI41H	contig_1	503369	503912	543	renamed_GCF_000008685.2	chromosome	503365	503908	543	100.0	7.636e-116
URI41H	contig_1	504301	504799	498	renamed_GCF_000008685.2	chromosome	504297	504795	498	100.0	1.785e-107
URI41H	contig_1	553990	555211	1221	renamed_GCF_000008685.2	chromosome	553991	555212	1221	100.0	5.34e-268
URI41H	contig_1	568268	569138	870	renamed_GCF_000008685.2	chromosome	568269	569139	870	100.0	1.737e-195
URI41H	contig_1	569276	569537	261	renamed_GCF_000008685.2	chromosome	569277	569538	261	100.0	9.575e-51
URI41H	contig_1	571281	571851	570	renamed_GCF_000008685.2	chromosome	571282	571852	570	100.0	1.471e-121
URI41H	contig_1	573851	575246	1395	renamed_GCF_000008685.2	chromosome	573852	575247	1395	100.0	2.85e-313
URI41H	contig_1	576525	575979	546	renamed_GCF_000008685.2	chromosome	576499	575980	546	100.0	1.781e-115
URI41H	contig_1	588064	589666	1602	renamed_GCF_000008685.2	chromosome	588065	589667	1602	100.0	0.0
URI41H	contig_1	590346	590934	588	renamed_GCF_000008685.2	chromosome	590347	590935	588	100.0	4.112e-130
URI41H	contig_1	621952	621043	909	renamed_GCF_000008685.2	chromosome	621953	621044	909	100.0	1.521e-203
URI41H	contig_1	622003	623446	1443	renamed_GCF_000008685.2	chromosome	622004	623447	1443	100.0	0.0
URI41H	contig_1	623449	625006	1557	renamed_GCF_000008685.2	chromosome	623450	625007	1557	100.0	0.0
URI41H	contig_1	625005	626259	1254	renamed_GCF_000008685.2	chromosome	625006	626260	1254	100.0	1.925e-276
URI41H	contig_1	626284	627037	753	renamed_GCF_000008685.2	chromosome	626285	627038	753	100.0	9.23e-166
URI41H	contig_1	714763	714100	663	renamed_GCF_000008685.2	chromosome	714766	714103	663	100.0	1.333e-146
URI41H	contig_1	716616	717768	1152	renamed_GCF_000008685.2	chromosome	716619	717771	1152	100.0	1.261e-246
URI41H	contig_1	718822	721084	2262	renamed_GCF_000008685.2	chromosome	718826	721088	2262	100.0	0.0
URI41H	contig_1	721114	723016	1902	renamed_GCF_000008685.2	chromosome	721118	723020	1902	100.0	0.0
URI41H	contig_1	724126	723058	1068	renamed_GCF_000008685.2	chromosome	724130	723062	1068	100.0	3.402e-247
URI41H	contig_1	739680	740172	492	renamed_GCF_000008685.2	chromosome	739684	740176	492	100.0	4.374e-105
URI41H	contig_1	740441	740684	243	renamed_GCF_000008685.2	chromosome	740445	740688	243	100.0	1.755e-49
URI41H	contig_1	742624	741391	1233	renamed_GCF_000008685.2	chromosome	742628	741395	1233	100.0	3.707e-274
URI41H	contig_1	744517	744841	324	renamed_GCF_000008685.2	chromosome	744521	744845	324	100.0	1.32e-65
URI41H	contig_1	759582	760212	630	renamed_GCF_000008685.2	chromosome	759585	760215	630	100.0	3.747e-138
URI41H	contig_1	763575	764358	783	renamed_GCF_000008685.2	chromosome	763578	764361	783	100.0	1.874e-171
URI41H	contig_1	765369	766713	1344	renamed_GCF_000008685.2	chromosome	765372	766716	1344	100.0	2.685e-305
URI41H	contig_1	769467	768075	1392	renamed_GCF_000008685.2	chromosome	769470	768078	1392	100.0	1.696e-292
URI41H	contig_1	783386	785018	1632	renamed_GCF_000008685.2	chromosome	783389	785021	1632	100.0	0.0
URI41H	contig_1	823269	823818	549	renamed_GCF_000008685.2	chromosome	823262	823811	549	100.0	1.698e-116
URI41H	contig_1	824388	825711	1323	renamed_GCF_000008685.2	chromosome	824381	825704	1323	100.0	8.966e-297
URI41H	contig_1	827637	829119	1482	renamed_GCF_000008685.2	chromosome	827630	829112	1482	100.0	0.0
URI41H	contig_1	847132	847495	363	renamed_GCF_000008685.2	chromosome	847125	847488	363	100.0	2.269e-74
URI41H	contig_1	848544	848811	267	renamed_GCF_000008685.2	chromosome	848537	848804	267	100.0	3.495e-54
URI41H	contig_1	851000	852521	1521	renamed_GCF_000008685.2	chromosome	850993	852514	1521	100.0	0.0
URI41H	contig_1	853781	854849	1068	renamed_GCF_000008685.2	chromosome	853774	854842	1068	100.0	1.362e-231
URI41H	contig_1	855995	857516	1521	renamed_GCF_000008685.2	chromosome	855988	857509	1521	100.0	0.0
URI41H	contig_1	868202	868748	546	renamed_GCF_000008685.2	chromosome	868194	868740	546	100.0	1.846e-123
URI41H	contig_1	870031	869515	516	renamed_GCF_000008685.2	chromosome	870023	869507	516	100.0	1.621e-111
URI41H	contig_2	16264	16468	204	renamed_GCF_000008685.2	cp32-4	15166	15370	204	100.0	2.578e-39
URI41H	contig_2	35208	36168	960	renamed_GCF_000008685.2	cp32-1	3962	4922	960	100.0	6.593e-213
URI41H	contig_2	36642	37026	384	renamed_GCF_000008685.2	cp32-1	5396	5780	384	100.0	2.931e-83
URI41H	contig_2	37399	37966	567	renamed_GCF_000008685.2	cp32-3	6153	6720	567	100.0	9.584e-126
URI41H	contig_2	39073	39502	429	renamed_GCF_000008685.2	cp32-7	7829	8258	429	100.0	5.601e-92
URI41H	contig_3	28003	28921	918	renamed_GCF_000008685.2	lp54	28013	28931	918	100.0	2.109e-201
URI41H	contig_3	29373	29748	375	renamed_GCF_000008685.2	lp54	29383	29758	375	100.0	1.685e-79
URI41H	contig_3	30083	30623	540	renamed_GCF_000008685.2	lp54	30093	30633	540	100.0	4.969e-120
URI41H	contig_3	31779	32202	423	renamed_GCF_000008685.2	lp54	31779	32202	423	100.0	5.086e-92
URI41H	contig_3	32741	32960	219	renamed_GCF_000008685.2	lp54	32741	32960	219	100.0	7.958e-46
URI41H	contig_3	34987	35833	846	renamed_GCF_000008685.2	lp54	34987	35833	846	99.6	2.758e-186
URI41H	contig_3	36267	36534	267	renamed_GCF_000008685.2	lp54	36255	36534	267	97.7	3.495e-54
URI41H	contig_3	39405	38160	1245	renamed_GCF_000008685.2	lp54	39405	38160	1245	100.0	4.898e-273
URI41H	contig_3	41045	40211	834	renamed_GCF_000008685.2	lp54	41045	40211	834	100.0	3.319e-182
URI41H	contig_3	52699	53497	798	renamed_GCF_000008685.2	lp54	52705	53503	798	100.0	3.008e-177
URI41H	contig_4	40706	40238	468	renamed_GCF_000008685.2	lp28-3	27445	26977	468	99.3	1.339e-105
URI41H	contig_5	12601	13237	636	renamed_GCF_000008685.2	lp36	12601	13237	636	100.0	3.41e-140
URI41H	contig_5	14841	14301	540	renamed_GCF_000008685.2	lp36	14841	14301	540	100.0	2.234e-120
URI41H	contig_5	16274	16886	612	renamed_GCF_000008685.2	lp36	16274	16886	612	100.0	9.153e-134
URI41H	contig_6	13725	14826	1101	renamed_GCF_000008685.2	lp28-1	15451	14350	1101	100.0	2.133e-249
URI41H	contig_6	15383	16148	765	renamed_GCF_000008685.2	lp28-1	13793	13028	765	100.0	1.871e-168
URI41H	contig_8	15796	16675	879	renamed_GCF_000008685.2	cp32-7	12831	13710	879	99.3	7.082e-190
URI41H	contig_8	17295	18111	816	renamed_GCF_000008685.2	cp32-4	14276	15092	816	97.7	4.382e-176
URI41H	contig_8	18392	18740	348	renamed_GCF_000008685.2	cp32-3	15418	15766	348	100.0	3.962e-74
URI41H	contig_8	18729	19065	336	renamed_GCF_000008685.2	cp32-4	15710	16046	336	100.0	5.348e-69
URI41H	contig_9	5847	6414	567	renamed_GCF_000008685.2	cp32-9	20274	20841	567	100.0	1.456e-129
URI41H	contig_9	7186	7747	561	renamed_GCF_000008685.2	cp32-9	21613	22174	561	100.0	6.308e-121
URI41H	contig_9	29142	30018	876	renamed_GCF_000008685.2	cp32-9	12921	13797	876	100.0	2.77e-191
URI41H	contig_10	572	920	348	renamed_GCF_000008685.2	cp32-4	15373	15721	348	100.0	3.962e-74
URI41H	contig_10	909	1245	336	renamed_GCF_000008685.2	cp32-6	15774	16110	336	100.0	5.348e-69
URI41H	contig_10	18077	18845	768	renamed_GCF_000008685.2	cp32-4	2579	3347	768	100.0	3.291e-171
URI41H	contig_10	21661	22228	567	renamed_GCF_000008685.2	cp32-4	6163	6730	567	100.0	1.054e-124
URI41H	contig_10	22208	23321	1113	renamed_GCF_000008685.2	cp32-4	6710	7823	1113	100.0	1.393e-247
URI41H	contig_11	1806	2595	789	renamed_GCF_000008685.2	lp21	2867	3656	789	99.6	6.373e-176
URI41H	contig_13	3829	3418	411	renamed_GCF_000008685.2	lp28-2	25979	26390	411	100.0	2.076e-91
URI41H	contig_13	5320	3853	1467	renamed_GCF_000008685.2	lp28-2	24488	25955	1467	100.0	0.0
URI41H	contig_13	5700	6087	387	renamed_GCF_000008685.2	lp28-2	24108	23721	387	100.0	1.013e-78
URI41H	contig_13	6083	6776	693	renamed_GCF_000008685.2	lp28-2	23725	23032	693	100.0	4.125e-156
URI41H	contig_13	6775	7150	375	renamed_GCF_000008685.2	lp28-2	23033	22658	375	100.0	2.05e-77
URI41H	contig_13	7504	10189	2685	renamed_GCF_000008685.2	lp28-2	22259	19619	2685	99.8	0.0
URI41H	contig_13	10981	11779	798	renamed_GCF_000008685.2	lp28-2	18827	18029	798	100.0	7.719e-184
URI41H	contig_13	23898	23130	768	renamed_GCF_000008685.2	lp28-2	5910	6678	768	100.0	2.365e-166
URI41H	contig_13	28762	27880	882	renamed_GCF_000008685.2	lp28-2	1046	1928	882	100.0	1.741e-197
URI41H	contig_14	13126	11881	1245	renamed_GCF_000008685.2	cp26	23254	24499	1245	100.0	1.056e-281
URI41H	contig_14	14483	13787	696	renamed_GCF_000008685.2	cp26	21897	22593	696	100.0	1.401e-151
URI41H	contig_14	15016	15523	507	renamed_GCF_000008685.2	cp26	21364	20857	507	100.0	3.123e-111
URI41H	contig_14	17059	18415	1356	renamed_GCF_000008685.2	cp26	19321	17965	1356	100.0	1.971e-293
URI41H	contig_14	19713	21249	1536	renamed_GCF_000008685.2	cp26	16667	15131	1536	100.0	0.0
URI41H	contig_15	6985	7651	666	renamed_GCF_000008685.2	lp28-4	19183	18517	666	100.0	3.109e-146
URI41H	contig_15	10817	9638	1179	renamed_GCF_000008685.2	lp28-4	15351	16530	1179	100.0	4.972e-253
URI41H	contig_20	191	740	549	renamed_GCF_000008685.2	lp56	855	1407	549	98.3	3.12e-118