QUERY_ID	QUERY_NAME	QUERY_START	QUERY_END	QUERY_LENGTH	REF_ID	REF_NAME	REF_START	REF_END	REF_LENGTH	IDENTITY	EVALUE
UCT31H	contig_1	54718	53197	1521	renamed_GCF_000008685.2	chromosome	855988	857509	1521	100.0	0.0
UCT31H	contig_1	55838	54710	1128	renamed_GCF_000008685.2	chromosome	854868	855996	1128	100.0	2.385e-261
UCT31H	contig_1	56932	55864	1068	renamed_GCF_000008685.2	chromosome	853774	854842	1068	100.0	1.362e-231
UCT31H	contig_1	59713	58192	1521	renamed_GCF_000008685.2	chromosome	850993	852514	1521	100.0	0.0
UCT31H	contig_1	79765	80389	624	renamed_GCF_000008685.2	chromosome	830941	830317	624	100.0	5.187e-142
UCT31H	contig_1	83076	81594	1482	renamed_GCF_000008685.2	chromosome	827630	829112	1482	100.0	0.0
UCT31H	contig_1	86325	85002	1323	renamed_GCF_000008685.2	chromosome	824381	825704	1323	100.0	8.966e-297
UCT31H	contig_1	87444	86895	549	renamed_GCF_000008685.2	chromosome	823262	823811	549	100.0	1.698e-116
UCT31H	contig_1	94407	95205	798	renamed_GCF_000008685.2	chromosome	816299	815501	798	100.0	1.968e-173
UCT31H	contig_1	96009	97017	1008	renamed_GCF_000008685.2	chromosome	814697	813689	1008	100.0	5.214e-215
UCT31H	contig_1	97476	98277	801	renamed_GCF_000008685.2	chromosome	813239	812438	801	100.0	9.279e-174
UCT31H	contig_1	99205	100246	1041	renamed_GCF_000008685.2	chromosome	811510	810469	1041	100.0	2.778e-236
UCT31H	contig_1	102251	102740	489	renamed_GCF_000008685.2	chromosome	808464	807975	489	100.0	6.125e-101
UCT31H	contig_1	127327	125695	1632	renamed_GCF_000008685.2	chromosome	783389	785021	1632	100.0	0.0
UCT31H	contig_1	131959	129331	2628	renamed_GCF_000008685.2	chromosome	778757	781385	2628	100.0	0.0
UCT31H	contig_1	133932	133143	789	renamed_GCF_000008685.2	chromosome	776784	777573	789	100.0	8.439e-173
UCT31H	contig_1	136040	135254	786	renamed_GCF_000008685.2	chromosome	774676	775462	786	100.0	1.17e-168
UCT31H	contig_1	139153	139555	402	renamed_GCF_000008685.2	chromosome	771563	771161	402	100.0	3.917e-83
UCT31H	contig_1	195950	196613	663	renamed_GCF_000008685.2	chromosome	714766	714103	663	100.0	1.333e-146
UCT31H	contig_1	197466	198513	1047	renamed_GCF_000008685.2	chromosome	713250	712203	1047	100.0	1.709e-225
UCT31H	contig_1	200031	199545	486	renamed_GCF_000008685.2	chromosome	710685	711171	486	100.0	5.304e-102
UCT31H	contig_1	213131	212384	747	renamed_GCF_000008685.2	chromosome	697585	698332	747	100.0	1.547e-167
UCT31H	contig_1	215086	213952	1134	renamed_GCF_000008685.2	chromosome	695630	696764	1134	100.0	1.419e-259
UCT31H	contig_1	217163	216020	1143	renamed_GCF_000008685.2	chromosome	693553	694696	1143	100.0	3.979e-258
UCT31H	contig_1	219832	218071	1761	renamed_GCF_000008685.2	chromosome	690884	692645	1761	100.0	0.0
UCT31H	contig_1	220524	220227	297	renamed_GCF_000008685.2	chromosome	690192	690489	297	100.0	1.037e-63
UCT31H	contig_1	234245	232856	1389	renamed_GCF_000008685.2	chromosome	676471	677860	1389	100.0	1.442e-302
UCT31H	contig_1	237375	235938	1437	renamed_GCF_000008685.2	chromosome	673341	674778	1437	100.0	0.0
UCT31H	contig_1	299521	300772	1251	renamed_GCF_000008685.2	chromosome	611193	609942	1251	100.0	7.081e-270
UCT31H	contig_1	300808	301654	846	renamed_GCF_000008685.2	chromosome	609906	609060	846	100.0	3.324e-184
UCT31H	contig_1	320506	321031	525	renamed_GCF_000008685.2	chromosome	590208	589683	525	100.0	5.037e-109
UCT31H	contig_1	322649	321047	1602	renamed_GCF_000008685.2	chromosome	588065	589667	1602	100.0	0.0
UCT31H	contig_1	325834	326524	690	renamed_GCF_000008685.2	chromosome	584880	584190	690	100.0	9.609e-155
UCT31H	contig_1	330229	329071	1158	renamed_GCF_000008685.2	chromosome	580485	581643	1158	100.0	7.971e-253
UCT31H	contig_1	353291	354152	861	renamed_GCF_000008685.2	chromosome	557423	556562	861	100.0	5.864e-189
UCT31H	contig_1	356723	355502	1221	renamed_GCF_000008685.2	chromosome	553991	555212	1221	100.0	5.34e-268
UCT31H	contig_1	358990	361072	2082	renamed_GCF_000008685.2	chromosome	551723	549641	2082	100.0	0.0
UCT31H	contig_1	361828	362227	399	renamed_GCF_000008685.2	chromosome	548885	548486	399	100.0	1.521e-84
UCT31H	contig_1	376413	375558	855	renamed_GCF_000008685.2	chromosome	534300	535155	855	100.0	8.967e-192
UCT31H	contig_1	379609	381517	1908	renamed_GCF_000008685.2	chromosome	531105	529197	1908	100.0	0.0
UCT31H	contig_1	407759	407360	399	renamed_GCF_000008685.2	chromosome	502950	503349	399	100.0	3.071e-85
UCT31H	contig_1	408519	407970	549	renamed_GCF_000008685.2	chromosome	502190	502739	549	100.0	1.698e-116
UCT31H	contig_1	409213	408844	369	renamed_GCF_000008685.2	chromosome	501496	501865	369	100.0	9.223e-77
UCT31H	contig_1	409698	409497	201	renamed_GCF_000008685.2	chromosome	501014	501212	201	98.4	1.098e-39
UCT31H	contig_1	411003	410121	882	renamed_GCF_000008685.2	chromosome	499706	500588	882	100.0	1.248e-192
UCT31H	contig_1	420977	420155	822	renamed_GCF_000008685.2	chromosome	489732	490554	822	100.0	2.749e-182
UCT31H	contig_1	422484	421737	747	renamed_GCF_000008685.2	chromosome	488225	488972	747	100.0	3.778e-166
UCT31H	contig_1	423993	423171	822	renamed_GCF_000008685.2	chromosome	486746	487538	822	100.0	1.872e-169
UCT31H	contig_1	425160	424632	528	renamed_GCF_000008685.2	chromosome	485549	486077	528	100.0	1.004e-118
UCT31H	contig_1	426423	426123	300	renamed_GCF_000008685.2	chromosome	484286	484586	300	100.0	5.976e-62
UCT31H	contig_1	439489	440749	1260	renamed_GCF_000008685.2	chromosome	471220	469960	1260	100.0	2.539e-274
UCT31H	contig_1	441044	441320	276	renamed_GCF_000008685.2	chromosome	469665	469389	276	100.0	1.644e-55
UCT31H	contig_1	443431	445192	1761	renamed_GCF_000008685.2	chromosome	467278	465517	1761	100.0	0.0
UCT31H	contig_1	446657	445577	1080	renamed_GCF_000008685.2	chromosome	464052	465132	1080	100.0	9.122e-247
UCT31H	contig_1	447891	446823	1068	renamed_GCF_000008685.2	chromosome	462818	463886	1068	100.0	4.491e-244
UCT31H	contig_1	448665	447936	729	renamed_GCF_000008685.2	chromosome	462044	462773	729	100.0	2.248e-160
UCT31H	contig_1	450658	450298	360	renamed_GCF_000008685.2	chromosome	460051	460411	360	100.0	4.812e-74
UCT31H	contig_1	450794	450638	156	renamed_GCF_000008685.2	chromosome	459915	460071	156	100.0	2.965e-30
UCT31H	contig_1	451185	450885	300	renamed_GCF_000008685.2	chromosome	459524	459824	300	100.0	7.304e-60
UCT31H	contig_1	452433	451275	1158	renamed_GCF_000008685.2	chromosome	458276	459434	1158	100.0	2.482e-257
UCT31H	contig_1	454134	452673	1461	renamed_GCF_000008685.2	chromosome	456575	458036	1461	100.0	0.0
UCT31H	contig_1	454321	456226	1905	renamed_GCF_000008685.2	chromosome	456388	454483	1905	100.0	0.0
UCT31H	contig_1	458788	459571	783	renamed_GCF_000008685.2	chromosome	451921	451138	783	100.0	1.017e-169
UCT31H	contig_1	491205	492324	1119	renamed_GCF_000008685.2	chromosome	419506	418387	1119	100.0	8.015e-255
UCT31H	contig_4	16260	16872	612	renamed_GCF_000008685.2	lp36	16274	16886	612	100.0	9.153e-134
UCT31H	contig_4	17365	17569	204	renamed_GCF_000008685.2	lp36	17379	17583	204	100.0	8.441e-43
UCT31H	contig_4	20374	21439	1065	renamed_GCF_000008685.2	lp36	20388	21453	1065	100.0	2.633e-232
UCT31H	contig_4	21897	22119	222	renamed_GCF_000008685.2	lp36	21911	22133	222	100.0	1.866e-45
UCT31H	contig_4	22279	22453	174	renamed_GCF_000008685.2	lp36	22293	22467	174	100.0	8.56e-38
UCT31H	contig_5	13507	14608	1101	renamed_GCF_000008685.2	lp28-1	15451	14350	1101	100.0	2.133e-249
UCT31H	contig_5	14629	15190	561	renamed_GCF_000008685.2	lp28-1	14329	13768	561	100.0	4.308e-125
UCT31H	contig_5	15165	15930	765	renamed_GCF_000008685.2	lp28-1	13793	13028	765	100.0	1.871e-168
UCT31H	contig_5	15966	16518	552	renamed_GCF_000008685.2	lp28-1	12992	12440	552	100.0	6.015e-120
UCT31H	contig_5	17967	18261	294	renamed_GCF_000008685.2	lp28-1	10895	10697	294	100.0	9.155e-41
UCT31H	contig_5	20187	19929	258	renamed_GCF_000008685.2	lp28-1	8771	9029	258	100.0	1.351e-54
UCT31H	contig_5	21047	21605	558	renamed_GCF_000008685.2	lp28-1	7869	7353	558	100.0	3.959e-117
UCT31H	contig_5	33099	32583	516	renamed_GCF_000008685.2	lp28-1	2619	2097	516	100.0	2.617e-106
UCT31H	contig_5	33262	33562	300	renamed_GCF_000008685.2	lp28-3	1044	1368	300	89.8	8.93e-58
UCT31H	contig_6	14416	15280	864	renamed_GCF_000008685.2	lp25	6897	7761	864	99.6	3.857e-194
UCT31H	contig_6	17706	17085	621	renamed_GCF_000008685.2	lp25	10187	9566	621	100.0	1.329e-139
UCT31H	contig_6	18228	17718	510	renamed_GCF_000008685.2	lp25	10694	10199	510	99.3	8.021e-110
UCT31H	contig_6	19598	19016	582	renamed_GCF_000008685.2	lp25	12079	11497	582	100.0	4.521e-128
UCT31H	contig_7	417	981	564	renamed_GCF_000008685.2	cp32-6	2009	2573	564	100.0	2.235e-124
UCT31H	contig_7	14092	14428	336	renamed_GCF_000008685.2	lp56	19256	19592	336	100.0	5.348e-69
UCT31H	contig_7	14420	14774	354	renamed_GCF_000008685.2	cp32-6	16102	16456	354	99.1	7.233e-77
UCT31H	contig_7	17659	16711	948	renamed_GCF_000008685.2	cp32-6	18680	17732	948	99.0	4.134e-216
UCT31H	contig_8	6394	6010	384	renamed_GCF_000008685.2	cp32-9	5412	5796	384	100.0	2.931e-83
UCT31H	contig_8	6849	6393	456	renamed_GCF_000008685.2	cp32-1	4941	5397	456	100.0	1.075e-97
UCT31H	contig_8	7828	6868	960	renamed_GCF_000008685.2	cp32-1	3962	4922	960	100.0	6.593e-213
UCT31H	contig_8	10487	9794	693	renamed_GCF_000008685.2	cp32-6	1305	1998	693	100.0	1.162e-144
UCT31H	contig_8	11727	10503	1224	renamed_GCF_000008685.2	cp32-6	65	1289	1224	100.0	2.096e-270
UCT31H	contig_8	23429	22328	1101	renamed_GCF_000008685.2	cp32-1	19113	20214	1101	100.0	1.773e-251
UCT31H	contig_10	10833	9720	1113	renamed_GCF_000008685.2	cp32-7	6702	7815	1113	100.0	3.095e-247
UCT31H	contig_10	22206	21498	708	renamed_GCF_000008685.2	cp32-7	26151	26841	708	83.9	2.557e-121
UCT31H	contig_10	29230	28132	1098	renamed_GCF_000008685.2	cp32-7	19116	20214	1098	96.7	8.634e-242
UCT31H	contig_11	363	753	390	renamed_GCF_000008685.2	cp32-9	5783	6173	390	100.0	3.229e-83
UCT31H	contig_11	10097	10445	348	renamed_GCF_000008685.2	cp32-8	15421	15769	348	100.0	8.822e-74
UCT31H	contig_11	10762	11116	354	renamed_GCF_000008685.2	cp32-9	16183	16537	354	100.0	1.459e-77
UCT31H	contig_11	11880	12309	429	renamed_GCF_000008685.2	cp32-9	17301	17730	429	100.0	2.284e-93
UCT31H	contig_11	14853	15420	567	renamed_GCF_000008685.2	cp32-9	20274	20841	567	100.0	1.456e-129
UCT31H	contig_11	25295	26522	1227	renamed_GCF_000008685.2	cp32-9	65	1292	1227	100.0	9.884e-271
UCT31H	contig_11	26538	27231	693	renamed_GCF_000008685.2	cp32-9	1308	2001	693	100.0	5.226e-145
UCT31H	contig_11	30188	30644	456	renamed_GCF_000008685.2	cp32-9	4957	5413	456	100.0	4.83e-98
UCT31H	contig_12	1806	2595	789	renamed_GCF_000008685.2	lp21	2867	3656	789	99.6	6.373e-176
UCT31H	contig_14	10603	9490	1113	renamed_GCF_000008685.2	cp32-1	6700	7813	1113	100.0	6.876e-247
UCT31H	contig_14	11907	11523	384	renamed_GCF_000008685.2	cp32-4	5406	5790	384	100.0	2.931e-83
UCT31H	contig_14	13341	12381	960	renamed_GCF_000008685.2	cp32-7	3961	4921	960	100.0	6.593e-213
UCT31H	contig_15	605	1718	1113	renamed_GCF_000008685.2	cp32-6	6710	7823	1113	100.0	1.393e-247
UCT31H	contig_15	2176	2632	456	renamed_GCF_000008685.2	cp32-6	8281	8737	456	100.0	1.971e-99
UCT31H	contig_15	4169	4853	684	renamed_GCF_000008685.2	cp32-8	10264	10948	684	100.0	3.113e-149
UCT31H	contig_15	6408	6741	333	renamed_GCF_000008685.2	cp32-8	12494	12827	333	100.0	8.424e-72
UCT31H	contig_15	23968	25192	1224	renamed_GCF_000008685.2	cp32-1	65	1289	1224	100.0	2.096e-270
UCT31H	contig_15	25913	26471	558	renamed_GCF_000008685.2	cp32-7	2009	2567	558	100.0	1.105e-122
UCT31H	contig_18	3802	3484	318	renamed_GCF_000008685.2	cp26	4481	4757	318	100.0	7.253e-55
UCT31H	contig_18	6055	7405	1350	renamed_GCF_000008685.2	cp26	2186	836	1350	100.0	7.868e-303
UCT31H	contig_18	8196	7917	279	renamed_GCF_000008685.2	cp26	45	324	279	100.0	2.323e-60
UCT31H	contig_18	11485	10240	1245	renamed_GCF_000008685.2	cp26	23254	24499	1245	100.0	1.056e-281
UCT31H	contig_18	23322	23820	498	renamed_GCF_000008685.2	cp26	11417	10919	498	100.0	3.608e-108
UCT31H	contig_18	25465	24703	762	renamed_GCF_000008685.2	cp26	9274	10036	762	100.0	1.063e-165
UCT31H	contig_18	26253	25974	279	renamed_GCF_000008685.2	cp26	7835	8765	279	100.0	2.569e-59
UCT31H	contig_19	2173	3010	837	renamed_GCF_000008685.2	lp28-4	23995	23158	837	100.0	6.415e-184
UCT31H	contig_19	4606	5398	792	renamed_GCF_000008685.2	lp28-4	21562	20770	792	100.0	1.631e-174
UCT31H	contig_1	67704	66255	1449	renamed_GCF_000008685.2	chromosome	843002	844451	1449	100.0	7.712e-320
UCT31H	contig_1	68873	68255	618	renamed_GCF_000008685.2	chromosome	841833	842451	618	100.0	1.393e-138
UCT31H	contig_1	74646	72180	2466	renamed_GCF_000008685.2	chromosome	836060	838526	2466	100.0	0.0
UCT31H	contig_1	89522	88337	1185	renamed_GCF_000008685.2	chromosome	821184	822369	1185	100.0	1.177e-261
UCT31H	contig_1	91165	90178	987	renamed_GCF_000008685.2	chromosome	819541	820528	987	100.0	5.255e-220
UCT31H	contig_1	91465	91219	246	renamed_GCF_000008685.2	chromosome	819241	819487	246	100.0	8.275e-50
UCT31H	contig_1	92102	91790	312	renamed_GCF_000008685.2	chromosome	818604	818916	312	100.0	1.086e-65
UCT31H	contig_1	93311	92750	561	renamed_GCF_000008685.2	chromosome	817395	817956	561	100.0	3.237e-128
UCT31H	contig_1	102749	103796	1047	renamed_GCF_000008685.2	chromosome	807966	806919	1047	100.0	5.315e-230
UCT31H	contig_1	158547	157497	1050	renamed_GCF_000008685.2	chromosome	752169	753219	1050	100.0	6.109e-229
UCT31H	contig_1	160686	159927	759	renamed_GCF_000008685.2	chromosome	750030	750789	759	100.0	2.255e-165
UCT31H	contig_1	172312	171946	366	renamed_GCF_000008685.2	chromosome	738405	738771	366	100.0	9.695e-76
UCT31H	contig_1	173506	173005	501	renamed_GCF_000008685.2	chromosome	737211	737712	501	100.0	9.268e-107
UCT31H	contig_1	174019	173758	261	renamed_GCF_000008685.2	chromosome	736698	736959	261	100.0	3.165e-54
UCT31H	contig_1	178924	176914	2010	renamed_GCF_000008685.2	chromosome	731793	733803	2010	100.0	0.0
UCT31H	contig_1	179534	178997	537	renamed_GCF_000008685.2	chromosome	731183	731720	537	100.0	1.936e-121
UCT31H	contig_1	181105	180211	894	renamed_GCF_000008685.2	chromosome	729612	730506	894	100.0	2.531e-195
UCT31H	contig_1	182981	182042	939	renamed_GCF_000008685.2	chromosome	727736	728675	939	100.0	1.678e-207
UCT31H	contig_1	185287	184222	1065	renamed_GCF_000008685.2	chromosome	725430	726495	1065	100.0	4.042e-236
UCT31H	contig_1	230153	230963	810	renamed_GCF_000008685.2	chromosome	680557	679753	810	99.6	5.278e-173
UCT31H	contig_1	251818	251092	726	renamed_GCF_000008685.2	chromosome	658897	659623	726	100.0	3.429e-155
UCT31H	contig_1	255907	253813	2094	renamed_GCF_000008685.2	chromosome	654862	656902	2094	99.8	0.0
UCT31H	contig_1	256925	260303	3378	renamed_GCF_000008685.2	chromosome	653790	650412	3378	100.0	0.0
UCT31H	contig_1	262389	264057	1668	renamed_GCF_000008685.2	chromosome	648254	646658	1668	100.0	0.0
UCT31H	contig_1	278230	276250	1980	renamed_GCF_000008685.2	chromosome	632484	634464	1980	100.0	0.0
UCT31H	contig_1	279946	278728	1218	renamed_GCF_000008685.2	chromosome	630795	631986	1218	99.7	8.847e-262
UCT31H	contig_1	281766	283623	1857	renamed_GCF_000008685.2	chromosome	628948	627091	1857	100.0	0.0
UCT31H	contig_1	287264	285707	1557	renamed_GCF_000008685.2	chromosome	623450	625007	1557	100.0	0.0
UCT31H	contig_1	288761	289670	909	renamed_GCF_000008685.2	chromosome	621953	621044	909	100.0	1.521e-203
UCT31H	contig_1	342445	341575	870	renamed_GCF_000008685.2	chromosome	568269	569139	870	100.0	1.737e-195
UCT31H	contig_1	344745	342891	1854	renamed_GCF_000008685.2	chromosome	565954	567823	1854	99.8	0.0
UCT31H	contig_1	348771	349152	381	renamed_GCF_000008685.2	chromosome	561943	561562	381	100.0	2.258e-77
UCT31H	contig_1	349587	349986	399	renamed_GCF_000008685.2	chromosome	561127	560728	399	100.0	7.535e-84
UCT31H	contig_1	362223	362868	645	renamed_GCF_000008685.2	chromosome	548490	547845	645	100.0	1.056e-137
UCT31H	contig_1	366882	366108	774	renamed_GCF_000008685.2	chromosome	543831	544605	774	100.0	1.787e-170
UCT31H	contig_1	368451	367689	762	renamed_GCF_000008685.2	chromosome	542262	543024	762	100.0	5.516e-173
UCT31H	contig_1	371438	372386	948	renamed_GCF_000008685.2	chromosome	539275	538327	948	99.6	1.106e-213
UCT31H	contig_1	394221	387720	6501	renamed_GCF_000008685.2	chromosome	516492	522993	6501	100.0	0.0
UCT31H	contig_2	21074	21614	540	renamed_GCF_000008685.2	lp54	21086	21626	540	100.0	8.011e-115
UCT31H	contig_2	23764	24403	639	renamed_GCF_000008685.2	lp54	23776	24415	639	100.0	9.606e-138
UCT31H	contig_2	32248	32737	489	renamed_GCF_000008685.2	lp54	32260	32749	489	100.0	3.125e-108
UCT31H	contig_2	34372	34936	564	renamed_GCF_000008685.2	lp54	34384	34948	564	100.0	7.276e-120
UCT31H	contig_2	35941	36217	276	renamed_GCF_000008685.2	lp54	35953	36229	276	100.0	3.31e-56
UCT31H	contig_2	39393	38148	1245	renamed_GCF_000008685.2	lp54	39405	38160	1245	99.2	2.65e-271
UCT31H	contig_2	42009	41385	624	renamed_GCF_000008685.2	lp54	42019	41395	624	100.0	3.1e-139
UCT31H	contig_2	44523	43674	849	renamed_GCF_000008685.2	lp54	44533	43684	849	100.0	7.054e-185
UCT31H	contig_2	47212	46456	756	renamed_GCF_000008685.2	lp54	47228	46472	756	100.0	2.151e-165
UCT31H	contig_3	14973	14226	747	renamed_GCF_000008685.2	lp56	36388	37135	747	100.0	3.778e-166
UCT31H	contig_3	16247	15554	693	renamed_GCF_000008685.2	lp56	35114	35807	693	100.0	1.057e-145
UCT31H	contig_3	19470	18903	567	renamed_GCF_000008685.2	lp56	31891	32458	567	100.0	5.734e-123
UCT31H	contig_3	21425	20387	1038	renamed_GCF_000008685.2	lp56	29936	30974	1038	100.0	2.28e-229
UCT31H	contig_3	32083	31747	336	renamed_GCF_000008685.2	cp32-8	15758	16094	336	100.0	5.348e-69
UCT31H	contig_3	32627	32423	204	renamed_GCF_000008685.2	cp32-1	15214	15418	204	100.0	2.578e-39
UCT31H	contig_3	35346	35013	333	renamed_GCF_000008685.2	cp32-3	12494	12827	333	100.0	8.424e-72
UCT31H	contig_6	23097	22560	537	renamed_GCF_000008685.2	lp25	15545	15041	537	99.4	7.638e-115
UCT31H	contig_7	7137	7374	237	renamed_GCF_000008685.2	cp32-9	8741	8978	237	100.0	1.76e-48
UCT31H	contig_7	12044	12650	606	renamed_GCF_000008685.2	lp56	17207	17813	606	100.0	5.47e-130
UCT31H	contig_7	20639	21161	522	renamed_GCF_000008685.2	cp32-7	21521	22076	522	100.0	1.473e-113
UCT31H	contig_8	16296	15774	522	renamed_GCF_000008685.2	cp32-8	26381	26903	522	100.0	1.338e-114
UCT31H	contig_8	17934	17508	426	renamed_GCF_000008685.2	cp32-1	24608	25034	426	99.2	1.793e-95
UCT31H	contig_8	19312	17986	1326	renamed_GCF_000008685.2	cp32-1	23230	24556	1326	100.0	7.132e-300
UCT31H	contig_8	20982	20424	558	renamed_GCF_000008685.2	cp32-1	21560	22118	558	100.0	2.975e-120
UCT31H	contig_8	22319	21752	567	renamed_GCF_000008685.2	cp32-1	20223	20790	567	100.0	2.944e-130
UCT31H	contig_8	30617	30071	546	renamed_GCF_000008685.2	cp32-8	11919	12465	546	100.0	7.28e-117
UCT31H	contig_9	1955	1415	540	renamed_GCF_000008685.2	cp32-8	28250	28790	540	100.0	1.472e-116
UCT31H	contig_9	3824	3302	522	renamed_GCF_000008685.2	cp32-1	26234	26768	522	100.0	1.338e-114
UCT31H	contig_9	5462	5036	426	renamed_GCF_000008685.2	cp32-7	24512	24938	426	99.2	1.793e-95
UCT31H	contig_10	11769	11379	390	renamed_GCF_000008685.2	cp32-4	5777	6167	390	100.0	3.229e-83
UCT31H	contig_10	15526	14968	558	renamed_GCF_000008685.2	cp32-3	2010	2568	558	100.0	1.105e-122
UCT31H	contig_11	5620	6571	951	renamed_GCF_000008685.2	cp32-9	11040	11991	951	100.0	9.63e-216
UCT31H	contig_11	7172	7505	333	renamed_GCF_000008685.2	cp32-9	12592	12925	333	100.0	1.876e-71
UCT31H	contig_11	9890	10094	204	renamed_GCF_000008685.2	cp32-7	15221	15425	204	100.0	2.578e-39
UCT31H	contig_11	19150	19576	426	renamed_GCF_000008685.2	cp32-9	24571	24997	426	100.0	1.627e-96
UCT31H	contig_13	3051	4347	1296	renamed_GCF_000008685.2	cp32-4	8977	10273	1296	100.0	2.13e-282
UCT31H	contig_13	4369	4966	597	renamed_GCF_000008685.2	cp32-4	10295	10892	597	100.0	4.743e-130
UCT31H	contig_13	4969	5920	951	renamed_GCF_000008685.2	cp32-4	10895	11846	951	100.0	4.333e-216
UCT31H	contig_13	5937	6492	555	renamed_GCF_000008685.2	cp32-4	11863	12418	555	100.0	3.12e-119
UCT31H	contig_13	6850	7726	876	renamed_GCF_000008685.2	cp32-6	12842	13718	876	100.0	5.609e-192
UCT31H	contig_13	7735	8341	606	renamed_GCF_000008685.2	cp32-8	13708	14314	606	100.0	5.47e-130
UCT31H	contig_13	8350	9166	816	renamed_GCF_000008685.2	cp32-4	14276	15092	816	100.0	1.49e-179
UCT31H	contig_13	9447	9795	348	renamed_GCF_000008685.2	cp32-1	15421	15769	348	100.0	3.962e-74
UCT31H	contig_13	16904	18230	1326	renamed_GCF_000008685.2	cp32-4	22830	24156	1326	100.0	6.506e-301
UCT31H	contig_13	19509	18714	795	renamed_GCF_000008685.2	cp32-4	25435	24640	795	100.0	5.809e-178
UCT31H	contig_14	20819	20228	591	renamed_GCF_000008685.2	cp32-3	26707	27298	591	100.0	2.345e-128
UCT31H	contig_14	22458	22032	426	renamed_GCF_000008685.2	cp32-3	25068	25494	426	100.0	3.62e-96
UCT31H	contig_14	24913	24343	570	renamed_GCF_000008685.2	cp32-3	22592	23183	570	95.9	3.598e-120
UCT31H	contig_14	26249	25508	741	renamed_GCF_000008685.2	cp32-3	21256	21997	741	100.0	5.003e-162
UCT31H	contig_14	27901	26800	1101	renamed_GCF_000008685.2	cp32-3	19604	20705	1101	100.0	1.773e-251
UCT31H	contig_14	29703	29256	447	renamed_GCF_000008685.2	cp32-3	17802	18249	447	100.0	7.667e-100
UCT31H	contig_15	9669	10005	336	renamed_GCF_000008685.2	cp32-7	15765	16101	336	100.0	5.348e-69
UCT31H	contig_15	9997	10351	354	renamed_GCF_000008685.2	cp32-7	16093	16447	354	100.0	1.459e-77
UCT31H	contig_15	10455	11142	687	renamed_GCF_000008685.2	lp56	20042	20738	687	79.2	1.459e-115
UCT31H	contig_15	14783	15533	750	renamed_GCF_000008685.2	cp32-6	20720	21470	750	100.0	4.35e-165
UCT31H	contig_15	15582	16161	579	renamed_GCF_000008685.2	cp32-6	21519	22098	579	100.0	5.735e-125
UCT31H	contig_15	16164	16833	669	renamed_GCF_000008685.2	cp32-6	22101	22770	669	100.0	2.138e-142
UCT31H	contig_15	18683	19109	426	renamed_GCF_000008685.2	cp32-6	24618	25044	426	100.0	8.056e-96
UCT31H	contig_15	19885	19114	771	renamed_GCF_000008685.2	cp32-6	25820	25049	771	100.0	3.141e-172
UCT31H	contig_16	18100	17761	339	renamed_GCF_000008685.2	lp28-2	18019	17680	339	100.0	5.085e-70
UCT31H	contig_17	11961	11064	897	renamed_GCF_000008685.2	lp28-3	16518	17415	897	100.0	1.518e-201
UCT31H	contig_17	17963	18632	669	renamed_GCF_000008685.2	lp28-3	10516	9847	669	100.0	5.739e-140
UCT31H	contig_17	20751	24588	3837	renamed_GCF_000008685.2	lp28-3	7728	3891	3837	100.0	0.0
UCT31H	contig_17	25508	26219	711	renamed_GCF_000008685.2	lp28-3	2970	2259	711	100.0	1.615e-152
UCT31H	contig_18	1565	527	1038	renamed_GCF_000008685.2	cp26	6676	7714	1038	100.0	8.529e-232
UCT31H	contig_18	11585	12137	552	renamed_GCF_000008685.2	cp26	23154	22602	552	100.0	6.015e-120
UCT31H	contig_18	12842	12146	696	renamed_GCF_000008685.2	cp26	21897	22593	696	100.0	1.401e-151
UCT31H	contig_18	12915	13401	486	renamed_GCF_000008685.2	cp26	21833	21338	486	100.0	3.279e-107
UCT31H	contig_18	13375	13882	507	renamed_GCF_000008685.2	cp26	21364	20857	507	100.0	3.123e-111
UCT31H	contig_18	13953	15309	1356	renamed_GCF_000008685.2	cp26	20786	19430	1356	100.0	1.798e-294
UCT31H	contig_18	15418	16774	1356	renamed_GCF_000008685.2	cp26	19321	17965	1356	100.0	1.971e-293
UCT31H	contig_18	17837	17204	633	renamed_GCF_000008685.2	cp26	16902	17535	633	100.0	1.275e-133
UCT31H	contig_18	18072	19608	1536	renamed_GCF_000008685.2	cp26	16667	15131	1536	100.0	0.0
UCT31H	contig_18	19632	20847	1215	renamed_GCF_000008685.2	cp26	15107	13892	1215	100.0	5.333e-267
UCT31H	contig_18	22726	21133	1593	renamed_GCF_000008685.2	cp26	12013	13606	1593	100.0	0.0
UCT31H	contig_1	50267	48932	1335	renamed_GCF_000008685.2	chromosome	860439	861774	1335	100.0	8.434e-291
UCT31H	contig_1	53201	51791	1410	renamed_GCF_000008685.2	chromosome	857505	858915	1410	100.0	1.384e-306
UCT31H	contig_1	58218	56928	1290	renamed_GCF_000008685.2	chromosome	852488	853778	1290	100.0	6.634e-286
UCT31H	contig_1	61888	59719	2169	renamed_GCF_000008685.2	chromosome	848836	850987	2169	99.8	0.0
UCT31H	contig_1	79143	79752	609	renamed_GCF_000008685.2	chromosome	831563	830954	609	100.0	7.938e-135
UCT31H	contig_1	81489	80385	1104	renamed_GCF_000008685.2	chromosome	829217	830321	1104	100.0	4.529e-250
UCT31H	contig_1	85006	83086	1920	renamed_GCF_000008685.2	chromosome	825700	827620	1920	100.0	0.0
UCT31H	contig_1	86891	86324	567	renamed_GCF_000008685.2	chromosome	823815	824382	567	100.0	1.275e-122
UCT31H	contig_1	87897	87603	294	renamed_GCF_000008685.2	chromosome	822809	823103	294	100.0	1.207e-61
UCT31H	contig_1	136348	139147	2799	renamed_GCF_000008685.2	chromosome	774368	771569	2799	100.0	0.0
UCT31H	contig_1	139577	141170	1593	renamed_GCF_000008685.2	chromosome	771139	769546	1593	100.0	0.0
UCT31H	contig_1	142652	143984	1332	renamed_GCF_000008685.2	chromosome	768064	766732	1332	100.0	1.239e-294
UCT31H	contig_1	146346	145374	972	renamed_GCF_000008685.2	chromosome	764370	765342	972	100.0	2.973e-215
UCT31H	contig_1	162594	160698	1896	renamed_GCF_000008685.2	chromosome	748122	750018	1896	100.0	0.0
UCT31H	contig_1	165416	164384	1032	renamed_GCF_000008685.2	chromosome	745301	746333	1032	100.0	2.498e-227
UCT31H	contig_1	167974	166201	1773	renamed_GCF_000008685.2	chromosome	742743	744516	1773	100.0	0.0
UCT31H	contig_1	170030	169292	738	renamed_GCF_000008685.2	chromosome	740687	741425	738	100.0	4.772e-162
UCT31H	contig_1	171033	170541	492	renamed_GCF_000008685.2	chromosome	739684	740176	492	100.0	4.374e-105
UCT31H	contig_1	220214	219917	297	renamed_GCF_000008685.2	chromosome	690481	690799	297	98.9	6.955e-60
UCT31H	contig_1	231778	232825	1047	renamed_GCF_000008685.2	chromosome	678938	677891	1047	100.0	5.633e-238
UCT31H	contig_1	235682	234338	1344	renamed_GCF_000008685.2	chromosome	675034	676378	1344	100.0	3.635e-293
UCT31H	contig_1	237504	238950	1446	renamed_GCF_000008685.2	chromosome	673167	671766	1446	100.0	1.676e-310
UCT31H	contig_1	245704	247537	1833	renamed_GCF_000008685.2	chromosome	665011	663178	1833	100.0	0.0
UCT31H	contig_1	249110	248186	924	renamed_GCF_000008685.2	chromosome	661605	662529	924	100.0	4.691e-202
UCT31H	contig_1	265944	265575	369	renamed_GCF_000008685.2	chromosome	644771	645140	369	100.0	1.529e-79
UCT31H	contig_1	268427	268274	153	renamed_GCF_000008685.2	chromosome	642288	642441	153	100.0	5.64e-31
UCT31H	contig_1	270875	268466	2409	renamed_GCF_000008685.2	chromosome	639858	642249	2409	100.0	0.0
UCT31H	contig_1	327257	326882	375	renamed_GCF_000008685.2	chromosome	583457	583832	375	100.0	8.349e-79
UCT31H	contig_1	329070	327297	1773	renamed_GCF_000008685.2	chromosome	581644	583417	1773	100.0	0.0
UCT31H	contig_1	352690	353308	618	renamed_GCF_000008685.2	chromosome	558024	557406	618	100.0	1.216e-131
UCT31H	contig_1	355499	354134	1365	renamed_GCF_000008685.2	chromosome	555215	556580	1365	100.0	6.28e-308
UCT31H	contig_1	357576	356925	651	renamed_GCF_000008685.2	chromosome	553138	553789	651	100.0	1.464e-143
UCT31H	contig_1	361095	361794	699	renamed_GCF_000008685.2	chromosome	549618	548919	699	100.0	1.058e-146
UCT31H	contig_1	375010	373186	1824	renamed_GCF_000008685.2	chromosome	535703	537527	1824	100.0	0.0
UCT31H	contig_1	375113	375536	423	renamed_GCF_000008685.2	chromosome	535600	535177	423	100.0	5.606e-91
UCT31H	contig_1	421727	421214	513	renamed_GCF_000008685.2	chromosome	488982	489495	513	100.0	1.545e-111
UCT31H	contig_1	423175	422485	690	renamed_GCF_000008685.2	chromosome	487534	488224	690	100.0	9.609e-155
UCT31H	contig_1	424636	423940	696	renamed_GCF_000008685.2	chromosome	486073	486769	696	100.0	2.835e-152
UCT31H	contig_1	425953	425443	510	renamed_GCF_000008685.2	chromosome	484756	485266	510	100.0	1.216e-113
UCT31H	contig_1	438953	439487	534	renamed_GCF_000008685.2	chromosome	471756	471222	534	100.0	8.816e-113
UCT31H	contig_1	440738	441032	294	renamed_GCF_000008685.2	chromosome	469971	469677	294	100.0	2.2e-63
UCT31H	contig_1	441322	443428	2106	renamed_GCF_000008685.2	chromosome	469387	467281	2106	100.0	0.0
UCT31H	contig_1	456237	458670	2433	renamed_GCF_000008685.2	chromosome	454472	452039	2433	100.0	0.0
UCT31H	contig_1	461291	460538	753	renamed_GCF_000008685.2	chromosome	449418	450171	753	100.0	3.278e-160
UCT31H	contig_1	492988	492376	612	renamed_GCF_000008685.2	chromosome	417723	418335	612	100.0	3.097e-137
UCT31H	contig_1	515545	516607	1062	renamed_GCF_000008685.2	chromosome	395166	394104	1062	100.0	1.904e-235
UCT31H	contig_1	516648	517668	1020	renamed_GCF_000008685.2	chromosome	394063	393043	1020	100.0	6.665e-223
UCT31H	contig_1	517754	518780	1026	renamed_GCF_000008685.2	chromosome	392957	391931	1026	100.0	1.232e-225
UCT31H	contig_1	518892	520317	1425	renamed_GCF_000008685.2	chromosome	391819	390391	1425	100.0	0.0
UCT31H	contig_1	520370	521735	1365	renamed_GCF_000008685.2	chromosome	390341	388976	1365	99.5	7.255e-289
UCT31H	contig_1	521785	522205	420	renamed_GCF_000008685.2	chromosome	388926	388506	420	100.0	9.787e-93
UCT31H	contig_1	522231	522894	663	renamed_GCF_000008685.2	chromosome	388480	387817	663	100.0	4.965e-149
UCT31H	contig_1	523378	522904	474	renamed_GCF_000008685.2	chromosome	387333	387807	474	100.0	1.339e-106
UCT31H	contig_1	545108	545597	489	renamed_GCF_000008685.2	chromosome	365603	365114	489	100.0	3.787e-106
UCT31H	contig_1	545631	546582	951	renamed_GCF_000008685.2	chromosome	364972	364129	951	99.6	1.174e-187
UCT31H	contig_1	559380	559656	276	renamed_GCF_000008685.2	chromosome	351331	351055	276	100.0	8.162e-55
UCT31H	contig_1	559663	561112	1449	renamed_GCF_000008685.2	chromosome	351045	349599	1449	99.7	6.4e-322
UCT31H	contig_1	561101	562559	1458	renamed_GCF_000008685.2	chromosome	349610	348152	1458	100.0	0.0
UCT31H	contig_1	562551	563361	810	renamed_GCF_000008685.2	chromosome	348160	347350	810	100.0	1.888e-184
UCT31H	contig_1	563410	563851	441	renamed_GCF_000008685.2	chromosome	347301	346860	441	100.0	1.706e-98
UCT31H	contig_1	563870	564281	411	renamed_GCF_000008685.2	chromosome	346841	346430	411	100.0	6.821e-87
UCT31H	contig_1	565649	564347	1302	renamed_GCF_000008685.2	chromosome	345062	346364	1302	100.0	6.07e-289
UCT31H	contig_1	567504	566532	972	renamed_GCF_000008685.2	chromosome	343207	344179	972	100.0	3.579e-213
UCT31H	contig_1	568377	567504	873	renamed_GCF_000008685.2	chromosome	342334	343207	873	100.0	1.573e-188
UCT31H	contig_1	592706	593465	759	renamed_GCF_000008685.2	chromosome	318005	317246	759	100.0	1.223e-163
UCT31H	contig_1	593495	594572	1077	renamed_GCF_000008685.2	chromosome	317216	316139	1077	100.0	1.824e-238
UCT31H	contig_1	594568	595405	837	renamed_GCF_000008685.2	chromosome	316143	315306	837	100.0	2.887e-184
UCT31H	contig_1	595397	596288	891	renamed_GCF_000008685.2	chromosome	315314	314423	891	100.0	4.455e-197
UCT31H	contig_1	596284	596566	282	renamed_GCF_000008685.2	chromosome	314427	314145	282	100.0	2.699e-59
UCT31H	contig_1	596588	597980	1392	renamed_GCF_000008685.2	chromosome	314123	312728	1392	100.0	1.047e-306
UCT31H	contig_1	597997	599053	1056	renamed_GCF_000008685.2	chromosome	312715	311659	1056	100.0	1.239e-230
UCT31H	contig_1	599059	600154	1095	renamed_GCF_000008685.2	chromosome	311617	310558	1095	99.7	2.491e-229
UCT31H	contig_1	608223	609933	1710	renamed_GCF_000008685.2	chromosome	302489	300779	1710	100.0	0.0
UCT31H	contig_1	609948	610983	1035	renamed_GCF_000008685.2	chromosome	300764	299729	1035	100.0	3.255e-216
UCT31H	contig_1	610997	611918	921	renamed_GCF_000008685.2	chromosome	299715	298794	921	100.0	4.644e-193
UCT31H	contig_1	611936	613247	1311	renamed_GCF_000008685.2	chromosome	298776	297465	1311	100.0	6.981e-289
UCT31H	contig_1	613243	613675	432	renamed_GCF_000008685.2	chromosome	297469	297037	432	100.0	1.974e-95
UCT31H	contig_1	613667	614285	618	renamed_GCF_000008685.2	chromosome	297045	296427	618	100.0	5.47e-132
UCT31H	contig_1	614292	615471	1179	renamed_GCF_000008685.2	chromosome	296420	295241	1179	100.0	1.072e-261
UCT31H	contig_1	615484	615928	444	renamed_GCF_000008685.2	chromosome	295228	294784	444	100.0	1.185e-94
UCT31H	contig_1	615932	617261	1329	renamed_GCF_000008685.2	chromosome	294780	293451	1329	100.0	2.397e-295
UCT31H	contig_1	617283	617508	225	renamed_GCF_000008685.2	chromosome	293429	293204	225	100.0	8.8e-46
UCT31H	contig_1	624753	626844	2091	renamed_GCF_000008685.2	chromosome	285962	283868	2091	99.8	0.0
UCT31H	contig_1	626847	628014	1167	renamed_GCF_000008685.2	chromosome	283865	282698	1167	100.0	1.172e-258
UCT31H	contig_1	655768	655063	705	renamed_GCF_000008685.2	chromosome	254944	255649	705	100.0	7.263e-152
UCT31H	contig_1	657554	655781	1773	renamed_GCF_000008685.2	chromosome	253158	254931	1773	100.0	0.0
UCT31H	contig_1	658279	657673	606	renamed_GCF_000008685.2	chromosome	252433	253039	606	100.0	4.115e-133
UCT31H	contig_1	658475	659501	1026	renamed_GCF_000008685.2	chromosome	252237	251211	1026	100.0	5.545e-226
UCT31H	contig_1	659501	660056	555	renamed_GCF_000008685.2	chromosome	251211	250656	555	100.0	3.12e-119
UCT31H	contig_1	660042	660537	495	renamed_GCF_000008685.2	chromosome	250670	250175	495	100.0	5.051e-104
UCT31H	contig_1	662186	660623	1563	renamed_GCF_000008685.2	chromosome	248505	250089	1563	100.0	0.0
UCT31H	contig_1	664116	662610	1506	renamed_GCF_000008685.2	chromosome	246596	248102	1506	100.0	0.0
UCT31H	contig_1	673570	675118	1548	renamed_GCF_000008685.2	chromosome	237142	235594	1548	100.0	0.0
UCT31H	contig_1	675178	675424	246	renamed_GCF_000008685.2	chromosome	235534	235288	246	100.0	3.025e-52
UCT31H	contig_1	715020	713016	2004	renamed_GCF_000008685.2	chromosome	195692	197696	2004	100.0	0.0
UCT31H	contig_1	715837	714976	861	renamed_GCF_000008685.2	chromosome	194875	195736	861	99.6	3.179e-187
UCT31H	contig_1	717249	718389	1140	renamed_GCF_000008685.2	chromosome	193463	192323	1140	100.0	4.164e-257
UCT31H	contig_1	718385	719195	810	renamed_GCF_000008685.2	chromosome	192327	191517	810	100.0	2.276e-182
UCT31H	contig_1	719994	719253	741	renamed_GCF_000008685.2	chromosome	190718	191459	741	100.0	7.281e-158
UCT31H	contig_1	720649	719995	654	renamed_GCF_000008685.2	chromosome	190186	190717	654	100.0	6.314e-111
UCT31H	contig_1	720853	721414	561	renamed_GCF_000008685.2	chromosome	189859	189298	561	100.0	1.275e-121
UCT31H	contig_1	727910	729305	1395	renamed_GCF_000008685.2	chromosome	182802	181407	1395	100.0	4.219e-300
UCT31H	contig_1	729307	731173	1866	renamed_GCF_000008685.2	chromosome	181405	179539	1866	100.0	0.0
UCT31H	contig_1	731169	731796	627	renamed_GCF_000008685.2	chromosome	179543	178916	627	100.0	1.275e-132
UCT31H	contig_1	731852	732845	993	renamed_GCF_000008685.2	chromosome	178860	177867	993	100.0	4.528e-214
UCT31H	contig_1	732859	733735	876	renamed_GCF_000008685.2	chromosome	177853	176977	876	100.0	9.427e-195
UCT31H	contig_1	733738	734644	906	renamed_GCF_000008685.2	chromosome	176974	176068	906	100.0	1.374e-195
UCT31H	contig_1	735628	736615	987	renamed_GCF_000008685.2	chromosome	174970	174097	987	100.0	1.551e-190
UCT31H	contig_1	736596	737184	588	renamed_GCF_000008685.2	chromosome	174116	173528	588	100.0	1.529e-132
UCT31H	contig_1	737132	739181	2049	renamed_GCF_000008685.2	chromosome	173535	171531	2049	99.8	0.0
UCT31H	contig_1	751345	750670	675	renamed_GCF_000008685.2	chromosome	159367	160042	675	100.0	1.946e-144
UCT31H	contig_1	752085	751368	717	renamed_GCF_000008685.2	chromosome	158627	159344	717	100.0	1.01e-158
UCT31H	contig_1	841147	840586	561	renamed_GCF_000008685.2	chromosome	69565	70126	561	100.0	3.775e-118
UCT31H	contig_1	843465	841143	2322	renamed_GCF_000008685.2	chromosome	67247	69569	2322	100.0	0.0
UCT31H	contig_1	845422	844960	462	renamed_GCF_000008685.2	chromosome	65290	65752	462	100.0	3.193e-95
UCT31H	contig_1	846675	845436	1239	renamed_GCF_000008685.2	chromosome	64037	65276	1239	100.0	5.707e-279
UCT31H	contig_1	847566	846684	882	renamed_GCF_000008685.2	chromosome	63146	64028	882	100.0	1.369e-191
UCT31H	contig_1	849455	850145	690	renamed_GCF_000008685.2	chromosome	61257	60567	690	100.0	1.401e-150
UCT31H	contig_1	868229	869270	1041	renamed_GCF_000008685.2	chromosome	42483	41442	1041	100.0	8.938e-232
UCT31H	contig_1	869280	869952	672	renamed_GCF_000008685.2	chromosome	41432	40760	672	100.0	1.856e-144
UCT31H	contig_1	892408	892921	513	renamed_GCF_000008685.2	chromosome	18304	17791	513	100.0	1.701e-110
UCT31H	contig_1	894718	893908	810	renamed_GCF_000008685.2	chromosome	15994	16804	810	100.0	1.068e-173
UCT31H	contig_1	894990	895368	378	renamed_GCF_000008685.2	chromosome	15716	15344	378	100.0	1.768e-79
UCT31H	contig_1	895367	895988	621	renamed_GCF_000008685.2	chromosome	15345	14724	621	100.0	3.249e-138
UCT31H	contig_1	897967	895984	1983	renamed_GCF_000008685.2	chromosome	12745	14728	1983	100.0	0.0
UCT31H	contig_1	898559	897959	600	renamed_GCF_000008685.2	chromosome	12153	12753	600	100.0	4.114e-132
UCT31H	contig_1	899292	898551	741	renamed_GCF_000008685.2	chromosome	11420	12161	741	100.0	4.147e-164
UCT31H	contig_1	900132	899292	840	renamed_GCF_000008685.2	chromosome	10580	11420	840	100.0	7.775e-191
UCT31H	contig_2	8418	8844	426	renamed_GCF_000008685.2	lp54	8441	8867	426	100.0	3.21e-89
UCT31H	contig_2	9433	10255	822	renamed_GCF_000008685.2	lp54	9456	10278	822	100.0	5.801e-174
UCT31H	contig_2	10264	11155	891	renamed_GCF_000008685.2	lp54	10287	11178	891	100.0	1.898e-189
UCT31H	contig_2	12971	13556	585	renamed_GCF_000008685.2	lp54	12994	13579	585	100.0	1.763e-130
UCT31H	contig_2	13531	14284	753	renamed_GCF_000008685.2	lp54	13554	14307	753	100.0	4.561e-165
UCT31H	contig_2	14314	14860	546	renamed_GCF_000008685.2	lp54	14337	14883	546	100.0	1.338e-118
UCT31H	contig_2	24485	25091	606	renamed_GCF_000008685.2	lp54	24497	25103	606	100.0	6.612e-128
UCT31H	contig_2	25440	26682	1242	renamed_GCF_000008685.2	lp54	25467	26694	1242	100.0	1.5e-268
UCT31H	contig_2	51160	50269	891	renamed_GCF_000008685.2	lp54	51176	50285	891	100.0	3.698e-199
UCT31H	contig_2	51689	52463	774	renamed_GCF_000008685.2	lp54	51705	52479	774	100.0	9.219e-161
UCT31H	contig_2	52689	53487	798	renamed_GCF_000008685.2	lp54	52705	53503	798	100.0	3.008e-177
UCT31H	contig_3	7665	10926	3261	renamed_GCF_000008685.2	lp56	43696	40435	3261	100.0	0.0
UCT31H	contig_3	21855	22632	777	renamed_GCF_000008685.2	lp56	29506	28729	777	100.0	6.363e-174
UCT31H	contig_3	23063	22637	426	renamed_GCF_000008685.2	lp56	28298	28724	426	100.0	8.877e-95
UCT31H	contig_3	39147	38910	237	renamed_GCF_000008685.2	cp32-4	8733	8970	237	100.0	1.76e-48
UCT31H	contig_3	39599	39143	456	renamed_GCF_000008685.2	cp32-4	8281	8737	456	100.0	1.971e-99
UCT31H	contig_3	40043	39614	429	renamed_GCF_000008685.2	lp56	11296	11725	429	100.0	5.601e-92
UCT31H	contig_3	42102	41712	390	renamed_GCF_000008685.2	cp32-1	5767	6157	390	100.0	3.229e-83
UCT31H	contig_3	42473	42089	384	renamed_GCF_000008685.2	lp56	8866	9250	384	100.0	2.931e-83
UCT31H	contig_3	42928	42472	456	renamed_GCF_000008685.2	lp56	8411	8867	456	100.0	1.075e-97
UCT31H	contig_3	43907	42947	960	renamed_GCF_000008685.2	cp32-6	3969	4929	960	100.0	6.008e-214
UCT31H	contig_3	44504	43928	576	renamed_GCF_000008685.2	lp56	6835	7411	576	100.0	4.521e-127
UCT31H	contig_8	27321	27117	204	renamed_GCF_000008685.2	lp56	18712	18916	204	100.0	2.578e-39
UCT31H	contig_9	11299	12310	1011	renamed_GCF_000008685.2	cp32-7	18728	17711	1011	98.8	2.166e-225
UCT31H	contig_9	13470	12882	588	renamed_GCF_000008685.2	cp32-7	16551	17139	588	100.0	7.272e-124
UCT31H	contig_9	21749	21293	456	renamed_GCF_000008685.2	cp32-7	8273	8729	456	100.0	8.859e-100
UCT31H	contig_9	24627	24243	384	renamed_GCF_000008685.2	cp32-6	5403	5787	384	100.0	2.931e-83
UCT31H	contig_9	26061	25101	960	renamed_GCF_000008685.2	lp56	7432	8392	960	100.0	6.008e-214
UCT31H	contig_11	11220	11775	555	renamed_GCF_000008685.2	cp32-9	16641	17196	555	100.0	1.867e-116
UCT31H	contig_11	13742	14843	1101	renamed_GCF_000008685.2	cp32-9	19163	20264	1101	100.0	3.592e-252
UCT31H	contig_11	15395	16151	756	renamed_GCF_000008685.2	cp32-9	20816	21572	756	100.0	2.151e-165
UCT31H	contig_11	23877	25230	1353	renamed_GCF_000008685.2	cp32-9	29298	30651	1353	100.0	6.259e-306
UCT31H	contig_11	27242	27809	567	renamed_GCF_000008685.2	cp32-9	2012	2579	567	100.0	4.74e-125
UCT31H	contig_11	27812	28580	768	renamed_GCF_000008685.2	cp32-9	2582	3350	768	100.0	6.66e-172
UCT31H	contig_12	457	1567	1110	renamed_GCF_000008685.2	lp21	1485	2628	1110	98.9	8.376e-253
UCT31H	contig_12	13228	12316	912	renamed_GCF_000008685.2	cp9	2803	3712	912	99.3	1.323e-205
UCT31H	contig_13	10570	11071	501	renamed_GCF_000008685.2	cp32-4	16496	16997	501	100.0	5.048e-105
UCT31H	contig_13	12657	11646	1011	renamed_GCF_000008685.2	cp32-4	18583	17572	1011	100.0	1.362e-230
UCT31H	contig_13	13033	14131	1098	renamed_GCF_000008685.2	cp32-4	18959	20057	1098	100.0	8.352e-251
UCT31H	contig_13	14682	15438	756	renamed_GCF_000008685.2	cp32-4	20608	21364	756	100.0	8.022e-168
UCT31H	contig_13	26385	26949	564	renamed_GCF_000008685.2	cp32-4	2012	2576	564	100.0	2.235e-124
UCT31H	contig_13	27748	28324	576	renamed_GCF_000008685.2	cp32-4	3375	3951	576	100.0	1.005e-126
UCT31H	contig_13	29324	29780	456	renamed_GCF_000008685.2	cp32-4	4951	5407	456	100.0	1.075e-97
UCT31H	contig_14	718	400	318	renamed_GCF_000008685.2	cp32-3	16585	16903	318	100.0	2.414e-66
UCT31H	contig_15	4856	5807	951	renamed_GCF_000008685.2	cp32-6	10961	11912	951	99.6	2.14e-215
UCT31H	contig_15	5824	6379	555	renamed_GCF_000008685.2	cp32-6	11929	12484	555	100.0	3.12e-119
UCT31H	contig_15	21987	22554	567	renamed_GCF_000008685.2	cp32-6	27922	28489	567	100.0	2.836e-122
UCT31H	contig_15	22550	23903	1353	renamed_GCF_000008685.2	cp32-6	28485	29838	1353	100.0	6.259e-306
UCT31H	contig_15	25208	25901	693	renamed_GCF_000008685.2	cp32-1	1305	1998	693	100.0	2.582e-144
UCT31H	contig_15	26477	27242	765	renamed_GCF_000008685.2	cp32-7	2573	3338	765	99.6	3.139e-171
UCT31H	contig_15	28844	29300	456	renamed_GCF_000008685.2	cp32-6	4948	5404	456	100.0	1.075e-97
UCT31H	contig_16	18908	18110	798	renamed_GCF_000008685.2	lp28-2	18827	18029	798	100.0	7.719e-184
UCT31H	contig_16	22385	19700	2685	renamed_GCF_000008685.2	lp28-2	22259	19619	2685	99.8	0.0
UCT31H	contig_16	22740	22353	387	renamed_GCF_000008685.2	lp28-2	22659	22272	387	100.0	4.63e-87
UCT31H	contig_16	23806	23113	693	renamed_GCF_000008685.2	lp28-2	23725	23032	693	100.0	4.125e-156
UCT31H	contig_16	24189	23802	387	renamed_GCF_000008685.2	lp28-2	24108	23721	387	100.0	1.013e-78
UCT31H	contig_16	26060	26471	411	renamed_GCF_000008685.2	lp28-2	25979	26390	411	100.0	2.076e-91
UCT31H	contig_16	27193	28021	828	renamed_GCF_000008685.2	lp28-2	27112	27940	828	100.0	3.316e-181
UCT31H	contig_16	29699	28934	765	renamed_GCF_000008685.2	lp28-2	29618	28853	765	100.0	1.703e-169
UCT31H	contig_17	1034	1502	468	renamed_GCF_000008685.2	lp28-3	27445	26977	468	99.3	1.339e-105
UCT31H	contig_17	5802	5526	276	renamed_GCF_000008685.2	lp28-3	22677	22953	276	100.0	6.026e-58
UCT31H	contig_17	9682	9052	630	renamed_GCF_000008685.2	lp28-3	18797	19427	630	100.0	1.007e-135
UCT31H	contig_17	10533	9777	756	renamed_GCF_000008685.2	lp28-3	17946	18702	756	100.0	8.81e-167
UCT31H	contig_19	6985	7651	666	renamed_GCF_000008685.2	lp28-4	19183	18517	666	100.0	3.109e-146
UCT31H	contig_19	12904	12331	573	renamed_GCF_000008685.2	lp28-4	13264	13837	573	100.0	2.579e-124
UCT31H	contig_19	13715	12962	753	renamed_GCF_000008685.2	lp28-4	12453	13206	753	100.0	4.561e-165
UCT31H	contig_19	15357	14241	1116	renamed_GCF_000008685.2	lp28-4	10814	11927	1116	99.7	2.242e-251
UCT31H	contig_20	10642	10939	297	renamed_GCF_000008685.2	lp17	9980	9590	297	100.0	9.385e-65
UCT31H	contig_20	12745	12418	327	renamed_GCF_000008685.2	lp17	7784	8111	327	100.0	1.029e-68
UCT31H	contig_20	14077	14656	579	renamed_GCF_000008685.2	lp17	6452	5873	579	100.0	2.345e-126
UCT31H	contig_20	16932	16710	222	renamed_GCF_000008685.2	lp17	3651	3819	222	100.0	6.565e-33
UCT31H	contig_20	20200	19726	474	renamed_GCF_000008685.2	lp17	329	803	474	100.0	1.788e-103
UCT31H	contig_21	7666	8107	441	renamed_GCF_000008685.2	cp9	1281	1839	441	100.0	7.669e-99
UCT31H	contig_21	8159	8720	561	renamed_GCF_000008685.2	cp9	1891	2452	561	100.0	2.578e-122
UCT31H	contig_1	24258	26478	2220	renamed_GCF_000008685.2	chromosome	886447	884227	2220	100.0	0.0
UCT31H	contig_1	26492	29621	3129	renamed_GCF_000008685.2	chromosome	884213	881084	3129	100.0	0.0
UCT31H	contig_1	29614	30439	825	renamed_GCF_000008685.2	chromosome	881091	880266	825	100.0	2.882e-182
UCT31H	contig_1	31391	30455	936	renamed_GCF_000008685.2	chromosome	879314	880250	936	99.6	1.601e-207
UCT31H	contig_1	34277	31424	2853	renamed_GCF_000008685.2	chromosome	876491	879281	2853	99.6	0.0
UCT31H	contig_1	35499	34257	1242	renamed_GCF_000008685.2	chromosome	875206	876448	1242	100.0	1.008e-281
UCT31H	contig_1	90100	89518	582	renamed_GCF_000008685.2	chromosome	820606	821188	582	100.0	9.143e-129
UCT31H	contig_1	91785	91464	321	renamed_GCF_000008685.2	chromosome	819035	819242	321	98.5	2.552e-42
UCT31H	contig_1	92689	92158	531	renamed_GCF_000008685.2	chromosome	818017	818548	531	100.0	1.403e-115
UCT31H	contig_1	93504	94395	891	renamed_GCF_000008685.2	chromosome	817160	816311	891	99.6	1.029e-187
UCT31H	contig_1	103792	104941	1149	renamed_GCF_000008685.2	chromosome	806923	805774	1149	100.0	1.098e-247
UCT31H	contig_1	107548	107878	330	renamed_GCF_000008685.2	chromosome	803167	802837	330	100.0	2.178e-69
UCT31H	contig_1	109706	108938	768	renamed_GCF_000008685.2	chromosome	801118	801778	768	99.5	4.938e-141
UCT31H	contig_1	110441	111509	1068	renamed_GCF_000008685.2	chromosome	800275	799207	1068	100.0	8.292e-246
UCT31H	contig_1	112668	113598	930	renamed_GCF_000008685.2	chromosome	798048	797118	930	100.0	3.063e-199
UCT31H	contig_1	171574	171034	540	renamed_GCF_000008685.2	chromosome	739143	739683	540	100.0	2.458e-119
UCT31H	contig_1	173009	172289	720	renamed_GCF_000008685.2	chromosome	737708	738428	720	100.0	9.639e-160
UCT31H	contig_1	173758	173509	249	renamed_GCF_000008685.2	chromosome	736959	737208	249	100.0	2.148e-48
UCT31H	contig_1	175366	174031	1335	renamed_GCF_000008685.2	chromosome	735351	736686	1335	100.0	6.003e-286
UCT31H	contig_1	176637	175428	1209	renamed_GCF_000008685.2	chromosome	734080	735289	1209	100.0	8.188e-270
UCT31H	contig_1	179618	180086	468	renamed_GCF_000008685.2	chromosome	731099	730631	468	100.0	1.969e-101
UCT31H	contig_1	182052	181098	954	renamed_GCF_000008685.2	chromosome	728665	729619	954	100.0	1.334e-212
UCT31H	contig_1	184260	182964	1296	renamed_GCF_000008685.2	chromosome	726457	727753	1296	100.0	7.283e-286
UCT31H	contig_1	186494	185270	1224	renamed_GCF_000008685.2	chromosome	724223	725447	1224	100.0	3.222e-274
UCT31H	contig_1	186587	187655	1068	renamed_GCF_000008685.2	chromosome	724130	723062	1068	100.0	3.402e-247
UCT31H	contig_1	230966	231758	792	renamed_GCF_000008685.2	chromosome	679750	678958	792	100.0	1.55e-166
UCT31H	contig_1	249200	251072	1872	renamed_GCF_000008685.2	chromosome	661515	659643	1872	100.0	0.0
UCT31H	contig_1	256829	255866	963	renamed_GCF_000008685.2	chromosome	653886	654849	963	100.0	5.23e-216
UCT31H	contig_1	260328	261546	1218	renamed_GCF_000008685.2	chromosome	650387	649169	1218	100.0	2.758e-266
UCT31H	contig_1	262163	261608	555	renamed_GCF_000008685.2	chromosome	648552	649107	555	100.0	3.12e-119
UCT31H	contig_1	264997	264034	963	renamed_GCF_000008685.2	chromosome	645718	646681	963	100.0	1.162e-215
UCT31H	contig_1	278724	278232	492	renamed_GCF_000008685.2	chromosome	631990	632482	492	100.0	1.786e-106
UCT31H	contig_1	280016	281519	1503	renamed_GCF_000008685.2	chromosome	630698	629195	1503	100.0	0.0
UCT31H	contig_1	284429	283676	753	renamed_GCF_000008685.2	chromosome	626285	627038	753	100.0	9.23e-166
UCT31H	contig_1	336862	335467	1395	renamed_GCF_000008685.2	chromosome	573852	575247	1395	100.0	2.85e-313
UCT31H	contig_1	339432	338862	570	renamed_GCF_000008685.2	chromosome	571282	571852	570	100.0	1.471e-121
UCT31H	contig_1	341437	341176	261	renamed_GCF_000008685.2	chromosome	569277	569538	261	100.0	9.575e-51
UCT31H	contig_1	342905	342437	468	renamed_GCF_000008685.2	chromosome	567809	568277	468	100.0	1.969e-101
UCT31H	contig_1	348530	346547	1983	renamed_GCF_000008685.2	chromosome	562184	564167	1983	100.0	0.0
UCT31H	contig_1	349160	349598	438	renamed_GCF_000008685.2	chromosome	561554	561116	438	100.0	1.44e-91
UCT31H	contig_1	349982	352709	2727	renamed_GCF_000008685.2	chromosome	560732	558005	2727	100.0	0.0
UCT31H	contig_1	366128	363326	2802	renamed_GCF_000008685.2	chromosome	544585	547387	2802	99.8	0.0
UCT31H	contig_1	367665	366897	768	renamed_GCF_000008685.2	chromosome	543048	543816	768	100.0	8.433e-178
UCT31H	contig_1	401840	401468	372	renamed_GCF_000008685.2	chromosome	508869	509241	372	100.0	8.775e-78
UCT31H	contig_1	402896	401861	1035	renamed_GCF_000008685.2	chromosome	507813	508848	1035	100.0	4.156e-222
UCT31H	contig_1	403304	402911	393	renamed_GCF_000008685.2	chromosome	507405	507798	393	100.0	3.073e-84
UCT31H	contig_1	403708	403330	378	renamed_GCF_000008685.2	chromosome	507001	507379	378	100.0	8.763e-79
UCT31H	contig_1	403839	403725	114	renamed_GCF_000008685.2	chromosome	506864	506984	114	100.0	7.638e-22
UCT31H	contig_1	405156	403851	1305	renamed_GCF_000008685.2	chromosome	505553	506858	1305	100.0	4.133e-285
UCT31H	contig_1	405606	405168	438	renamed_GCF_000008685.2	chromosome	505103	505541	438	100.0	1.186e-93
UCT31H	contig_1	405911	405605	306	renamed_GCF_000008685.2	chromosome	504798	505104	306	100.0	1.468e-61
UCT31H	contig_1	406412	405914	498	renamed_GCF_000008685.2	chromosome	504297	504795	498	100.0	1.785e-107
UCT31H	contig_1	406784	406424	360	renamed_GCF_000008685.2	chromosome	503925	504285	360	100.0	4.361e-75
UCT31H	contig_1	420066	418782	1284	renamed_GCF_000008685.2	chromosome	490643	491927	1284	100.0	9.564e-281
UCT31H	contig_1	428110	426427	1683	renamed_GCF_000008685.2	chromosome	482599	484282	1683	100.0	0.0
UCT31H	contig_1	428652	429366	714	renamed_GCF_000008685.2	chromosome	482057	481343	714	100.0	3.944e-160
UCT31H	contig_1	431001	429690	1311	renamed_GCF_000008685.2	chromosome	479708	481019	1311	100.0	7.438e-297
UCT31H	contig_1	432635	434447	1812	renamed_GCF_000008685.2	chromosome	478005	476262	1812	100.0	0.0
UCT31H	contig_1	435104	434498	606	renamed_GCF_000008685.2	chromosome	475605	476211	606	100.0	1.006e-131
UCT31H	contig_1	436097	435107	990	renamed_GCF_000008685.2	chromosome	474612	475602	990	100.0	3.939e-215
UCT31H	contig_1	436153	437305	1152	renamed_GCF_000008685.2	chromosome	474556	473404	1152	100.0	7.714e-261
UCT31H	contig_1	438144	437301	843	renamed_GCF_000008685.2	chromosome	472565	473408	843	100.0	5.328e-187
UCT31H	contig_1	489331	491209	1878	renamed_GCF_000008685.2	chromosome	421380	419502	1878	100.0	0.0
UCT31H	contig_1	501309	502158	849	renamed_GCF_000008685.2	chromosome	409402	408553	849	100.0	9.834e-190
UCT31H	contig_1	502331	502511	180	renamed_GCF_000008685.2	chromosome	408380	408200	180	100.0	2.118e-37
UCT31H	contig_1	502813	503368	555	renamed_GCF_000008685.2	chromosome	407898	407343	555	100.0	5.734e-121
UCT31H	contig_1	503419	503851	432	renamed_GCF_000008685.2	chromosome	407292	406860	432	100.0	3.534e-89
UCT31H	contig_1	503850	504531	681	renamed_GCF_000008685.2	chromosome	406861	406180	681	100.0	2.702e-150
UCT31H	contig_1	504535	505024	489	renamed_GCF_000008685.2	chromosome	406176	405687	489	100.0	1.238e-101
UCT31H	contig_1	505094	505469	375	renamed_GCF_000008685.2	chromosome	405617	405242	375	100.0	5.555e-75
UCT31H	contig_1	509034	513168	4134	renamed_GCF_000008685.2	chromosome	401677	397543	4134	100.0	0.0
UCT31H	contig_1	535051	534772	279	renamed_GCF_000008685.2	chromosome	375660	375939	279	100.0	3.143e-57
UCT31H	contig_1	536435	535058	1377	renamed_GCF_000008685.2	chromosome	374276	375653	1377	100.0	1.277e-310
UCT31H	contig_1	536560	537145	585	renamed_GCF_000008685.2	chromosome	374151	373566	585	100.0	4.312e-129
UCT31H	contig_1	537572	537191	381	renamed_GCF_000008685.2	chromosome	373139	373520	381	100.0	1.683e-80
UCT31H	contig_1	539678	537665	2013	renamed_GCF_000008685.2	chromosome	371033	373046	2013	100.0	0.0
UCT31H	contig_1	540685	539698	987	renamed_GCF_000008685.2	chromosome	370026	371013	987	100.0	7.343e-225
UCT31H	contig_1	541827	540684	1143	renamed_GCF_000008685.2	chromosome	368884	370027	1143	100.0	3.212e-243
UCT31H	contig_1	542256	541830	426	renamed_GCF_000008685.2	chromosome	368455	368881	426	100.0	3.899e-87
UCT31H	contig_1	543751	544483	732	renamed_GCF_000008685.2	chromosome	366960	366228	732	100.0	5.239e-160
UCT31H	contig_1	590453	591032	579	renamed_GCF_000008685.2	chromosome	320249	319679	579	99.4	6.936e-123
UCT31H	contig_1	600189	600933	744	renamed_GCF_000008685.2	chromosome	310523	309779	744	100.0	5.245e-162
UCT31H	contig_1	600932	602174	1242	renamed_GCF_000008685.2	chromosome	309780	308538	1242	100.0	1.368e-269
UCT31H	contig_1	602195	603395	1200	renamed_GCF_000008685.2	chromosome	308517	307317	1200	100.0	3.302e-261
UCT31H	contig_1	603395	604088	693	renamed_GCF_000008685.2	chromosome	307317	306624	693	100.0	2.971e-151
UCT31H	contig_1	604094	605042	948	renamed_GCF_000008685.2	chromosome	306615	305670	948	100.0	3.249e-210
UCT31H	contig_1	605051	605600	549	renamed_GCF_000008685.2	chromosome	305661	305112	549	100.0	9.24e-115
UCT31H	contig_1	605592	606939	1347	renamed_GCF_000008685.2	chromosome	305120	303773	1347	100.0	1.016e-290
UCT31H	contig_1	606972	607380	408	renamed_GCF_000008685.2	chromosome	303740	303332	408	100.0	2.649e-88
UCT31H	contig_1	607403	607862	459	renamed_GCF_000008685.2	chromosome	303309	302850	459	100.0	4.601e-99
UCT31H	contig_1	623623	624742	1119	renamed_GCF_000008685.2	chromosome	287089	285970	1119	100.0	9.957e-244
UCT31H	contig_1	636859	635476	1383	renamed_GCF_000008685.2	chromosome	273856	275236	1383	99.7	2.662e-303
UCT31H	contig_1	637065	638079	1014	renamed_GCF_000008685.2	chromosome	273647	272633	1014	100.0	5.532e-224
UCT31H	contig_1	638032	640225	2193	renamed_GCF_000008685.2	chromosome	272641	270487	2193	100.0	0.0
UCT31H	contig_1	640239	641040	801	renamed_GCF_000008685.2	chromosome	270473	269672	801	100.0	6.66e-169
UCT31H	contig_1	643647	643437	210	renamed_GCF_000008685.2	chromosome	267065	267275	210	100.0	4.647e-42
UCT31H	contig_1	644606	643661	945	renamed_GCF_000008685.2	chromosome	266106	267051	945	100.0	6.277e-211
UCT31H	contig_1	646725	644598	2127	renamed_GCF_000008685.2	chromosome	263987	266114	2127	100.0	0.0
UCT31H	contig_1	647000	649421	2421	renamed_GCF_000008685.2	chromosome	263712	261291	2421	100.0	0.0
UCT31H	contig_1	673083	673491	408	renamed_GCF_000008685.2	chromosome	237629	237221	408	100.0	2.649e-88
UCT31H	contig_1	699412	698644	768	renamed_GCF_000008685.2	chromosome	211300	212068	768	100.0	8.822e-169
UCT31H	contig_1	702092	702629	537	renamed_GCF_000008685.2	chromosome	208581	208083	537	99.3	7.373e-107
UCT31H	contig_1	704184	702606	1578	renamed_GCF_000008685.2	chromosome	206528	208106	1578	100.0	0.0
UCT31H	contig_1	705640	704668	972	renamed_GCF_000008685.2	chromosome	205174	206044	972	99.6	3.289e-188
UCT31H	contig_1	706576	705640	936	renamed_GCF_000008685.2	chromosome	204136	205072	936	100.0	4.7e-204
UCT31H	contig_1	707863	706624	1239	renamed_GCF_000008685.2	chromosome	202849	204088	1239	100.0	5.514e-262
UCT31H	contig_1	727827	727332	495	renamed_GCF_000008685.2	chromosome	182885	183380	495	100.0	9.271e-106
UCT31H	contig_1	739462	739228	234	renamed_GCF_000008685.2	chromosome	171262	171484	234	98.6	1.134e-44
UCT31H	contig_1	739615	739993	378	renamed_GCF_000008685.2	chromosome	171097	170719	378	100.0	1.603e-80
UCT31H	contig_1	741174	740004	1170	renamed_GCF_000008685.2	chromosome	169562	170708	1170	99.7	6.062e-258
UCT31H	contig_1	741313	742834	1521	renamed_GCF_000008685.2	chromosome	169399	167878	1521	100.0	0.0
UCT31H	contig_1	742953	744798	1845	renamed_GCF_000008685.2	chromosome	167759	165914	1845	100.0	0.0
UCT31H	contig_1	744825	745812	987	renamed_GCF_000008685.2	chromosome	165887	164900	987	100.0	2.687e-210
UCT31H	contig_1	745892	747641	1749	renamed_GCF_000008685.2	chromosome	164820	163071	1749	100.0	0.0
UCT31H	contig_1	747835	747667	168	renamed_GCF_000008685.2	chromosome	162877	163045	168	100.0	5.294e-34
UCT31H	contig_1	747911	749513	1602	renamed_GCF_000008685.2	chromosome	162801	161199	1602	100.0	0.0
UCT31H	contig_1	772948	774841	1893	renamed_GCF_000008685.2	chromosome	137766	135873	1893	100.0	0.0
UCT31H	contig_1	776740	774850	1890	renamed_GCF_000008685.2	chromosome	133974	135864	1890	100.0	0.0
UCT31H	contig_1	776872	778243	1371	renamed_GCF_000008685.2	chromosome	133842	132471	1371	100.0	2.422e-302
UCT31H	contig_1	779417	778289	1128	renamed_GCF_000008685.2	chromosome	131297	132425	1128	100.0	3.566e-248
UCT31H	contig_1	779600	780545	945	renamed_GCF_000008685.2	chromosome	131114	130169	945	100.0	6.888e-210
UCT31H	contig_1	780582	783288	2706	renamed_GCF_000008685.2	chromosome	130132	127426	2706	100.0	0.0
UCT31H	contig_1	783301	784399	1098	renamed_GCF_000008685.2	chromosome	127413	126315	1098	100.0	1.369e-236
UCT31H	contig_1	784413	785181	768	renamed_GCF_000008685.2	chromosome	126301	125533	768	100.0	3.291e-171
UCT31H	contig_1	785167	785917	750	renamed_GCF_000008685.2	chromosome	125547	124797	750	100.0	1.281e-161
UCT31H	contig_1	785900	786566	666	renamed_GCF_000008685.2	chromosome	124814	124148	666	100.0	8.347e-144
UCT31H	contig_1	795908	795206	702	renamed_GCF_000008685.2	chromosome	114806	115508	702	100.0	2.35e-155
UCT31H	contig_1	796111	797806	1695	renamed_GCF_000008685.2	chromosome	114603	112908	1695	100.0	0.0
UCT31H	contig_1	797945	798365	420	renamed_GCF_000008685.2	chromosome	112769	112349	420	100.0	6.488e-89
UCT31H	contig_1	798376	798826	450	renamed_GCF_000008685.2	chromosome	112338	111888	450	100.0	4.387e-98
UCT31H	contig_1	798839	799130	291	renamed_GCF_000008685.2	chromosome	111875	111584	291	100.0	1.894e-64
UCT31H	contig_1	799147	799669	522	renamed_GCF_000008685.2	chromosome	111567	111045	522	100.0	1.783e-111
UCT31H	contig_1	799672	801040	1368	renamed_GCF_000008685.2	chromosome	111042	109674	1368	100.0	1.976e-295
UCT31H	contig_1	802408	801043	1365	renamed_GCF_000008685.2	chromosome	108306	109671	1365	100.0	4.349e-312
UCT31H	contig_1	802544	803741	1197	renamed_GCF_000008685.2	chromosome	108170	106973	1197	100.0	8.414e-259
UCT31H	contig_1	803820	804831	1011	renamed_GCF_000008685.2	chromosome	106894	105883	1011	100.0	4.14e-218
UCT31H	contig_1	816108	816495	387	renamed_GCF_000008685.2	chromosome	94605	94218	387	100.0	1.031e-86
UCT31H	contig_1	816681	817281	600	renamed_GCF_000008685.2	chromosome	94032	93432	600	100.0	1.47e-126
UCT31H	contig_1	817290	817836	546	renamed_GCF_000008685.2	chromosome	93423	92877	546	100.0	2.704e-119
UCT31H	contig_1	819598	820903	1305	renamed_GCF_000008685.2	chromosome	91115	89810	1305	100.0	2.863e-289
UCT31H	contig_1	820905	821514	609	renamed_GCF_000008685.2	chromosome	89808	89199	609	100.0	1.275e-129
UCT31H	contig_1	823353	823788	435	renamed_GCF_000008685.2	chromosome	87360	86925	435	100.0	2.772e-92
UCT31H	contig_1	823859	824834	975	renamed_GCF_000008685.2	chromosome	86854	85879	975	100.0	4.354e-220
UCT31H	contig_1	824993	826673	1680	renamed_GCF_000008685.2	chromosome	85720	84040	1680	100.0	0.0
UCT31H	contig_1	826793	827744	951	renamed_GCF_000008685.2	chromosome	83920	82969	951	99.6	3.736e-209
UCT31H	contig_1	829309	827773	1536	renamed_GCF_000008685.2	chromosome	81404	82940	1536	100.0	0.0
UCT31H	contig_1	829731	829305	426	renamed_GCF_000008685.2	chromosome	80982	81408	426	100.0	5.338e-92
UCT31H	contig_1	831209	829940	1269	renamed_GCF_000008685.2	chromosome	79504	80773	1269	100.0	1.4e-282
UCT31H	contig_1	831361	831712	351	renamed_GCF_000008685.2	chromosome	79322	79001	351	100.0	3.732e-67
UCT31H	contig_1	831704	833003	1299	renamed_GCF_000008685.2	chromosome	79009	77710	1299	100.0	8.363e-285
UCT31H	contig_1	834263	833012	1251	renamed_GCF_000008685.2	chromosome	76450	77701	1251	100.0	1.724e-268
UCT31H	contig_1	834940	834259	681	renamed_GCF_000008685.2	chromosome	75773	76454	681	100.0	3.584e-147
UCT31H	contig_1	858278	859460	1182	renamed_GCF_000008685.2	chromosome	52434	51252	1182	100.0	6.664e-259
UCT31H	contig_1	859461	860223	762	renamed_GCF_000008685.2	chromosome	51251	50489	762	100.0	1.168e-164
UCT31H	contig_1	860238	860601	363	renamed_GCF_000008685.2	chromosome	50474	50111	363	100.0	4.578e-75
UCT31H	contig_1	861372	860700	672	renamed_GCF_000008685.2	chromosome	49340	50012	672	100.0	9.591e-152
UCT31H	contig_1	861453	862110	657	renamed_GCF_000008685.2	chromosome	49259	48602	657	100.0	2.137e-140
UCT31H	contig_1	862808	862106	702	renamed_GCF_000008685.2	chromosome	47916	48606	702	100.0	4.54e-148
UCT31H	contig_1	863546	862871	675	renamed_GCF_000008685.2	chromosome	47166	47841	675	100.0	3.937e-145
UCT31H	contig_1	864333	864702	369	renamed_GCF_000008685.2	chromosome	46379	46010	369	100.0	3.085e-80
UCT31H	contig_1	865267	864721	546	renamed_GCF_000008685.2	chromosome	45445	45991	546	100.0	3.273e-117
UCT31H	contig_1	865358	867806	2448	renamed_GCF_000008685.2	chromosome	45354	42906	2448	100.0	0.0
UCT31H	contig_2	2870	2021	849	renamed_GCF_000008685.2	lp54	2893	2044	849	100.0	5.332e-188
UCT31H	contig_2	5117	4643	474	renamed_GCF_000008685.2	lp54	5140	4666	474	100.0	5.31e-100
UCT31H	contig_2	5290	5626	336	renamed_GCF_000008685.2	lp54	5313	5649	336	100.0	1.784e-72
UCT31H	contig_2	5622	6495	873	renamed_GCF_000008685.2	lp54	5645	6518	873	100.0	2.408e-192
UCT31H	contig_2	16553	15977	576	renamed_GCF_000008685.2	lp54	16576	16000	576	100.0	1.337e-123
UCT31H	contig_2	18701	20054	1353	renamed_GCF_000008685.2	lp54	18724	20077	1353	100.0	1.524e-304
UCT31H	contig_2	20705	20900	195	renamed_GCF_000008685.2	lp54	20717	20912	195	100.0	2.214e-39
UCT31H	contig_2	23261	21671	1590	renamed_GCF_000008685.2	lp54	23273	21683	1590	100.0	0.0
UCT31H	contig_2	48251	47459	792	renamed_GCF_000008685.2	lp54	48267	47475	792	100.0	4.37e-172
UCT31H	contig_3	15543	14976	567	renamed_GCF_000008685.2	lp56	35818	36385	567	100.0	4.74e-125
UCT31H	contig_3	18907	17554	1353	renamed_GCF_000008685.2	lp56	32454	33807	1353	100.0	5.71e-307
UCT31H	contig_3	20224	19651	573	renamed_GCF_000008685.2	lp56	31167	31710	573	100.0	2.482e-116
UCT31H	contig_3	31755	31401	354	renamed_GCF_000008685.2	lp56	19584	19938	354	100.0	1.459e-77
UCT31H	contig_3	32420	32072	348	renamed_GCF_000008685.2	lp56	18919	19267	348	100.0	3.962e-74
UCT31H	contig_3	33517	32701	816	renamed_GCF_000008685.2	lp56	17822	18638	816	98.8	8.08e-178
UCT31H	contig_3	34132	33526	606	renamed_GCF_000008685.2	cp32-4	13661	14267	606	100.0	5.47e-130
UCT31H	contig_4	28274	27368	906	renamed_GCF_000008685.2	lp36	28288	27382	906	100.0	5.634e-197
UCT31H	contig_4	31571	30704	867	renamed_GCF_000008685.2	lp36	31585	30718	867	100.0	3.181e-188
UCT31H	contig_4	34065	33066	999	renamed_GCF_000008685.2	lp36	34079	33080	999	100.0	2.04e-215
UCT31H	contig_7	10830	11163	333	renamed_GCF_000008685.2	cp32-4	12447	12780	333	100.0	8.424e-72
UCT31H	contig_7	19850	20600	750	renamed_GCF_000008685.2	cp32-7	20765	21515	750	100.0	2.593e-162
UCT31H	contig_7	21172	21745	573	renamed_GCF_000008685.2	cp32-7	22087	22660	573	100.0	7.629e-121
UCT31H	contig_9	4254	5031	777	renamed_GCF_000008685.2	cp32-1	25816	25039	777	99.6	6.363e-174
UCT31H	contig_9	6840	5514	1326	renamed_GCF_000008685.2	cp32-7	23134	24460	1326	99.7	3.211e-300
UCT31H	contig_9	14800	14596	204	renamed_GCF_000008685.2	cp32-3	15211	15415	204	100.0	2.578e-39
UCT31H	contig_9	18095	17549	546	renamed_GCF_000008685.2	cp32-7	11927	12473	546	100.0	8.009e-116
UCT31H	contig_9	19706	19064	642	renamed_GCF_000008685.2	cp32-7	10316	10958	642	100.0	3.749e-140
UCT31H	contig_9	21053	19718	1335	renamed_GCF_000008685.2	cp32-7	8969	10304	1335	100.0	9.244e-290
UCT31H	contig_9	29965	28741	1224	renamed_GCF_000008685.2	cp32-8	65	1289	1224	100.0	2.096e-270
UCT31H	contig_11	7501	8377	876	renamed_GCF_000008685.2	cp32-9	12921	13797	876	100.0	2.77e-191
UCT31H	contig_11	16192	16753	561	renamed_GCF_000008685.2	cp32-9	21613	22174	561	100.0	6.308e-121
UCT31H	contig_11	16762	17302	540	renamed_GCF_000008685.2	cp32-9	22183	22723	540	100.0	1.782e-114
UCT31H	contig_11	17772	19098	1326	renamed_GCF_000008685.2	cp32-9	23193	24519	1326	100.0	7.132e-300
UCT31H	contig_11	20788	21349	561	renamed_GCF_000008685.2	cp32-9	26209	26770	561	100.0	4.739e-124
UCT31H	contig_11	22604	23123	519	renamed_GCF_000008685.2	cp32-9	28025	28544	519	99.4	3.122e-113
UCT31H	contig_12	21986	22574	588	renamed_GCF_000008685.2	lp21	14647	15235	588	100.0	4.973e-128
UCT31H	contig_12	23851	23566	285	renamed_GCF_000008685.2	lp21	16548	16227	285	98.9	2.097e-62
UCT31H	contig_13	6521	6854	333	renamed_GCF_000008685.2	cp32-6	12513	12846	333	100.0	8.424e-72
UCT31H	contig_13	9240	9444	204	renamed_GCF_000008685.2	cp32-8	15214	15418	204	100.0	2.578e-39
UCT31H	contig_13	18283	18709	426	renamed_GCF_000008685.2	cp32-4	24209	24635	426	100.0	8.056e-96
UCT31H	contig_13	20078	20894	816	renamed_GCF_000008685.2	cp32-4	26004	26820	816	100.0	2.075e-184
UCT31H	contig_13	21749	22277	528	renamed_GCF_000008685.2	cp32-4	27675	28203	528	100.0	1.105e-117
UCT31H	contig_13	23020	24373	1353	renamed_GCF_000008685.2	cp32-4	28946	30299	1353	100.0	2.818e-306
UCT31H	contig_13	24438	25662	1224	renamed_GCF_000008685.2	cp32-4	65	1289	1224	100.0	4.655e-270
UCT31H	contig_14	21250	22027	777	renamed_GCF_000008685.2	cp32-3	26276	25499	777	100.0	3.144e-173
UCT31H	contig_14	23836	22510	1326	renamed_GCF_000008685.2	cp32-3	23690	25016	1326	100.0	1.445e-300
UCT31H	contig_14	26791	26224	567	renamed_GCF_000008685.2	cp32-3	20714	21281	567	100.0	2.944e-130
UCT31H	contig_14	28277	29219	942	renamed_GCF_000008685.2	cp32-3	19228	18286	942	100.0	4.129e-215
UCT31H	contig_15	7622	8228	606	renamed_GCF_000008685.2	cp32-6	13727	14333	606	100.0	5.47e-130
UCT31H	contig_15	9125	9329	204	renamed_GCF_000008685.2	cp32-9	15311	15515	204	100.0	2.578e-39
UCT31H	contig_15	11247	11694	447	renamed_GCF_000008685.2	cp32-1	17231	17678	447	77.7	8.625e-74
UCT31H	contig_15	13131	14232	1101	renamed_GCF_000008685.2	cp32-6	19068	20169	1101	98.9	5.702e-247
UCT31H	contig_16	17765	16574	1191	renamed_GCF_000008685.2	lp28-2	17684	16493	1191	100.0	6.781e-269
UCT31H	contig_17	11072	10505	567	renamed_GCF_000008685.2	lp28-3	17407	17974	567	100.0	1.938e-126
UCT31H	contig_20	798	1068	270	renamed_GCF_000008685.2	lp17	14069	14339	270	100.0	1.489e-55
UCT31H	contig_20	7191	6450	741	renamed_GCF_000008685.2	lp17	13338	14079	741	100.0	7.64e-166
UCT31H	contig_21	1270	745	525	renamed_GCF_000008685.2	cp9	4377	3852	525	100.0	1.87e-111
UCT31H	contig_21	1681	1396	285	renamed_GCF_000008685.2	cp9	4788	4503	285	100.0	2.564e-60
UCT31H	contig_1	2299	1114	1185	renamed_GCF_000008685.2	chromosome	908406	909591	1185	100.0	8.142e-266
UCT31H	contig_1	11207	9974	1233	renamed_GCF_000008685.2	chromosome	899498	900731	1233	100.0	1.522e-275
UCT31H	contig_1	13578	14127	549	renamed_GCF_000008685.2	chromosome	897127	896578	549	100.0	1.159e-120
UCT31H	contig_1	40682	41198	516	renamed_GCF_000008685.2	chromosome	870023	869507	516	100.0	1.621e-111
UCT31H	contig_1	41190	41973	783	renamed_GCF_000008685.2	chromosome	869380	868732	783	99.5	1.931e-145
UCT31H	contig_1	42591	42963	372	renamed_GCF_000008685.2	chromosome	868114	867742	372	100.0	7.954e-79
UCT31H	contig_1	44212	44011	201	renamed_GCF_000008685.2	chromosome	866493	866694	201	100.0	2.206e-40
UCT31H	contig_1	45653	44786	867	renamed_GCF_000008685.2	chromosome	865052	865919	867	100.0	6.442e-189
UCT31H	contig_1	48007	47059	948	renamed_GCF_000008685.2	chromosome	862698	863646	948	100.0	4.292e-207
UCT31H	contig_1	50595	51768	1173	renamed_GCF_000008685.2	chromosome	860111	858938	1173	100.0	1.287e-258
UCT31H	contig_1	141246	142638	1392	renamed_GCF_000008685.2	chromosome	769470	768078	1392	100.0	1.696e-292
UCT31H	contig_1	145344	144000	1344	renamed_GCF_000008685.2	chromosome	765372	766716	1344	100.0	2.685e-305
UCT31H	contig_1	147138	146355	783	renamed_GCF_000008685.2	chromosome	763578	764361	783	100.0	1.874e-171
UCT31H	contig_1	166196	165872	324	renamed_GCF_000008685.2	chromosome	744521	744845	324	100.0	1.32e-65
UCT31H	contig_1	168089	169322	1233	renamed_GCF_000008685.2	chromosome	742628	741395	1233	100.0	3.707e-274
UCT31H	contig_1	170272	170029	243	renamed_GCF_000008685.2	chromosome	740445	740688	243	100.0	1.755e-49
UCT31H	contig_1	170478	170295	183	renamed_GCF_000008685.2	chromosome	740239	740422	183	100.0	1.805e-39
UCT31H	contig_1	194097	192945	1152	renamed_GCF_000008685.2	chromosome	716619	717771	1152	100.0	1.261e-246
UCT31H	contig_1	242198	245708	3510	renamed_GCF_000008685.2	chromosome	668517	665007	3510	100.0	0.0
UCT31H	contig_1	247798	248113	315	renamed_GCF_000008685.2	chromosome	662917	662602	315	100.0	5.657e-65
UCT31H	contig_1	265114	265579	465	renamed_GCF_000008685.2	chromosome	645601	645136	465	100.0	4.176e-101
UCT31H	contig_1	266065	267421	1356	renamed_GCF_000008685.2	chromosome	644650	643294	1356	100.0	1.597e-304
UCT31H	contig_1	267589	268216	627	renamed_GCF_000008685.2	chromosome	643126	642499	627	100.0	8.735e-137
UCT31H	contig_1	272136	270843	1293	renamed_GCF_000008685.2	chromosome	638579	639872	1293	100.0	3.129e-286
UCT31H	contig_1	274123	272758	1365	renamed_GCF_000008685.2	chromosome	636592	637957	1365	100.0	3.184e-298
UCT31H	contig_1	291887	289679	2208	renamed_GCF_000008685.2	chromosome	618827	621035	2208	100.0	0.0
UCT31H	contig_1	294324	294951	627	renamed_GCF_000008685.2	chromosome	616390	615763	627	100.0	5.736e-133
UCT31H	contig_1	298667	296729	1938	renamed_GCF_000008685.2	chromosome	612047	613985	1938	100.0	0.0
UCT31H	contig_7	984	1752	768	renamed_GCF_000008685.2	cp32-6	2576	3344	768	100.0	1.48e-171
UCT31H	contig_7	1780	2356	576	renamed_GCF_000008685.2	cp32-6	3372	3948	576	100.0	4.521e-127
UCT31H	contig_7	4568	5135	567	renamed_GCF_000008685.2	lp56	9623	10190	567	98.9	5.214e-124
UCT31H	contig_7	5115	6228	1113	renamed_GCF_000008685.2	lp56	10170	11283	1113	99.4	1.675e-245
UCT31H	contig_7	6241	6670	429	renamed_GCF_000008685.2	cp32-4	7837	8266	429	100.0	5.601e-92
UCT31H	contig_7	13548	13752	204	renamed_GCF_000008685.2	cp32-4	15166	15370	204	100.0	2.578e-39
UCT31H	contig_8	23814	24828	1014	renamed_GCF_000008685.2	cp32-1	18728	17714	1014	100.0	7.051e-230
UCT31H	contig_8	26449	26095	354	renamed_GCF_000008685.2	cp32-1	16086	16440	354	100.0	6.554e-78
UCT31H	contig_8	26777	26441	336	renamed_GCF_000008685.2	cp32-1	15758	16094	336	100.0	2.402e-69
UCT31H	contig_8	27114	26766	348	renamed_GCF_000008685.2	cp32-3	15418	15766	348	100.0	3.962e-74
UCT31H	contig_8	28827	28221	606	renamed_GCF_000008685.2	cp32-1	13708	14314	606	100.0	5.47e-130
UCT31H	contig_9	12777	12354	423	renamed_GCF_000008685.2	cp32-7	17244	17667	423	100.0	2.074e-93
UCT31H	contig_9	13928	13574	354	renamed_GCF_000008685.2	cp32-8	16086	16440	354	100.0	1.459e-77
UCT31H	contig_9	14593	14236	357	renamed_GCF_000008685.2	cp32-7	15428	15785	357	100.0	8.381e-76
UCT31H	contig_9	22193	21764	429	renamed_GCF_000008685.2	cp32-6	7837	8266	429	100.0	5.601e-92
UCT31H	contig_9	24256	23866	390	renamed_GCF_000008685.2	cp32-6	5774	6164	390	100.0	1.451e-83
UCT31H	contig_10	4728	3849	879	renamed_GCF_000008685.2	cp32-7	12831	13710	879	99.3	7.082e-190
UCT31H	contig_12	29105	28811	294	renamed_GCF_000008685.2	lp21	15790	16084	294	100.0	2.432e-62
UCT31H	contig_13	237	804	567	renamed_GCF_000008685.2	cp32-4	6163	6730	567	100.0	1.054e-124
UCT31H	contig_13	9784	10120	336	renamed_GCF_000008685.2	cp32-9	15855	16191	336	100.0	5.348e-69
UCT31H	contig_13	11176	11599	423	renamed_GCF_000008685.2	cp32-4	17102	17525	423	100.0	4.616e-93
UCT31H	contig_13	14140	14707	567	renamed_GCF_000008685.2	cp32-4	20066	20633	567	100.0	2.944e-130
UCT31H	contig_13	15488	16034	546	renamed_GCF_000008685.2	cp32-4	21414	21960	546	100.0	3.273e-117
UCT31H	contig_13	26952	27720	768	renamed_GCF_000008685.2	cp32-4	2579	3347	768	100.0	3.291e-171
UCT31H	contig_13	28345	29305	960	renamed_GCF_000008685.2	cp32-4	3972	4932	960	100.0	6.008e-214
UCT31H	contig_14	8336	7061	1275	renamed_GCF_000008685.2	cp32-3	8967	10242	1275	97.6	1.125e-268
UCT31H	contig_14	9032	8576	456	renamed_GCF_000008685.2	cp32-1	8271	8727	456	100.0	1.971e-99
UCT31H	contig_15	29299	29683	384	renamed_GCF_000008685.2	cp32-7	5395	5779	384	100.0	2.931e-83
UCT31H	contig_16	19700	18917	783	renamed_GCF_000008685.2	lp28-2	19619	18836	783	100.0	1.354e-183
UCT31H	contig_16	23114	22739	375	renamed_GCF_000008685.2	lp28-2	23033	22658	375	100.0	2.05e-77
UCT31H	contig_16	24569	26036	1467	renamed_GCF_000008685.2	lp28-2	24488	25955	1467	100.0	0.0
UCT31H	contig_16	26737	27166	429	renamed_GCF_000008685.2	lp28-2	26569	27085	429	100.0	3.799e-96
UCT31H	contig_16	28111	28912	801	renamed_GCF_000008685.2	lp28-2	28030	28831	801	100.0	3.29e-168
UCT31H	contig_17	282	855	573	renamed_GCF_000008685.2	lp28-3	28197	27624	573	100.0	5.735e-124
UCT31H	contig_17	2135	3047	912	renamed_GCF_000008685.2	lp28-3	26371	25432	912	100.0	5.639e-198
UCT31H	contig_17	7010	6260	750	renamed_GCF_000008685.2	lp28-3	21469	22219	750	100.0	6.33e-161
UCT31H	contig_19	10817	9638	1179	renamed_GCF_000008685.2	lp28-4	15351	16530	1179	100.0	4.972e-253
UCT31H	contig_19	14245	13690	555	renamed_GCF_000008685.2	lp28-4	11923	12478	555	100.0	3.559e-126
UCT31H	contig_19	18935	17633	1302	renamed_GCF_000008685.2	lp28-4	7182	8538	1302	96.0	2.563e-281
UCT31H	contig_20	12263	11150	1113	renamed_GCF_000008685.2	lp17	8266	9379	1113	100.0	6.27e-248
UCT31H	contig_20	15474	14790	684	renamed_GCF_000008685.2	lp17	5055	5739	684	100.0	2.578e-151
UCT31H	contig_20	19120	18763	357	renamed_GCF_000008685.2	lp17	1409	1766	357	100.0	1.532e-77
UCT31H	contig_24	6	306	300	renamed_GCF_000008685.2	lp56	855	1407	300	98.9	8.92e-66
UCT31H	contig_1	22526	24236	1710	renamed_GCF_000008685.2	chromosome	888179	886469	1710	100.0	0.0
UCT31H	contig_1	107917	108775	858	renamed_GCF_000008685.2	chromosome	802798	801940	858	100.0	3.462e-177
UCT31H	contig_1	110241	109644	597	renamed_GCF_000008685.2	chromosome	800475	801072	597	100.0	2.836e-127
UCT31H	contig_1	111700	112660	960	renamed_GCF_000008685.2	chromosome	799016	798056	960	100.0	6.008e-214
UCT31H	contig_1	115861	116875	1014	renamed_GCF_000008685.2	chromosome	794855	793841	1014	100.0	1.719e-228
UCT31H	contig_1	118464	118923	459	renamed_GCF_000008685.2	chromosome	792252	791793	459	100.0	5.068e-98
UCT31H	contig_1	123857	121754	2103	renamed_GCF_000008685.2	chromosome	786859	788962	2103	100.0	0.0
UCT31H	contig_1	151131	150501	630	renamed_GCF_000008685.2	chromosome	759585	760215	630	100.0	3.747e-138
UCT31H	contig_1	154363	153046	1317	renamed_GCF_000008685.2	chromosome	756353	757670	1317	100.0	1.293e-291
UCT31H	contig_1	156649	156166	483	renamed_GCF_000008685.2	chromosome	754067	754550	483	100.0	1.405e-107
UCT31H	contig_1	189599	187697	1902	renamed_GCF_000008685.2	chromosome	721118	723020	1902	100.0	0.0
UCT31H	contig_1	204044	201449	2595	renamed_GCF_000008685.2	chromosome	706672	709267	2595	100.0	0.0
UCT31H	contig_1	205768	205216	552	renamed_GCF_000008685.2	chromosome	704948	705500	552	100.0	2.458e-121
UCT31H	contig_1	207708	206748	960	renamed_GCF_000008685.2	chromosome	703008	703968	960	100.0	6.008e-214
UCT31H	contig_1	208892	208442	450	renamed_GCF_000008685.2	chromosome	701824	702274	450	100.0	9.762e-98
UCT31H	contig_1	209688	209331	357	renamed_GCF_000008685.2	chromosome	701028	701385	357	100.0	2.301e-81
UCT31H	contig_1	222227	220589	1638	renamed_GCF_000008685.2	chromosome	688489	690127	1638	100.0	0.0
UCT31H	contig_1	224209	224740	531	renamed_GCF_000008685.2	chromosome	686507	685976	531	100.0	1.053e-118
UCT31H	contig_1	228038	227339	699	renamed_GCF_000008685.2	chromosome	682678	683377	699	100.0	1.337e-152
UCT31H	contig_1	228192	229032	840	renamed_GCF_000008685.2	chromosome	682524	681684	840	100.0	1.641e-182
UCT31H	contig_1	303731	305936	2205	renamed_GCF_000008685.2	chromosome	606983	604778	2205	100.0	0.0
UCT31H	contig_1	308341	306985	1356	renamed_GCF_000008685.2	chromosome	602373	603729	1356	100.0	2.305e-300
UCT31H	contig_1	311220	309870	1350	renamed_GCF_000008685.2	chromosome	599494	600844	1350	100.0	3.989e-293
UCT31H	contig_1	314184	312123	2061	renamed_GCF_000008685.2	chromosome	596530	598591	2061	100.0	0.0
UCT31H	contig_1	318227	314783	3444	renamed_GCF_000008685.2	chromosome	592445	595931	3444	100.0	0.0
UCT31H	contig_1	332765	332453	312	renamed_GCF_000008685.2	chromosome	577949	578261	312	100.0	5.387e-65
UCT31H	contig_1	333527	334133	606	renamed_GCF_000008685.2	chromosome	577187	576581	606	100.0	4.975e-131
UCT31H	contig_1	334898	335441	543	renamed_GCF_000008685.2	chromosome	575816	575273	543	100.0	3.121e-117
UCT31H	contig_1	336974	338825	1851	renamed_GCF_000008685.2	chromosome	573740	571889	1851	100.0	0.0
UCT31H	contig_1	341156	339434	1722	renamed_GCF_000008685.2	chromosome	569558	571280	1722	100.0	0.0
UCT31H	contig_1	396186	394926	1260	renamed_GCF_000008685.2	chromosome	514523	515783	1260	100.0	5.48e-283
UCT31H	contig_1	884960	884321	639	renamed_GCF_000008685.2	chromosome	25752	26391	639	100.0	1.211e-143
UCT31H	contig_1	887973	888567	594	renamed_GCF_000008685.2	chromosome	22739	22145	594	100.0	3.27e-125
UCT31H	contig_1	910600	910036	564	renamed_GCF_000008685.2	chromosome	104	677	564	100.0	4.108e-126
UCT31H	contig_2	1437	1947	510	renamed_GCF_000008685.2	lp54	1460	1970	510	100.0	8.829e-109
UCT31H	contig_2	4233	2979	1254	renamed_GCF_000008685.2	lp54	4256	3002	1254	100.0	3.245e-279
UCT31H	contig_2	6497	7124	627	renamed_GCF_000008685.2	lp54	6520	7147	627	100.0	4.747e-135
UCT31H	contig_2	15346	15778	432	renamed_GCF_000008685.2	lp54	15369	15801	432	100.0	1.792e-96
UCT31H	contig_2	17236	16672	564	renamed_GCF_000008685.2	lp54	17259	16695	564	100.0	1.065e-115
UCT31H	contig_2	18104	18698	594	renamed_GCF_000008685.2	lp54	18127	18721	594	100.0	1.47e-125
UCT31H	contig_4	6026	5273	753	renamed_GCF_000008685.2	lp36	6040	5287	753	100.0	7.287e-160
UCT31H	contig_4	9358	9985	627	renamed_GCF_000008685.2	lp36	9372	9999	627	100.0	1.942e-136
UCT31H	contig_4	12587	13223	636	renamed_GCF_000008685.2	lp36	12601	13237	636	100.0	3.41e-140
UCT31H	contig_4	24052	24229	177	renamed_GCF_000008685.2	lp36	24066	24243	177	100.0	7.659e-32
UCT31H	contig_4	25088	25643	555	renamed_GCF_000008685.2	lp36	25102	25657	555	100.0	3.12e-119
UCT31H	contig_4	26789	26570	219	renamed_GCF_000008685.2	lp36	26803	26584	219	100.0	9.792e-44
UCT31H	contig_4	30449	29462	987	renamed_GCF_000008685.2	lp36	30463	29476	987	100.0	5.255e-220
UCT31H	contig_4	32808	31812	996	renamed_GCF_000008685.2	lp36	32822	31826	996	100.0	2.481e-221
UCT31H	contig_5	1146	7482	6336	renamed_GCF_000008685.2	lp28-1	26996	28073	6336	55.1	2.156e-93
UCT31H	contig_5	11152	11407	255	renamed_GCF_000008685.2	lp28-1	17805	17550	255	100.0	1.423e-53
UCT31H	contig_6	20373	19614	759	renamed_GCF_000008685.2	lp25	12854	12095	759	100.0	2.255e-165
UCT31H	contig_6	20912	20348	564	renamed_GCF_000008685.2	lp25	13393	12829	564	100.0	4.519e-125
UCT31H	contig_8	1526	842	684	renamed_GCF_000008685.2	cp32-6	10274	10958	684	100.0	3.113e-149
UCT31H	contig_8	3067	2830	237	renamed_GCF_000008685.2	cp32-3	8723	8960	237	100.0	7.893e-49
UCT31H	contig_8	5090	3977	1113	renamed_GCF_000008685.2	cp32-8	6700	7813	1113	100.0	6.876e-247
UCT31H	contig_8	5637	5070	567	renamed_GCF_000008685.2	cp32-3	6153	6720	567	100.0	9.584e-126
UCT31H	contig_8	6023	5633	390	renamed_GCF_000008685.2	cp32-8	5767	6157	390	100.0	3.229e-83
UCT31H	contig_9	15691	14875	816	renamed_GCF_000008685.2	cp32-8	14323	15139	816	100.0	1.636e-178
UCT31H	contig_9	17520	17187	333	renamed_GCF_000008685.2	cp32-7	12502	12835	333	100.0	1.876e-71
UCT31H	contig_9	19061	18119	942	renamed_GCF_000008685.2	cp32-7	10961	11903	942	100.0	2.456e-212
UCT31H	contig_9	21297	21060	237	renamed_GCF_000008685.2	cp32-7	8725	8962	237	100.0	7.893e-49
UCT31H	contig_10	500	977	477	renamed_GCF_000008685.2	cp32-6	17075	16592	477	71.8	8.245e-71
UCT31H	contig_10	1795	1459	336	renamed_GCF_000008685.2	cp32-4	15710	16046	336	100.0	5.348e-69
UCT31H	contig_10	2339	2135	204	renamed_GCF_000008685.2	cp32-6	15230	15434	204	100.0	2.578e-39
UCT31H	contig_11	21376	22408	1032	renamed_GCF_000008685.2	cp32-9	26797	27829	1032	100.0	2.498e-227
UCT31H	contig_12	22687	23152	465	renamed_GCF_000008685.2	lp21	15348	15813	465	99.3	4.176e-101
UCT31H	contig_12	24224	25217	993	renamed_GCF_000008685.2	lp5	3339	4332	993	100.0	1.858e-215
UCT31H	contig_12	25272	25704	432	renamed_GCF_000008685.2	lp5	4387	4819	432	99.3	2.641e-92
UCT31H	contig_12	28010	27017	993	renamed_GCF_000008685.2	lp21	16885	17878	993	100.0	1.858e-215
UCT31H	contig_13	20926	21601	675	renamed_GCF_000008685.2	cp32-4	26852	27527	675	100.0	3.937e-145
UCT31H	contig_13	22457	23024	567	renamed_GCF_000008685.2	cp32-4	28383	28950	567	100.0	1.275e-122
UCT31H	contig_14	1548	1212	336	renamed_GCF_000008685.2	cp32-3	15755	16091	336	100.0	5.348e-69
UCT31H	contig_14	4809	4476	333	renamed_GCF_000008685.2	cp32-1	12494	12827	333	100.0	8.424e-72
UCT31H	contig_14	7039	6355	684	renamed_GCF_000008685.2	cp32-3	10264	10948	684	99.5	3.113e-149
UCT31H	contig_14	15998	15305	693	renamed_GCF_000008685.2	cp32-8	1305	1998	693	100.0	2.582e-144
UCT31H	contig_14	18656	17303	1353	renamed_GCF_000008685.2	cp32-3	28870	30223	1353	100.0	1.268e-306
UCT31H	contig_15	21810	21141	669	renamed_GCF_000008685.2	cp32-6	27745	27076	669	100.0	4.521e-151
UCT31H	contig_16	1127	2009	882	renamed_GCF_000008685.2	lp28-2	1046	1928	882	100.0	1.741e-197
UCT31H	contig_16	5458	6031	573	renamed_GCF_000008685.2	lp28-2	5377	5950	573	100.0	1.602e-129
UCT31H	contig_16	6817	7369	552	renamed_GCF_000008685.2	lp28-2	6736	7288	552	100.0	2.704e-120
UCT31H	contig_16	11572	11143	429	renamed_GCF_000008685.2	lp28-2	11491	11062	429	100.0	3.057e-90
UCT31H	contig_16	12833	12389	444	renamed_GCF_000008685.2	lp28-2	12752	12308	444	100.0	8.866e-98
UCT31H	contig_16	13576	13237	339	renamed_GCF_000008685.2	lp28-2	13495	13156	339	100.0	3.422e-74
UCT31H	contig_16	14966	14456	510	renamed_GCF_000008685.2	lp28-2	14885	14375	510	100.0	3.606e-110
UCT31H	contig_16	16563	15537	1026	renamed_GCF_000008685.2	lp28-2	16482	15456	1026	100.0	1.723e-230
UCT31H	contig_19	20994	20775	219	renamed_GCF_000008685.2	lp28-4	5127	5346	219	100.0	1.443e-47
UCT31H	contig_19	23586	22770	816	renamed_GCF_000008685.2	lp28-4	2535	3351	816	100.0	8.08e-178
UCT31H	contig_20	8883	9546	663	renamed_GCF_000008685.2	lp17	11646	10983	663	100.0	1.005e-149
UCT31H	contig_21	6429	7539	1110	renamed_GCF_000008685.2	cp9	162	1272	1110	100.0	8.376e-253
UCT31H	contig_1	5805	6777	972	renamed_GCF_000008685.2	chromosome	904900	903928	972	100.0	2.334e-209
UCT31H	contig_1	8872	7447	1425	renamed_GCF_000008685.2	chromosome	901833	903258	1425	100.0	1.211e-310
UCT31H	contig_1	9907	8923	984	renamed_GCF_000008685.2	chromosome	900798	901782	984	100.0	5.014e-220
UCT31H	contig_1	11385	13002	1617	renamed_GCF_000008685.2	chromosome	899320	897703	1617	100.0	0.0
UCT31H	contig_1	13010	13610	600	renamed_GCF_000008685.2	chromosome	897695	897095	600	100.0	6.881e-135
UCT31H	contig_1	17577	14136	3441	renamed_GCF_000008685.2	chromosome	893128	896569	3441	100.0	0.0
UCT31H	contig_1	20384	17531	2853	renamed_GCF_000008685.2	chromosome	890321	893174	2853	100.0	0.0
UCT31H	contig_1	42511	41965	546	renamed_GCF_000008685.2	chromosome	868194	868740	546	100.0	1.846e-123
UCT31H	contig_1	44025	43104	921	renamed_GCF_000008685.2	chromosome	866680	867601	921	100.0	3.086e-206
UCT31H	contig_1	44790	44247	543	renamed_GCF_000008685.2	chromosome	865915	866458	543	100.0	2.343e-120
UCT31H	contig_1	47070	45663	1407	renamed_GCF_000008685.2	chromosome	863635	865042	1407	100.0	1.287e-315
UCT31H	contig_1	95404	95839	435	renamed_GCF_000008685.2	chromosome	815302	814867	435	100.0	4.611e-95
UCT31H	contig_1	97000	97330	330	renamed_GCF_000008685.2	chromosome	813706	813385	330	97.2	1.608e-64
UCT31H	contig_1	98327	99209	882	renamed_GCF_000008685.2	chromosome	812388	811506	882	100.0	2.526e-193
UCT31H	contig_1	100220	101015	795	renamed_GCF_000008685.2	chromosome	810495	809700	795	100.0	1.877e-173
UCT31H	contig_1	101163	102255	1092	renamed_GCF_000008685.2	chromosome	809552	808460	1092	100.0	7.863e-242
UCT31H	contig_1	125660	123962	1698	renamed_GCF_000008685.2	chromosome	785056	786754	1698	100.0	0.0
UCT31H	contig_1	127468	127741	273	renamed_GCF_000008685.2	chromosome	783248	782975	273	100.0	3.858e-54
UCT31H	contig_1	127887	128565	678	renamed_GCF_000008685.2	chromosome	782829	782151	678	100.0	4.744e-152
UCT31H	contig_1	132952	131962	990	renamed_GCF_000008685.2	chromosome	777764	778754	990	100.0	1.559e-225
UCT31H	contig_1	134037	135051	1014	renamed_GCF_000008685.2	chromosome	776679	775665	1014	100.0	1.623e-220
UCT31H	contig_1	192974	192071	903	renamed_GCF_000008685.2	chromosome	717742	718669	903	100.0	1.36e-186
UCT31H	contig_1	195708	194097	1611	renamed_GCF_000008685.2	chromosome	715008	716619	1611	100.0	0.0
UCT31H	contig_1	196609	197473	864	renamed_GCF_000008685.2	chromosome	714107	713243	864	100.0	1.134e-190
UCT31H	contig_1	198509	199025	516	renamed_GCF_000008685.2	chromosome	712207	711691	516	100.0	1.621e-111
UCT31H	contig_1	199506	199065	441	renamed_GCF_000008685.2	chromosome	711210	711651	441	100.0	1.245e-93
UCT31H	contig_1	201443	200042	1401	renamed_GCF_000008685.2	chromosome	709273	710674	1401	100.0	3.758e-311
UCT31H	contig_1	210751	212317	1566	renamed_GCF_000008685.2	chromosome	699965	698399	1566	100.0	0.0
UCT31H	contig_1	213279	213966	687	renamed_GCF_000008685.2	chromosome	697437	696750	687	100.0	2.97e-150
UCT31H	contig_1	215193	216024	831	renamed_GCF_000008685.2	chromosome	695523	694692	831	100.0	5.839e-184
UCT31H	contig_1	218088	217188	900	renamed_GCF_000008685.2	chromosome	692628	693528	900	100.0	8.957e-191
UCT31H	contig_1	272753	272159	594	renamed_GCF_000008685.2	chromosome	637971	638556	594	100.0	1.47e-125
UCT31H	contig_1	276134	274703	1431	renamed_GCF_000008685.2	chromosome	634580	636011	1431	100.0	1.295e-319
UCT31H	contig_1	292155	294303	2148	renamed_GCF_000008685.2	chromosome	618559	616411	2148	100.0	0.0
UCT31H	contig_1	294943	296701	1758	renamed_GCF_000008685.2	chromosome	615771	614013	1758	100.0	0.0
UCT31H	contig_1	299406	298692	714	renamed_GCF_000008685.2	chromosome	611308	612022	714	100.0	1.949e-159
UCT31H	contig_1	303577	302779	798	renamed_GCF_000008685.2	chromosome	607137	607935	798	100.0	9.72e-173
UCT31H	contig_1	320367	319779	588	renamed_GCF_000008685.2	chromosome	590347	590935	588	100.0	4.112e-130
UCT31H	contig_1	323684	322832	852	renamed_GCF_000008685.2	chromosome	587030	587882	852	100.0	3.506e-193
UCT31H	contig_1	325623	324558	1065	renamed_GCF_000008685.2	chromosome	585079	586156	1065	99.7	1.659e-237
UCT31H	contig_1	379022	379586	564	renamed_GCF_000008685.2	chromosome	531692	531128	564	100.0	2.704e-122
UCT31H	contig_1	381516	382611	1095	renamed_GCF_000008685.2	chromosome	529198	528103	1095	100.0	3.934e-250
UCT31H	contig_1	386160	384459	1701	renamed_GCF_000008685.2	chromosome	524553	526254	1701	100.0	0.0
UCT31H	contig_1	407954	407768	186	renamed_GCF_000008685.2	chromosome	502755	502941	186	100.0	7.664e-41
UCT31H	contig_1	408830	408524	306	renamed_GCF_000008685.2	chromosome	501879	502185	306	100.0	2.959e-62
UCT31H	contig_1	409495	409240	255	renamed_GCF_000008685.2	chromosome	501214	501469	255	100.0	1.745e-51
UCT31H	contig_1	410117	409700	417	renamed_GCF_000008685.2	chromosome	500592	501009	417	100.0	2.778e-89
UCT31H	contig_1	411369	411006	363	renamed_GCF_000008685.2	chromosome	499340	499703	363	100.0	3.407e-78
UCT31H	contig_1	421218	420990	228	renamed_GCF_000008685.2	chromosome	489539	489719	228	100.0	1.455e-33
UCT31H	contig_1	493610	492998	612	renamed_GCF_000008685.2	chromosome	417101	417713	612	100.0	4.975e-132
UCT31H	contig_1	494023	493606	417	renamed_GCF_000008685.2	chromosome	416688	417105	417	100.0	1.248e-89
UCT31H	contig_1	494188	494866	678	renamed_GCF_000008685.2	chromosome	416478	415845	678	99.5	1.008e-143
UCT31H	contig_1	494918	496385	1467	renamed_GCF_000008685.2	chromosome	415793	414326	1467	100.0	0.0
UCT31H	contig_1	497599	496396	1203	renamed_GCF_000008685.2	chromosome	413112	414315	1203	100.0	6.394e-263
UCT31H	contig_1	497711	499256	1545	renamed_GCF_000008685.2	chromosome	413006	411455	1545	99.8	0.0
UCT31H	contig_1	499925	499265	660	renamed_GCF_000008685.2	chromosome	410786	411446	660	100.0	1.008e-140
UCT31H	contig_1	500264	501296	1032	renamed_GCF_000008685.2	chromosome	410447	409415	1032	100.0	9.895e-238
UCT31H	contig_1	513634	514108	474	renamed_GCF_000008685.2	chromosome	397077	396603	474	100.0	4.822e-101
UCT31H	contig_1	514205	515231	1026	renamed_GCF_000008685.2	chromosome	396506	395480	1026	100.0	3.003e-224
UCT31H	contig_1	546594	548394	1800	renamed_GCF_000008685.2	chromosome	364117	362317	1800	100.0	0.0
UCT31H	contig_1	549512	548390	1122	renamed_GCF_000008685.2	chromosome	361187	362321	1122	100.0	1.01e-252
UCT31H	contig_1	549633	551199	1566	renamed_GCF_000008685.2	chromosome	361078	359512	1566	100.0	0.0
UCT31H	contig_1	551216	551495	279	renamed_GCF_000008685.2	chromosome	359495	359216	279	100.0	2.841e-58
UCT31H	contig_1	552254	551513	741	renamed_GCF_000008685.2	chromosome	358457	359198	741	100.0	9.218e-164
UCT31H	contig_1	553705	552271	1434	renamed_GCF_000008685.2	chromosome	357006	358440	1434	100.0	9.657e-315
UCT31H	contig_1	555221	553802	1419	renamed_GCF_000008685.2	chromosome	355490	356909	1419	100.0	1.415e-316
UCT31H	contig_1	555413	556064	651	renamed_GCF_000008685.2	chromosome	355298	354647	651	100.0	1.769e-141
UCT31H	contig_1	556075	557272	1197	renamed_GCF_000008685.2	chromosome	354636	353439	1197	100.0	5.312e-264
UCT31H	contig_1	557271	559371	2100	renamed_GCF_000008685.2	chromosome	353437	351340	2100	100.0	0.0
UCT31H	contig_1	569438	568388	1050	renamed_GCF_000008685.2	chromosome	341273	342323	1050	100.0	1.489e-227
UCT31H	contig_1	570371	569450	921	renamed_GCF_000008685.2	chromosome	340340	341261	921	100.0	2.92e-198
UCT31H	contig_1	572354	570728	1626	renamed_GCF_000008685.2	chromosome	338357	339983	1626	100.0	0.0
UCT31H	contig_1	575775	574203	1572	renamed_GCF_000008685.2	chromosome	334936	336508	1572	100.0	0.0
UCT31H	contig_1	576196	577093	897	renamed_GCF_000008685.2	chromosome	334515	333618	897	100.0	1.666e-200
UCT31H	contig_1	577113	579909	2796	renamed_GCF_000008685.2	chromosome	333598	330802	2796	100.0	0.0
UCT31H	contig_1	579959	581069	1110	renamed_GCF_000008685.2	chromosome	330752	329642	1110	100.0	1.105e-249
UCT31H	contig_1	591075	591606	531	renamed_GCF_000008685.2	chromosome	319636	319105	531	100.0	1.699e-113
UCT31H	contig_1	591595	592435	840	renamed_GCF_000008685.2	chromosome	319116	318276	840	99.6	1.977e-180
UCT31H	contig_1	628025	628913	888	renamed_GCF_000008685.2	chromosome	282687	281799	888	100.0	4.025e-189
UCT31H	contig_1	628919	629399	480	renamed_GCF_000008685.2	chromosome	281793	281313	480	100.0	1.072e-101
UCT31H	contig_1	629401	631306	1905	renamed_GCF_000008685.2	chromosome	281311	279406	1905	100.0	0.0
UCT31H	contig_1	631332	631635	303	renamed_GCF_000008685.2	chromosome	279380	279077	303	100.0	2.087e-65
UCT31H	contig_1	631654	632176	522	renamed_GCF_000008685.2	chromosome	279058	278536	522	100.0	3.966e-111
UCT31H	contig_1	632153	633623	1470	renamed_GCF_000008685.2	chromosome	278559	277089	1470	100.0	8.9e-322
UCT31H	contig_1	634155	633648	507	renamed_GCF_000008685.2	chromosome	276671	277064	507	100.0	6.298e-87
UCT31H	contig_1	634216	635470	1254	renamed_GCF_000008685.2	chromosome	276496	275242	1254	100.0	4.99e-283
UCT31H	contig_1	654250	651727	2523	renamed_GCF_000008685.2	chromosome	256462	258985	2523	100.0	0.0
UCT31H	contig_1	655067	654452	615	renamed_GCF_000008685.2	chromosome	255645	256260	615	100.0	1.16e-131
UCT31H	contig_1	678375	675459	2916	renamed_GCF_000008685.2	chromosome	232337	235253	2916	100.0	0.0
UCT31H	contig_1	679092	678390	702	renamed_GCF_000008685.2	chromosome	231620	232322	702	100.0	1.161e-154
UCT31H	contig_1	679221	680499	1278	renamed_GCF_000008685.2	chromosome	231491	230213	1278	100.0	4.58e-288
UCT31H	contig_1	681496	680488	1008	renamed_GCF_000008685.2	chromosome	229216	230224	1008	100.0	1.228e-222
UCT31H	contig_1	682191	682899	708	renamed_GCF_000008685.2	chromosome	228521	227813	708	100.0	8.763e-159
UCT31H	contig_1	682885	684103	1218	renamed_GCF_000008685.2	chromosome	227827	226609	1218	100.0	6.126e-266
UCT31H	contig_1	684102	685887	1785	renamed_GCF_000008685.2	chromosome	226610	224825	1785	100.0	0.0
UCT31H	contig_1	685927	686749	822	renamed_GCF_000008685.2	chromosome	224785	223963	822	100.0	3.638e-179
UCT31H	contig_1	687534	686751	783	renamed_GCF_000008685.2	chromosome	223178	223961	783	100.0	3.455e-173
UCT31H	contig_1	689079	687534	1545	renamed_GCF_000008685.2	chromosome	221741	223178	1545	99.7	1.424e-311
UCT31H	contig_1	689984	689075	909	renamed_GCF_000008685.2	chromosome	220728	221637	909	100.0	9.393e-192
UCT31H	contig_1	690913	690073	840	renamed_GCF_000008685.2	chromosome	219799	220639	840	100.0	1.641e-182
UCT31H	contig_1	691078	691657	579	renamed_GCF_000008685.2	chromosome	219634	219055	579	100.0	8.388e-121
UCT31H	contig_1	691634	692288	654	renamed_GCF_000008685.2	chromosome	219078	218424	654	100.0	1.052e-147
UCT31H	contig_1	693432	692400	1032	renamed_GCF_000008685.2	chromosome	217277	218312	1032	100.0	9.666e-221
UCT31H	contig_1	695286	693453	1833	renamed_GCF_000008685.2	chromosome	215426	217259	1833	100.0	0.0
UCT31H	contig_1	709662	710748	1086	renamed_GCF_000008685.2	chromosome	201050	199964	1086	100.0	2.679e-244
UCT31H	contig_1	752655	752238	417	renamed_GCF_000008685.2	chromosome	158075	158474	417	100.0	2.72e-81
UCT31H	contig_1	753086	752651	435	renamed_GCF_000008685.2	chromosome	157626	158061	435	100.0	6.167e-92
UCT31H	contig_1	754251	753114	1137	renamed_GCF_000008685.2	chromosome	156461	157598	1137	100.0	1.164e-253
UCT31H	contig_1	754312	757012	2700	renamed_GCF_000008685.2	chromosome	156400	153700	2700	100.0	0.0
UCT31H	contig_1	757026	757638	612	renamed_GCF_000008685.2	chromosome	153686	153074	612	100.0	4.712e-141
UCT31H	contig_1	758507	757700	807	renamed_GCF_000008685.2	chromosome	152205	153012	807	100.0	9.769e-183
UCT31H	contig_1	759739	758533	1206	renamed_GCF_000008685.2	chromosome	150973	152179	1206	100.0	4.93e-275
UCT31H	contig_1	839512	838102	1410	renamed_GCF_000008685.2	chromosome	71200	72610	1410	100.0	2.56e-308
UCT31H	contig_1	840540	839493	1047	renamed_GCF_000008685.2	chromosome	70141	71219	1047	100.0	1.295e-228
UCT31H	contig_1	870887	870035	852	renamed_GCF_000008685.2	chromosome	39825	40677	852	100.0	1.031e-189
UCT31H	contig_1	871074	872577	1503	renamed_GCF_000008685.2	chromosome	39638	38135	1503	100.0	0.0
UCT31H	contig_1	874103	874856	753	renamed_GCF_000008685.2	chromosome	36609	35856	753	100.0	1.343e-161
UCT31H	contig_1	874876	876676	1800	renamed_GCF_000008685.2	chromosome	35836	34036	1800	100.0	0.0
UCT31H	contig_1	876675	878556	1881	renamed_GCF_000008685.2	chromosome	34037	32156	1881	100.0	0.0
UCT31H	contig_1	878623	879163	540	renamed_GCF_000008685.2	chromosome	32089	31549	540	100.0	3.274e-116
UCT31H	contig_1	879686	879233	453	renamed_GCF_000008685.2	chromosome	31026	31479	453	100.0	2.279e-97
UCT31H	contig_1	888611	889655	1044	renamed_GCF_000008685.2	chromosome	22101	21057	1044	100.0	6.693e-227
UCT31H	contig_1	900510	900135	375	renamed_GCF_000008685.2	chromosome	10202	10577	375	100.0	3.75e-79
UCT31H	contig_1	901511	900506	1005	renamed_GCF_000008685.2	chromosome	9201	10206	1005	100.0	1.697e-218
UCT31H	contig_1	902286	901515	771	renamed_GCF_000008685.2	chromosome	8426	9197	771	100.0	1.781e-161
UCT31H	contig_1	902397	903255	858	renamed_GCF_000008685.2	chromosome	8315	7457	858	100.0	6.472e-196
UCT31H	contig_1	903315	904404	1089	renamed_GCF_000008685.2	chromosome	7397	6308	1089	100.0	1.828e-240
UCT31H	contig_1	904406	905462	1056	renamed_GCF_000008685.2	chromosome	6306	5250	1056	99.7	7.804e-236
UCT31H	contig_1	907318	905524	1794	renamed_GCF_000008685.2	chromosome	3418	5188	1794	100.0	0.0
UCT31H	contig_2	7185	8220	1035	renamed_GCF_000008685.2	lp54	7208	8243	1035	100.0	8.138e-232
UCT31H	contig_2	8242	8422	180	renamed_GCF_000008685.2	lp54	8265	8445	180	100.0	1.452e-33
UCT31H	contig_2	27377	27986	609	renamed_GCF_000008685.2	lp54	27389	27998	609	100.0	2.346e-131
UCT31H	contig_2	28001	28919	918	renamed_GCF_000008685.2	lp54	28013	28931	918	100.0	2.109e-201
UCT31H	contig_2	28922	29375	453	renamed_GCF_000008685.2	lp54	28934	29387	453	100.0	2.51e-96
UCT31H	contig_2	29371	29746	375	renamed_GCF_000008685.2	lp54	29383	29758	375	100.0	1.685e-79
UCT31H	contig_2	30081	30621	540	renamed_GCF_000008685.2	lp54	30093	30633	540	100.0	4.969e-120
UCT31H	contig_2	30697	31768	1071	renamed_GCF_000008685.2	lp54	30709	31780	1071	100.0	2.191e-235
UCT31H	contig_2	50079	49836	243	renamed_GCF_000008685.2	lp54	50077	49852	243	98.6	5.904e-45
UCT31H	contig_3	24441	23115	1326	renamed_GCF_000008685.2	lp56	26920	28246	1326	100.0	3.211e-300
UCT31H	contig_3	26877	26121	756	renamed_GCF_000008685.2	lp56	24517	25273	756	100.0	1.063e-164
UCT31H	contig_3	27419	26852	567	renamed_GCF_000008685.2	lp56	23975	24542	567	100.0	1.456e-129
UCT31H	contig_3	28526	27428	1098	renamed_GCF_000008685.2	lp56	22868	23966	1098	100.0	9.161e-250
UCT31H	contig_3	28915	29863	948	renamed_GCF_000008685.2	lp56	22479	21531	948	100.0	7.628e-218
UCT31H	contig_3	30551	29939	612	renamed_GCF_000008685.2	lp56	20843	21455	612	100.0	1.152e-139
UCT31H	contig_3	37585	36901	684	renamed_GCF_000008685.2	lp56	13754	14438	684	100.0	3.113e-149
UCT31H	contig_3	38903	37607	1296	renamed_GCF_000008685.2	lp56	12436	13732	1296	99.0	2.805e-279
UCT31H	contig_3	45000	45537	537	renamed_GCF_000008685.2	lp56	6339	5802	537	100.0	1.599e-123
UCT31H	contig_3	45509	46271	762	renamed_GCF_000008685.2	lp56	5830	5068	762	100.0	1.784e-168
UCT31H	contig_3	46353	47091	738	renamed_GCF_000008685.2	lp56	4986	4248	738	100.0	1.779e-164
UCT31H	contig_3	47717	47231	486	renamed_GCF_000008685.2	lp56	3622	4108	486	100.0	4.376e-104
UCT31H	contig_3	48596	47843	753	renamed_GCF_000008685.2	lp56	2743	3496	753	100.0	1.868e-166
UCT31H	contig_4	173	1067	894	renamed_GCF_000008685.2	lp36	187	1081	894	100.0	7.433e-192
UCT31H	contig_4	14827	14287	540	renamed_GCF_000008685.2	lp36	14841	14301	540	100.0	2.234e-120
UCT31H	contig_4	15746	14819	927	renamed_GCF_000008685.2	lp36	15760	14833	927	100.0	2.815e-208
UCT31H	contig_10	19455	18888	567	renamed_GCF_000008685.2	cp32-1	28834	29401	567	94.1	1.228e-114
UCT31H	contig_10	21447	20355	1092	renamed_GCF_000008685.2	cp32-7	26892	27984	1092	65.8	3.036e-147
UCT31H	contig_11	749	1316	567	renamed_GCF_000008685.2	cp32-9	6169	6736	567	100.0	2.131e-125
UCT31H	contig_11	2424	2853	429	renamed_GCF_000008685.2	cp32-9	7844	8273	429	100.0	5.601e-92
UCT31H	contig_11	3321	3558	237	renamed_GCF_000008685.2	lp56	12192	12429	237	100.0	1.76e-48
UCT31H	contig_11	10434	10770	336	renamed_GCF_000008685.2	cp32-6	15774	16110	336	100.0	5.348e-69
UCT31H	contig_13	784	1897	1113	renamed_GCF_000008685.2	cp32-4	6710	7823	1113	100.0	1.393e-247
UCT31H	contig_13	10112	10466	354	renamed_GCF_000008685.2	cp32-4	16038	16392	354	100.0	6.554e-78
UCT31H	contig_14	1220	866	354	renamed_GCF_000008685.2	cp32-3	16083	16437	354	100.0	1.459e-77
UCT31H	contig_14	8580	8343	237	renamed_GCF_000008685.2	cp32-1	8723	8960	237	100.0	7.893e-49
UCT31H	contig_14	9476	9047	429	renamed_GCF_000008685.2	cp32-1	7827	8256	429	100.0	5.601e-92
UCT31H	contig_14	11536	11146	390	renamed_GCF_000008685.2	cp32-3	5767	6157	390	100.0	3.229e-83
UCT31H	contig_14	12362	11906	456	renamed_GCF_000008685.2	cp32-7	4940	5396	456	100.0	1.075e-97
UCT31H	contig_15	55	625	570	renamed_GCF_000008685.2	cp32-6	6160	6730	570	100.0	2.235e-125
UCT31H	contig_15	1732	2161	429	renamed_GCF_000008685.2	cp32-7	7829	8258	429	100.0	5.601e-92
UCT31H	contig_15	2628	2865	237	renamed_GCF_000008685.2	cp32-6	8733	8970	237	100.0	7.893e-49
UCT31H	contig_15	2872	4147	1275	renamed_GCF_000008685.2	cp32-6	8977	10252	1275	100.0	5.405e-277
UCT31H	contig_18	3473	2375	1098	renamed_GCF_000008685.2	cp26	4768	5866	1098	100.0	2.035e-249
UCT31H	contig_18	4158	3810	348	renamed_GCF_000008685.2	cp26	4083	4431	348	100.0	1.075e-71
UCT31H	contig_18	4443	5766	1323	renamed_GCF_000008685.2	cp26	3798	2475	1323	100.0	1.419e-291
UCT31H	contig_18	7490	7934	444	renamed_GCF_000008685.2	cp26	751	307	444	100.0	2.98e-101
UCT31H	contig_18	9915	8286	1629	renamed_GCF_000008685.2	cp26	24824	26453	1629	100.0	0.0
UCT31H	contig_18	24636	24087	549	renamed_GCF_000008685.2	cp26	10103	10652	549	100.0	6.94e-118
UCT31H	contig_19	1079	1946	867	renamed_GCF_000008685.2	lp28-4	25089	24222	867	100.0	1.188e-190
UCT31H	contig_19	3237	4074	837	renamed_GCF_000008685.2	lp28-4	22931	22094	837	100.0	1.426e-183
UCT31H	contig_1	35573	38120	2547	renamed_GCF_000008685.2	chromosome	875132	872585	2547	100.0	0.0
UCT31H	contig_1	38122	40594	2472	renamed_GCF_000008685.2	chromosome	872583	870111	2472	100.0	0.0
UCT31H	contig_1	62169	61902	267	renamed_GCF_000008685.2	chromosome	848537	848804	267	100.0	3.495e-54
UCT31H	contig_1	63216	62367	849	renamed_GCF_000008685.2	chromosome	847490	848339	849	100.0	6.426e-186
UCT31H	contig_1	63581	63218	363	renamed_GCF_000008685.2	chromosome	847125	847488	363	100.0	2.269e-74
UCT31H	contig_1	66253	63604	2649	renamed_GCF_000008685.2	chromosome	844453	847102	2649	100.0	0.0
UCT31H	contig_1	68155	67717	438	renamed_GCF_000008685.2	chromosome	842500	842989	438	99.3	1.307e-92
UCT31H	contig_1	71463	68874	2589	renamed_GCF_000008685.2	chromosome	839243	841832	2589	100.0	0.0
UCT31H	contig_1	72160	71626	534	renamed_GCF_000008685.2	chromosome	838546	839080	534	100.0	7.282e-115
UCT31H	contig_1	88363	88012	351	renamed_GCF_000008685.2	chromosome	822343	822694	351	100.0	6.889e-77
UCT31H	contig_1	118366	117091	1275	renamed_GCF_000008685.2	chromosome	792350	793625	1275	100.0	1.279e-284
UCT31H	contig_1	118929	119910	981	renamed_GCF_000008685.2	chromosome	791787	790806	981	100.0	5.759e-218
UCT31H	contig_1	119909	120770	861	renamed_GCF_000008685.2	chromosome	790807	789946	861	100.0	1.57e-186
UCT31H	contig_1	121414	120778	636	renamed_GCF_000008685.2	chromosome	789302	789938	636	100.0	6.275e-142
UCT31H	contig_1	150515	149069	1446	renamed_GCF_000008685.2	chromosome	760225	761647	1446	99.7	9.686e-317
UCT31H	contig_1	156167	154367	1800	renamed_GCF_000008685.2	chromosome	754636	756349	1800	100.0	0.0
UCT31H	contig_1	157494	156648	846	renamed_GCF_000008685.2	chromosome	753291	754068	846	100.0	1.342e-168
UCT31H	contig_1	159526	158557	969	renamed_GCF_000008685.2	chromosome	751190	752159	969	100.0	4.772e-218
UCT31H	contig_1	191891	189629	2262	renamed_GCF_000008685.2	chromosome	718826	721088	2262	100.0	0.0
UCT31H	contig_1	205137	204111	1026	renamed_GCF_000008685.2	chromosome	705579	706605	1026	100.0	2.737e-225
UCT31H	contig_1	206786	205757	1029	renamed_GCF_000008685.2	chromosome	703960	704959	1029	99.6	3.451e-223
UCT31H	contig_1	207750	208434	684	renamed_GCF_000008685.2	chromosome	702951	702282	684	100.0	4.537e-145
UCT31H	contig_1	209322	208911	411	renamed_GCF_000008685.2	chromosome	701394	701805	411	100.0	2.78e-88
UCT31H	contig_1	209792	210665	873	renamed_GCF_000008685.2	chromosome	700924	700051	873	100.0	5.874e-191
UCT31H	contig_1	224736	225720	984	renamed_GCF_000008685.2	chromosome	685980	684996	984	100.0	1.708e-223
UCT31H	contig_1	227294	225749	1545	renamed_GCF_000008685.2	chromosome	683422	684967	1545	100.0	0.0
UCT31H	contig_1	229110	230154	1044	renamed_GCF_000008685.2	chromosome	681606	680562	1044	100.0	8.539e-233
UCT31H	contig_1	285708	284454	1254	renamed_GCF_000008685.2	chromosome	625006	626260	1254	100.0	1.925e-276
UCT31H	contig_1	288710	287267	1443	renamed_GCF_000008685.2	chromosome	622004	623447	1443	100.0	0.0
UCT31H	contig_1	305945	306989	1044	renamed_GCF_000008685.2	chromosome	604769	603725	1044	100.0	3.194e-235
UCT31H	contig_1	309705	308370	1335	renamed_GCF_000008685.2	chromosome	601009	602344	1335	100.0	3.161e-293
UCT31H	contig_1	311338	312127	789	renamed_GCF_000008685.2	chromosome	599376	598587	789	100.0	1.07e-178
UCT31H	contig_1	314772	314193	579	renamed_GCF_000008685.2	chromosome	595942	596521	579	100.0	3.772e-121
UCT31H	contig_1	319527	318357	1170	renamed_GCF_000008685.2	chromosome	591187	592357	1170	100.0	9.606e-253
UCT31H	contig_1	332438	330293	2145	renamed_GCF_000008685.2	chromosome	578276	580421	2145	100.0	0.0
UCT31H	contig_1	333320	332777	543	renamed_GCF_000008685.2	chromosome	577394	577937	543	100.0	3.121e-117
UCT31H	contig_1	334188	334734	546	renamed_GCF_000008685.2	chromosome	576499	575980	546	100.0	1.781e-115
UCT31H	contig_1	373194	372405	789	renamed_GCF_000008685.2	chromosome	537543	538308	789	99.6	2.994e-167
UCT31H	contig_1	397484	396182	1302	renamed_GCF_000008685.2	chromosome	513225	514527	1302	100.0	1.62e-286
UCT31H	contig_1	397570	398317	747	renamed_GCF_000008685.2	chromosome	513139	512392	747	100.0	7.284e-159
UCT31H	contig_1	399874	399085	789	renamed_GCF_000008685.2	chromosome	510835	511624	789	100.0	3.149e-175
UCT31H	contig_1	401396	399863	1533	renamed_GCF_000008685.2	chromosome	509313	510846	1533	100.0	0.0
UCT31H	contig_1	407344	406801	543	renamed_GCF_000008685.2	chromosome	503365	503908	543	100.0	7.636e-116
UCT31H	contig_1	411654	411375	279	renamed_GCF_000008685.2	chromosome	499055	499334	279	100.0	1.411e-57
UCT31H	contig_1	412497	411663	834	renamed_GCF_000008685.2	chromosome	498212	499046	834	100.0	1.895e-188
UCT31H	contig_1	412815	412518	297	renamed_GCF_000008685.2	chromosome	497894	498191	297	100.0	5.69e-62
UCT31H	contig_1	413465	412835	630	renamed_GCF_000008685.2	chromosome	497244	497874	630	100.0	4.528e-136
UCT31H	contig_1	414095	413474	621	renamed_GCF_000008685.2	chromosome	496614	497235	621	100.0	8.732e-136
UCT31H	contig_1	414442	414130	312	renamed_GCF_000008685.2	chromosome	496267	496579	312	100.0	2.953e-63
UCT31H	contig_1	415677	414492	1185	renamed_GCF_000008685.2	chromosome	495032	496217	1185	100.0	4.832e-263
UCT31H	contig_1	416167	416560	393	renamed_GCF_000008685.2	chromosome	494539	494149	393	100.0	4.545e-80
UCT31H	contig_1	418122	416757	1365	renamed_GCF_000008685.2	chromosome	492587	493952	1365	100.0	1.721e-296
UCT31H	contig_1	438234	438939	705	renamed_GCF_000008685.2	chromosome	472358	471770	705	99.4	1.099e-121
UCT31H	contig_1	462005	461399	606	renamed_GCF_000008685.2	chromosome	448707	449310	606	100.0	1.106e-130
UCT31H	contig_1	462118	462508	390	renamed_GCF_000008685.2	chromosome	448591	448201	390	100.0	7.926e-82
UCT31H	contig_1	462855	462537	318	renamed_GCF_000008685.2	chromosome	447854	448172	318	100.0	8.883e-69
UCT31H	contig_1	462949	463741	792	renamed_GCF_000008685.2	chromosome	447736	446968	792	99.6	3.782e-165
UCT31H	contig_1	463834	464383	549	renamed_GCF_000008685.2	chromosome	446875	446326	549	100.0	4.738e-122
UCT31H	contig_1	467461	468022	561	renamed_GCF_000008685.2	chromosome	443248	442687	561	100.0	1.054e-123
UCT31H	contig_1	468157	468997	840	renamed_GCF_000008685.2	chromosome	442552	441712	840	100.0	1.361e-184
UCT31H	contig_1	475606	480091	4485	renamed_GCF_000008685.2	chromosome	435103	430618	4485	100.0	0.0
UCT31H	contig_1	480093	481017	924	renamed_GCF_000008685.2	chromosome	430616	429692	924	100.0	4.275e-203
UCT31H	contig_1	482064	481035	1029	renamed_GCF_000008685.2	chromosome	428645	429674	1029	100.0	3.872e-239
UCT31H	contig_1	482723	482087	636	renamed_GCF_000008685.2	chromosome	427986	428622	636	100.0	3.41e-140
UCT31H	contig_1	483974	482759	1215	renamed_GCF_000008685.2	chromosome	426735	427950	1215	100.0	1.711e-262
UCT31H	contig_1	485126	483998	1128	renamed_GCF_000008685.2	chromosome	425583	426711	1128	100.0	1.044e-244
UCT31H	contig_1	486016	485158	858	renamed_GCF_000008685.2	chromosome	424693	425551	858	100.0	1.579e-194
UCT31H	contig_1	486263	486887	624	renamed_GCF_000008685.2	chromosome	424442	423821	624	100.0	2.036e-135
UCT31H	contig_1	487654	486874	780	renamed_GCF_000008685.2	chromosome	423054	423834	780	100.0	3.296e-173
UCT31H	contig_1	489158	488528	630	renamed_GCF_000008685.2	chromosome	421553	422183	630	100.0	5.705e-142
UCT31H	contig_1	513235	513610	375	renamed_GCF_000008685.2	chromosome	397476	397101	375	100.0	1.385e-81
UCT31H	contig_1	524553	523374	1179	renamed_GCF_000008685.2	chromosome	386158	387337	1179	100.0	1.981e-263
UCT31H	contig_1	525263	524549	714	renamed_GCF_000008685.2	chromosome	385448	386162	714	100.0	3.427e-153
UCT31H	contig_1	526425	525285	1140	renamed_GCF_000008685.2	chromosome	384286	385426	1140	100.0	7.242e-251
UCT31H	contig_1	526549	527317	768	renamed_GCF_000008685.2	chromosome	384162	383394	768	100.0	1.961e-168
UCT31H	contig_1	527329	528802	1473	renamed_GCF_000008685.2	chromosome	383382	381909	1473	100.0	0.0
UCT31H	contig_1	528819	530157	1338	renamed_GCF_000008685.2	chromosome	381892	380554	1338	99.7	6.95e-311
UCT31H	contig_1	530153	531371	1218	renamed_GCF_000008685.2	chromosome	380558	379340	1218	100.0	1.741e-271
UCT31H	contig_1	531381	533673	2292	renamed_GCF_000008685.2	chromosome	379258	377038	2292	99.8	0.0
UCT31H	contig_1	533692	534751	1059	renamed_GCF_000008685.2	chromosome	377019	375960	1059	100.0	5.328e-232
UCT31H	contig_1	581450	581090	360	renamed_GCF_000008685.2	chromosome	329261	329621	360	100.0	1.609e-77
UCT31H	contig_1	582680	581546	1134	renamed_GCF_000008685.2	chromosome	328031	329165	1134	100.0	5.485e-253
UCT31H	contig_1	582984	584013	1029	renamed_GCF_000008685.2	chromosome	327757	326698	1029	99.7	7.409e-232
UCT31H	contig_1	584423	585476	1053	renamed_GCF_000008685.2	chromosome	326288	325235	1053	100.0	4.032e-234
UCT31H	contig_1	585475	586936	1461	renamed_GCF_000008685.2	chromosome	325236	323775	1461	100.0	0.0
UCT31H	contig_1	586932	587865	933	renamed_GCF_000008685.2	chromosome	323779	322846	933	100.0	1.839e-205
UCT31H	contig_1	587865	588672	807	renamed_GCF_000008685.2	chromosome	322846	322039	807	99.6	2.064e-174
UCT31H	contig_1	589360	588673	687	renamed_GCF_000008685.2	chromosome	321351	322038	687	100.0	1.336e-150
UCT31H	contig_1	590403	589359	1044	renamed_GCF_000008685.2	chromosome	320308	321352	1044	100.0	3.013e-227
UCT31H	contig_1	607876	608209	333	renamed_GCF_000008685.2	chromosome	302839	302503	333	99.0	1.253e-67
UCT31H	contig_1	617504	618287	783	renamed_GCF_000008685.2	chromosome	293208	292425	783	100.0	6.057e-167
UCT31H	contig_1	618286	619069	783	renamed_GCF_000008685.2	chromosome	292426	291643	783	100.0	1.874e-171
UCT31H	contig_1	619117	619654	537	renamed_GCF_000008685.2	chromosome	291595	291058	537	100.0	7.638e-115
UCT31H	contig_1	619691	620750	1059	renamed_GCF_000008685.2	chromosome	291021	289962	1059	100.0	3.164e-229
UCT31H	contig_1	620795	621137	342	renamed_GCF_000008685.2	chromosome	289917	289575	342	100.0	1.077e-70
UCT31H	contig_1	621129	621756	627	renamed_GCF_000008685.2	chromosome	289583	288956	627	100.0	2.836e-132
UCT31H	contig_1	621766	622531	765	renamed_GCF_000008685.2	chromosome	288946	288181	765	100.0	2.478e-165
UCT31H	contig_1	622539	622803	264	renamed_GCF_000008685.2	chromosome	288173	287909	264	100.0	2.025e-51
UCT31H	contig_1	622835	623624	789	renamed_GCF_000008685.2	chromosome	287877	287088	789	100.0	1.783e-164
UCT31H	contig_1	664923	664158	765	renamed_GCF_000008685.2	chromosome	245789	246554	765	100.0	7.663e-170
UCT31H	contig_1	665333	665936	603	renamed_GCF_000008685.2	chromosome	245382	244776	603	99.5	7.936e-134
UCT31H	contig_1	665999	666770	771	renamed_GCF_000008685.2	chromosome	244713	243942	771	100.0	4.161e-169
UCT31H	contig_1	668275	666709	1566	renamed_GCF_000008685.2	chromosome	242437	244003	1566	100.0	0.0
UCT31H	contig_1	668423	670430	2007	renamed_GCF_000008685.2	chromosome	242289	240282	2007	100.0	0.0
UCT31H	contig_1	670462	671569	1107	renamed_GCF_000008685.2	chromosome	240250	239143	1107	100.0	3.718e-244
UCT31H	contig_1	671584	672412	828	renamed_GCF_000008685.2	chromosome	239128	238300	828	100.0	9.354e-187
UCT31H	contig_1	672486	672744	258	renamed_GCF_000008685.2	chromosome	238226	237968	258	100.0	9.113e-51
UCT31H	contig_1	672756	673083	327	renamed_GCF_000008685.2	chromosome	237956	237629	327	100.0	8.435e-71
UCT31H	contig_1	708134	709661	1527	renamed_GCF_000008685.2	chromosome	202578	201051	1527	100.0	0.0
UCT31H	contig_1	721436	721637	201	renamed_GCF_000008685.2	chromosome	189276	189075	201	100.0	9.889e-41
UCT31H	contig_1	722218	722479	261	renamed_GCF_000008685.2	chromosome	188494	188233	261	100.0	7.054e-54
UCT31H	contig_1	722475	722889	414	renamed_GCF_000008685.2	chromosome	188237	187823	414	100.0	2.918e-88
UCT31H	contig_1	722881	723535	654	renamed_GCF_000008685.2	chromosome	187831	187177	654	100.0	1.397e-144
UCT31H	contig_1	723764	723518	246	renamed_GCF_000008685.2	chromosome	186948	187194	246	100.0	9.168e-49
UCT31H	contig_1	724159	723766	393	renamed_GCF_000008685.2	chromosome	186553	186946	393	100.0	5.626e-86
UCT31H	contig_1	750623	749504	1119	renamed_GCF_000008685.2	chromosome	160089	161208	1119	100.0	2.349e-251
UCT31H	contig_1	762053	763064	1011	renamed_GCF_000008685.2	chromosome	148659	147648	1011	100.0	5.463e-215
UCT31H	contig_1	763217	764336	1119	renamed_GCF_000008685.2	chromosome	147495	146376	1119	100.0	3.727e-246
UCT31H	contig_1	764342	765242	900	renamed_GCF_000008685.2	chromosome	146370	145470	900	100.0	6.779e-194
UCT31H	contig_1	765254	766127	873	renamed_GCF_000008685.2	chromosome	145458	144585	873	100.0	2.787e-199
UCT31H	contig_1	766446	767769	1323	renamed_GCF_000008685.2	chromosome	144230	142943	1323	99.7	1.75e-280
UCT31H	contig_1	767780	768734	954	renamed_GCF_000008685.2	chromosome	142932	141978	954	100.0	1.517e-202
UCT31H	contig_1	771969	772281	312	renamed_GCF_000008685.2	chromosome	138745	138433	312	100.0	1.981e-67
UCT31H	contig_1	786568	788224	1656	renamed_GCF_000008685.2	chromosome	124146	122490	1656	100.0	0.0
UCT31H	contig_1	788223	788835	612	renamed_GCF_000008685.2	chromosome	122491	121879	612	100.0	3.269e-128
UCT31H	contig_1	788891	789614	723	renamed_GCF_000008685.2	chromosome	121823	121100	723	100.0	1.695e-162
UCT31H	contig_1	789632	789911	279	renamed_GCF_000008685.2	chromosome	121082	120803	279	100.0	1.411e-57
UCT31H	contig_1	790125	790908	783	renamed_GCF_000008685.2	chromosome	120589	119806	783	100.0	5.024e-169
UCT31H	contig_1	790911	791751	840	renamed_GCF_000008685.2	chromosome	119803	118963	840	100.0	4.393e-180
UCT31H	contig_1	791785	792340	555	renamed_GCF_000008685.2	chromosome	118929	118374	555	100.0	1.543e-118
UCT31H	contig_1	792344	793037	693	renamed_GCF_000008685.2	chromosome	118370	117677	693	100.0	4.532e-155
UCT31H	contig_1	793908	795210	1302	renamed_GCF_000008685.2	chromosome	116806	115504	1302	100.0	1.776e-285
UCT31H	contig_1	804859	805297	438	renamed_GCF_000008685.2	chromosome	105846	105417	438	100.0	3.53e-90
UCT31H	contig_1	805283	806951	1668	renamed_GCF_000008685.2	chromosome	105299	103763	1668	100.0	0.0
UCT31H	contig_1	806943	807699	756	renamed_GCF_000008685.2	chromosome	103771	103015	756	100.0	4.353e-166
UCT31H	contig_1	807765	809190	1425	renamed_GCF_000008685.2	chromosome	102949	101524	1425	100.0	1.009e-312
UCT31H	contig_1	809375	809969	594	renamed_GCF_000008685.2	chromosome	101339	100745	594	100.0	6.255e-135
UCT31H	contig_1	810487	809965	522	renamed_GCF_000008685.2	chromosome	100227	100749	522	100.0	2.976e-114
UCT31H	contig_1	811898	810509	1389	renamed_GCF_000008685.2	chromosome	98816	100205	1389	100.0	9.726e-316
UCT31H	contig_1	811933	812851	918	renamed_GCF_000008685.2	chromosome	98648	97862	918	100.0	2.136e-175
UCT31H	contig_1	812847	813771	924	renamed_GCF_000008685.2	chromosome	97866	96942	924	100.0	7.888e-205
UCT31H	contig_1	813760	816103	2343	renamed_GCF_000008685.2	chromosome	96953	94610	2343	100.0	0.0
UCT31H	contig_1	838066	837220	846	renamed_GCF_000008685.2	chromosome	72646	73492	846	100.0	5.813e-178
UCT31H	contig_1	850179	850677	498	renamed_GCF_000008685.2	chromosome	60533	60035	498	100.0	3.278e-109
UCT31H	contig_1	850673	851612	939	renamed_GCF_000008685.2	chromosome	60039	59100	939	100.0	4.091e-206
UCT31H	contig_1	851676	852684	1008	renamed_GCF_000008685.2	chromosome	58982	58028	1008	100.0	2.425e-206
UCT31H	contig_1	853454	852737	717	renamed_GCF_000008685.2	chromosome	57258	57975	717	100.0	1.471e-154
UCT31H	contig_1	853527	853881	354	renamed_GCF_000008685.2	chromosome	57185	56831	354	100.0	1.322e-78
UCT31H	contig_1	853964	854432	468	renamed_GCF_000008685.2	chromosome	56748	56280	468	100.0	3.979e-102
UCT31H	contig_1	854432	855212	780	renamed_GCF_000008685.2	chromosome	56280	55500	780	99.6	1.628e-172
UCT31H	contig_1	855208	857179	1971	renamed_GCF_000008685.2	chromosome	55504	53533	1971	100.0	0.0
UCT31H	contig_1	857251	858259	1008	renamed_GCF_000008685.2	chromosome	53461	52453	1008	100.0	6.65e-221
UCT31H	contig_1	867831	868233	402	renamed_GCF_000008685.2	chromosome	42881	42479	402	100.0	2.405e-88
UCT31H	contig_1	881170	879697	1473	renamed_GCF_000008685.2	chromosome	29542	31015	1473	99.7	0.0
UCT31H	contig_1	881240	882221	981	renamed_GCF_000008685.2	chromosome	29472	28491	981	100.0	8.047e-223
UCT31H	contig_1	882222	882858	636	renamed_GCF_000008685.2	chromosome	28490	27854	636	100.0	8.334e-139
UCT31H	contig_1	882847	883279	432	renamed_GCF_000008685.2	chromosome	27865	27433	432	100.0	2.641e-92
UCT31H	contig_1	884314	883264	1050	renamed_GCF_000008685.2	chromosome	26398	27448	1050	100.0	7.794e-235
UCT31H	contig_1	885089	886016	927	renamed_GCF_000008685.2	chromosome	25623	24696	927	100.0	1.199e-200
UCT31H	contig_1	886016	886748	732	renamed_GCF_000008685.2	chromosome	24696	23964	732	100.0	2.844e-158
UCT31H	contig_1	887894	886754	1140	renamed_GCF_000008685.2	chromosome	22818	23958	1140	100.0	2.624e-262
UCT31H	contig_1	908917	909946	1029	renamed_GCF_000008685.2	chromosome	1796	767	1029	100.0	4.829e-228
UCT31H	contig_2	31767	32190	423	renamed_GCF_000008685.2	lp54	31779	32202	423	100.0	5.086e-92
UCT31H	contig_2	32729	32948	219	renamed_GCF_000008685.2	lp54	32741	32960	219	100.0	7.958e-46
UCT31H	contig_2	34975	35821	846	renamed_GCF_000008685.2	lp54	34987	35833	846	100.0	5.585e-187
UCT31H	contig_2	36255	36522	267	renamed_GCF_000008685.2	lp54	36255	36534	267	98.8	1.568e-54
UCT31H	contig_2	40102	39862	240	renamed_GCF_000008685.2	lp54	40112	39872	240	100.0	3.722e-49
UCT31H	contig_2	41035	40201	834	renamed_GCF_000008685.2	lp54	41045	40211	834	98.9	1.8e-180
UCT31H	contig_2	42256	42463	207	renamed_GCF_000008685.2	lp54	42266	42473	207	100.0	9.856e-42
UCT31H	contig_2	43522	42613	909	renamed_GCF_000008685.2	lp54	43532	42623	909	100.0	1.089e-198
UCT31H	contig_2	45931	44701	1230	renamed_GCF_000008685.2	lp54	45947	44711	1230	98.7	1.97e-263
UCT31H	contig_3	36898	35947	951	renamed_GCF_000008685.2	lp56	14441	15392	951	100.0	2.14e-215
UCT31H	contig_4	6360	6636	276	renamed_GCF_000008685.2	lp36	6365	6650	276	100.0	1.214e-58
UCT31H	contig_4	8845	8149	696	renamed_GCF_000008685.2	lp36	8859	8163	696	100.0	1.275e-152
UCT31H	contig_4	10286	11933	1647	renamed_GCF_000008685.2	lp36	10300	11947	1647	100.0	0.0
UCT31H	contig_4	14312	13562	750	renamed_GCF_000008685.2	lp36	14326	13576	750	100.0	1.062e-163
UCT31H	contig_4	24278	24656	378	renamed_GCF_000008685.2	lp38	23365	24088	378	39.2	3.947e-22
UCT31H	contig_4	26344	25798	546	renamed_GCF_000008685.2	lp36	26358	25812	546	100.0	8.009e-116
UCT31H	contig_5	28490	27491	999	renamed_GCF_000008685.2	lp28-1	466	1465	999	100.0	6.954e-219
UCT31H	contig_6	21995	20921	1074	renamed_GCF_000008685.2	lp25	14530	13402	1074	99.7	2.22e-244
UCT31H	contig_6	30201	29469	732	renamed_GCF_000008685.2	lp25	22677	21945	732	100.0	5.239e-160
UCT31H	contig_8	3519	3063	456	renamed_GCF_000008685.2	cp32-8	8271	8727	456	100.0	1.971e-99
UCT31H	contig_8	3963	3534	429	renamed_GCF_000008685.2	cp32-8	7827	8256	429	100.0	5.601e-92
UCT31H	contig_8	15747	14610	1137	renamed_GCF_000008685.2	cp32-1	26795	27932	1137	100.0	3.741e-249
UCT31H	contig_8	20412	19779	633	renamed_GCF_000008685.2	cp32-1	22130	22763	633	100.0	1.275e-133
UCT31H	contig_8	21777	21036	741	renamed_GCF_000008685.2	cp32-1	20765	21506	741	100.0	1.112e-161
UCT31H	contig_8	29712	28836	876	renamed_GCF_000008685.2	cp32-8	12823	13699	876	100.0	1.247e-191
UCT31H	contig_9	3275	2138	1137	renamed_GCF_000008685.2	cp32-8	26930	28067	1137	100.0	3.741e-249
UCT31H	contig_10	2132	1784	348	renamed_GCF_000008685.2	cp32-4	15373	15721	348	100.0	3.962e-74
UCT31H	contig_11	3565	4840	1275	renamed_GCF_000008685.2	cp32-9	8985	10260	1275	100.0	5.405e-277
UCT31H	contig_14	4480	3604	876	renamed_GCF_000008685.2	cp32-3	12823	13699	876	100.0	5.609e-192
UCT31H	contig_14	5384	4838	546	renamed_GCF_000008685.2	cp32-3	11919	12465	546	100.0	7.28e-117
UCT31H	contig_14	6352	5401	951	renamed_GCF_000008685.2	cp32-3	10951	11902	951	100.0	4.333e-216
UCT31H	contig_14	17238	16014	1224	renamed_GCF_000008685.2	cp32-3	65	1289	1224	100.0	2.096e-270
UCT31H	contig_14	19291	18652	639	renamed_GCF_000008685.2	cp32-3	28235	28874	639	100.0	1.943e-138
UCT31H	contig_14	20117	19607	510	renamed_GCF_000008685.2	cp32-3	27409	27919	510	100.0	3.969e-109
UCT31H	contig_15	20321	21080	759	renamed_GCF_000008685.2	cp32-6	26256	27015	759	100.0	2.986e-162
UCT31H	contig_16	196	1090	894	renamed_GCF_000008685.2	lp28-2	115	1009	894	100.0	3.048e-193
UCT31H	contig_16	5991	6759	768	renamed_GCF_000008685.2	lp28-2	5910	6678	768	100.0	2.365e-166
UCT31H	contig_16	12400	11581	819	renamed_GCF_000008685.2	lp28-2	12319	11500	819	100.0	1.075e-183
UCT31H	contig_16	13222	12829	393	renamed_GCF_000008685.2	lp28-2	13141	12748	393	100.0	6.841e-84
UCT31H	contig_16	14422	13588	834	renamed_GCF_000008685.2	lp28-2	14341	13507	834	100.0	1.239e-184
UCT31H	contig_16	15512	14966	546	renamed_GCF_000008685.2	lp28-2	15431	14885	546	100.0	8.811e-115
UCT31H	contig_21	3701	3173	528	renamed_GCF_000008685.2	cp9	6808	6280	528	100.0	2.158e-110