QUERY_ID	QUERY_NAME	QUERY_START	QUERY_END	QUERY_LENGTH	REF_ID	REF_NAME	REF_START	REF_END	REF_LENGTH	IDENTITY	EVALUE
B331P	contig_1	33916	32035	1881	renamed_GCF_000008685.2	chromosome	34037	32156	1881	99.5	0.0
B331P	contig_1	36488	35735	753	renamed_GCF_000008685.2	chromosome	36609	35856	753	97.2	1.779e-158
B331P	contig_1	39703	40555	852	renamed_GCF_000008685.2	chromosome	39825	40677	852	99.2	2.515e-188
B331P	contig_1	50350	49987	363	renamed_GCF_000008685.2	chromosome	50474	50111	363	100.0	4.578e-75
B331P	contig_1	52310	51128	1182	renamed_GCF_000008685.2	chromosome	52434	51252	1182	99.7	3.289e-258
B331P	contig_1	55380	53409	1971	renamed_GCF_000008685.2	chromosome	55504	53533	1971	99.8	0.0
B331P	contig_1	56624	56156	468	renamed_GCF_000008685.2	chromosome	56748	56280	468	98.0	4.825e-100
B331P	contig_1	57134	57851	717	renamed_GCF_000008685.2	chromosome	57258	57975	717	98.7	3.592e-153
B331P	contig_1	70287	71097	810	renamed_GCF_000008685.2	chromosome	70141	71219	810	99.6	2.744e-180
B331P	contig_1	72524	73370	846	renamed_GCF_000008685.2	chromosome	72646	73492	846	99.6	2.871e-177
B331P	contig_1	76327	77578	1251	renamed_GCF_000008685.2	chromosome	76450	77701	1251	98.7	4.601e-266
B331P	contig_1	79229	78878	351	renamed_GCF_000008685.2	chromosome	79322	79001	351	100.0	3.732e-67
B331P	contig_1	103648	102892	756	renamed_GCF_000008685.2	chromosome	103771	103015	756	99.6	2.151e-165
B331P	contig_1	105723	105294	429	renamed_GCF_000008685.2	chromosome	105846	105417	429	99.2	1.514e-89
B331P	contig_1	108047	106850	1197	renamed_GCF_000008685.2	chromosome	108170	106973	1197	99.7	1.869e-258
B331P	contig_1	110919	109551	1368	renamed_GCF_000008685.2	chromosome	111042	109674	1368	100.0	1.976e-295
B331P	contig_1	111751	111460	291	renamed_GCF_000008685.2	chromosome	111875	111584	291	100.0	1.894e-64
B331P	contig_1	112645	112225	420	renamed_GCF_000008685.2	chromosome	112769	112349	420	97.8	3.541e-87
B331P	contig_1	114683	115385	702	renamed_GCF_000008685.2	chromosome	114806	115508	702	96.9	1.54e-151
B331P	contig_1	217339	218371	1032	renamed_GCF_000008685.2	chromosome	217277	218312	1032	99.4	4.772e-220
B331P	contig_1	219693	219114	579	renamed_GCF_000008685.2	chromosome	219634	219055	579	100.0	8.388e-121
B331P	contig_1	220787	221696	909	renamed_GCF_000008685.2	chromosome	220728	221637	909	99.3	4.638e-191
B331P	contig_1	223237	224020	783	renamed_GCF_000008685.2	chromosome	223178	223961	783	99.2	8.433e-172
B331P	contig_1	237201	235653	1548	renamed_GCF_000008685.2	chromosome	237142	235594	1548	99.8	0.0
B331P	contig_1	238015	237688	327	renamed_GCF_000008685.2	chromosome	237956	237629	327	100.0	8.435e-71
B331P	contig_1	239187	238359	828	renamed_GCF_000008685.2	chromosome	239128	238300	828	99.6	2.079e-186
B331P	contig_1	242348	240341	2007	renamed_GCF_000008685.2	chromosome	242289	240282	2007	99.7	0.0
B331P	contig_1	244772	244001	771	renamed_GCF_000008685.2	chromosome	244713	243942	771	100.0	4.161e-169
B331P	contig_1	256520	259043	2523	renamed_GCF_000008685.2	chromosome	256462	258985	2523	99.0	0.0
B331P	contig_1	630723	629220	1503	renamed_GCF_000008685.2	chromosome	630698	629195	1503	99.8	5e-324
B331P	contig_1	630793	632011	1218	renamed_GCF_000008685.2	chromosome	630795	631986	1218	99.4	4.366e-261
B331P	contig_1	644796	645165	369	renamed_GCF_000008685.2	chromosome	644771	645140	369	100.0	1.529e-79
B331P	contig_1	645626	645161	465	renamed_GCF_000008685.2	chromosome	645601	645136	465	99.3	2.067e-100
B331P	contig_1	645743	646706	963	renamed_GCF_000008685.2	chromosome	645718	646681	963	100.0	1.162e-215
B331P	contig_1	648351	646683	1668	renamed_GCF_000008685.2	chromosome	648254	646658	1668	99.4	0.0
B331P	contig_1	648577	649132	555	renamed_GCF_000008685.2	chromosome	648552	649107	555	98.9	3.432e-118
B331P	contig_1	650405	649187	1218	renamed_GCF_000008685.2	chromosome	650387	649169	1218	99.0	7.362e-264
B331P	contig_1	653808	650430	3378	renamed_GCF_000008685.2	chromosome	653790	650412	3378	99.2	0.0
B331P	contig_1	653904	654867	963	renamed_GCF_000008685.2	chromosome	653886	654849	963	100.0	5.23e-216
B331P	contig_1	654826	656920	2094	renamed_GCF_000008685.2	chromosome	654862	656902	2094	99.4	0.0
B331P	contig_1	676487	677876	1389	renamed_GCF_000008685.2	chromosome	676471	677860	1389	100.0	1.442e-302
B331P	contig_1	678954	677907	1047	renamed_GCF_000008685.2	chromosome	678938	677891	1047	98.8	3.051e-236
B331P	contig_1	679765	678973	792	renamed_GCF_000008685.2	chromosome	679750	678958	792	98.8	1.702e-165
B331P	contig_1	680578	679768	810	renamed_GCF_000008685.2	chromosome	680557	679753	810	99.2	5.794e-172
B331P	contig_1	681621	680577	1044	renamed_GCF_000008685.2	chromosome	681606	680562	1044	100.0	8.539e-233
B331P	contig_1	682539	681699	840	renamed_GCF_000008685.2	chromosome	682524	681684	840	100.0	1.641e-182
B331P	contig_1	682616	683390	774	renamed_GCF_000008685.2	chromosome	682678	683377	774	99.5	9.609e-152
B331P	contig_1	683435	684980	1545	renamed_GCF_000008685.2	chromosome	683422	684967	1545	99.8	0.0
B331P	contig_1	685993	685009	984	renamed_GCF_000008685.2	chromosome	685980	684996	984	100.0	1.708e-223
B331P	contig_1	686520	685989	531	renamed_GCF_000008685.2	chromosome	686507	685976	531	100.0	1.053e-118
B331P	contig_1	697599	698346	747	renamed_GCF_000008685.2	chromosome	697585	698332	747	99.5	7.646e-167
B331P	contig_1	699979	698413	1566	renamed_GCF_000008685.2	chromosome	699965	698399	1566	99.2	0.0
B331P	contig_1	700934	700061	873	renamed_GCF_000008685.2	chromosome	700924	700051	873	99.3	1.433e-189
B331P	contig_1	701038	701395	357	renamed_GCF_000008685.2	chromosome	701028	701385	357	99.1	2.301e-81
B331P	contig_1	701404	701815	411	renamed_GCF_000008685.2	chromosome	701394	701805	411	98.5	1.377e-87
B331P	contig_1	701834	702284	450	renamed_GCF_000008685.2	chromosome	701824	702274	450	99.3	2.172e-97
B331P	contig_1	702976	702292	684	renamed_GCF_000008685.2	chromosome	702951	702282	684	100.0	4.537e-145
B331P	contig_1	703018	703978	960	renamed_GCF_000008685.2	chromosome	703008	703968	960	99.3	2.967e-213
B331P	contig_1	703940	704969	1029	renamed_GCF_000008685.2	chromosome	703960	704959	1029	98.7	4.152e-221
B331P	contig_1	704958	705510	552	renamed_GCF_000008685.2	chromosome	704948	705500	552	100.0	2.458e-121
B331P	contig_1	716627	717779	1152	renamed_GCF_000008685.2	chromosome	716619	717771	1152	100.0	1.261e-246
B331P	contig_1	717750	718677	927	renamed_GCF_000008685.2	chromosome	717742	718669	927	100.0	3.519e-197
B331P	contig_1	718834	721096	2262	renamed_GCF_000008685.2	chromosome	718826	721088	2262	99.8	0.0
B331P	contig_1	721126	723028	1902	renamed_GCF_000008685.2	chromosome	721118	723020	1902	99.6	0.0
B331P	contig_1	724138	723070	1068	renamed_GCF_000008685.2	chromosome	724130	723062	1068	99.7	1.68e-246
B331P	contig_1	724231	725455	1224	renamed_GCF_000008685.2	chromosome	724223	725447	1224	98.7	9.433e-271
B331P	contig_1	725438	726503	1065	renamed_GCF_000008685.2	chromosome	725430	726495	1065	99.1	4.863e-234
B331P	contig_1	726492	727761	1269	renamed_GCF_000008685.2	chromosome	726457	727753	1269	99.2	9.104e-279
B331P	contig_1	727744	728683	939	renamed_GCF_000008685.2	chromosome	727736	728675	939	99.3	1.841e-206
B331P	contig_1	728673	729627	954	renamed_GCF_000008685.2	chromosome	728665	729619	954	99.6	2.964e-212
B331P	contig_1	748131	750027	1896	renamed_GCF_000008685.2	chromosome	748122	750018	1896	99.8	0.0
B331P	contig_1	750039	750798	759	renamed_GCF_000008685.2	chromosome	750030	750789	759	99.6	2.476e-164
B331P	contig_1	751199	752168	969	renamed_GCF_000008685.2	chromosome	751190	752159	969	99.0	5.746e-216
B331P	contig_1	752178	753228	1050	renamed_GCF_000008685.2	chromosome	752169	753219	1050	100.0	6.109e-229
B331P	contig_1	753231	754077	846	renamed_GCF_000008685.2	chromosome	753291	754068	846	99.6	1.473e-167
B331P	contig_1	754076	754559	483	renamed_GCF_000008685.2	chromosome	754067	754550	483	99.3	6.952e-107
B331P	contig_1	754558	756358	1800	renamed_GCF_000008685.2	chromosome	754636	756349	1800	99.8	0.0
B331P	contig_1	756362	757679	1317	renamed_GCF_000008685.2	chromosome	756353	757670	1317	99.7	1.293e-291
B331P	contig_1	759594	760224	630	renamed_GCF_000008685.2	chromosome	759585	760215	630	98.0	9.159e-137
B331P	contig_1	760210	761656	1446	renamed_GCF_000008685.2	chromosome	760225	761647	1446	99.3	2.357e-315
B331P	contig_1	763587	764370	783	renamed_GCF_000008685.2	chromosome	763578	764361	783	100.0	1.874e-171
B331P	contig_1	764379	765351	972	renamed_GCF_000008685.2	chromosome	764370	765342	972	100.0	2.973e-215
B331P	contig_1	765381	766725	1344	renamed_GCF_000008685.2	chromosome	765372	766716	1344	100.0	2.685e-305
B331P	contig_1	768073	766741	1332	renamed_GCF_000008685.2	chromosome	768064	766732	1332	98.8	1.632e-291
B331P	contig_1	782876	782198	678	renamed_GCF_000008685.2	chromosome	782829	782151	678	99.1	5.213e-151
B331P	contig_1	783295	783022	273	renamed_GCF_000008685.2	chromosome	783248	782975	273	100.0	3.858e-54
B331P	contig_1	783436	785068	1632	renamed_GCF_000008685.2	chromosome	783389	785021	1632	99.8	0.0
B331P	contig_1	785103	786801	1698	renamed_GCF_000008685.2	chromosome	785056	786754	1698	99.2	0.0
B331P	contig_1	786906	788991	2085	renamed_GCF_000008685.2	chromosome	786859	788962	2085	99.0	0.0
B331P	contig_1	789331	789967	636	renamed_GCF_000008685.2	chromosome	789302	789938	636	99.5	1.395e-141
B331P	contig_1	790836	789975	861	renamed_GCF_000008685.2	chromosome	790807	789946	861	100.0	1.57e-186
B331P	contig_1	791816	790835	981	renamed_GCF_000008685.2	chromosome	791787	790806	981	99.6	2.843e-217
B331P	contig_1	792281	791822	459	renamed_GCF_000008685.2	chromosome	792252	791793	459	99.3	2.509e-97
B331P	contig_1	792379	793654	1275	renamed_GCF_000008685.2	chromosome	792350	793625	1275	97.6	5.405e-277
B331P	contig_1	815359	814924	435	renamed_GCF_000008685.2	chromosome	815302	814867	435	100.0	4.611e-95
B331P	contig_1	816356	815558	798	renamed_GCF_000008685.2	chromosome	816299	815501	798	100.0	1.968e-173
B331P	contig_1	817259	816368	891	renamed_GCF_000008685.2	chromosome	817160	816311	891	99.2	1.029e-187
B331P	contig_1	817452	818013	561	renamed_GCF_000008685.2	chromosome	817395	817956	561	100.0	3.237e-128
B331P	contig_1	818074	818605	531	renamed_GCF_000008685.2	chromosome	818017	818548	531	100.0	1.403e-115
B331P	contig_1	818661	818973	312	renamed_GCF_000008685.2	chromosome	818604	818916	312	100.0	1.086e-65
B331P	contig_1	818978	819299	321	renamed_GCF_000008685.2	chromosome	819035	819242	321	97.0	1.267e-41
B331P	contig_1	819298	819544	246	renamed_GCF_000008685.2	chromosome	819241	819487	246	100.0	8.275e-50
B331P	contig_1	819598	820585	987	renamed_GCF_000008685.2	chromosome	819541	820528	987	99.6	5.255e-220
B331P	contig_1	820663	821245	582	renamed_GCF_000008685.2	chromosome	820606	821188	582	100.0	9.143e-129
B331P	contig_1	831620	831011	609	renamed_GCF_000008685.2	chromosome	831563	830954	609	100.0	7.938e-135
B331P	contig_1	836117	838583	2466	renamed_GCF_000008685.2	chromosome	836060	838526	2466	99.7	0.0
B331P	contig_1	838603	839137	534	renamed_GCF_000008685.2	chromosome	838546	839080	534	99.4	3.603e-114
B331P	contig_1	839300	841889	2589	renamed_GCF_000008685.2	chromosome	839243	841832	2589	99.5	0.0
B331P	contig_1	841890	842508	618	renamed_GCF_000008685.2	chromosome	841833	842451	618	100.0	1.393e-138
B331P	contig_1	842557	843046	489	renamed_GCF_000008685.2	chromosome	842500	842989	489	99.3	1.021e-103
B331P	contig_1	843059	844508	1449	renamed_GCF_000008685.2	chromosome	843002	844451	1449	99.5	1.877e-318
B331P	contig_1	844510	847129	2619	renamed_GCF_000008685.2	chromosome	844453	847102	2619	97.3	0.0
B331P	contig_1	847152	847515	363	renamed_GCF_000008685.2	chromosome	847125	847488	363	100.0	2.269e-74
B331P	contig_1	860466	861801	1335	renamed_GCF_000008685.2	chromosome	860439	861774	1335	99.3	4.561e-289
B331P	contig_1	862726	863674	948	renamed_GCF_000008685.2	chromosome	862698	863646	948	100.0	4.292e-207
B331P	contig_1	863663	865070	1407	renamed_GCF_000008685.2	chromosome	863635	865042	1407	100.0	1.287e-315
B331P	contig_1	865080	865947	867	renamed_GCF_000008685.2	chromosome	865052	865919	867	99.6	3.181e-188
B331P	contig_1	865943	866486	543	renamed_GCF_000008685.2	chromosome	865915	866458	543	98.8	6.309e-118
B331P	contig_1	866521	866722	201	renamed_GCF_000008685.2	chromosome	866493	866694	201	100.0	2.206e-40
B331P	contig_1	866708	867629	921	renamed_GCF_000008685.2	chromosome	866680	867601	921	99.0	7.526e-205
B331P	contig_1	900826	901810	984	renamed_GCF_000008685.2	chromosome	900798	901782	984	99.6	2.476e-219
B331P	contig_1	901861	903286	1425	renamed_GCF_000008685.2	chromosome	901833	903258	1425	99.7	1.327e-309
B331P	contig_2	9274	10036	762	renamed_GCF_000008685.2	cp26	9274	10036	762	98.4	1.282e-163
B331P	contig_2	10103	10652	549	renamed_GCF_000008685.2	cp26	10103	10652	549	98.9	3.433e-117
B331P	contig_2	11418	10920	498	renamed_GCF_000008685.2	cp26	11417	10919	498	99.3	3.972e-107
B331P	contig_2	11996	13589	1593	renamed_GCF_000008685.2	cp26	12013	13606	1593	99.4	0.0
B331P	contig_2	15090	13875	1215	renamed_GCF_000008685.2	cp26	15107	13892	1215	97.7	8.445e-262
B331P	contig_2	16653	15114	1539	renamed_GCF_000008685.2	cp26	16667	15131	1539	99.0	0.0
B331P	contig_2	16885	17518	633	renamed_GCF_000008685.2	cp26	16902	17535	633	79.1	5.253e-101
B331P	contig_3	20970	21711	741	renamed_GCF_000008685.2	cp32-3	21256	21997	741	99.5	2.472e-161
B331P	contig_3	21751	22294	543	renamed_GCF_000008685.2	cp32-1	21560	22118	543	64.0	6.304e-76
B331P	contig_4	2012	2576	564	renamed_GCF_000008685.2	cp32-6	2009	2573	564	99.4	1.105e-123
B331P	contig_4	3972	4932	960	renamed_GCF_000008685.2	cp32-6	3969	4929	960	100.0	6.008e-214
B331P	contig_4	4951	5407	456	renamed_GCF_000008685.2	cp32-6	4948	5404	456	99.3	5.32e-97
B331P	contig_4	5406	5790	384	renamed_GCF_000008685.2	cp32-9	5412	5796	384	100.0	2.931e-83
B331P	contig_4	5777	6167	390	renamed_GCF_000008685.2	cp32-9	5783	6173	390	100.0	3.229e-83
B331P	contig_4	6163	6730	567	renamed_GCF_000008685.2	lp56	9623	10190	567	98.9	1.159e-123
B331P	contig_4	20232	20799	567	renamed_GCF_000008685.2	cp32-6	20178	20745	567	100.0	6.547e-130
B331P	contig_5	2009	2573	564	renamed_GCF_000008685.2	cp32-4	2012	2576	564	99.4	1.105e-123
B331P	contig_5	2576	3344	768	renamed_GCF_000008685.2	cp32-6	2576	3344	768	99.2	1.626e-170
B331P	contig_5	3969	4929	960	renamed_GCF_000008685.2	lp56	7432	8392	960	100.0	6.008e-214
B331P	contig_5	5403	5787	384	renamed_GCF_000008685.2	cp32-4	5406	5790	384	100.0	2.931e-83
B331P	contig_5	6707	7820	1113	renamed_GCF_000008685.2	lp56	10170	11283	1113	98.3	4.476e-243
B331P	contig_5	16098	16452	354	renamed_GCF_000008685.2	cp32-6	16102	16456	354	100.0	1.459e-77
B331P	contig_5	16556	17177	621	renamed_GCF_000008685.2	cp32-9	16641	17196	621	83.4	3.299e-104
B331P	contig_6	16614	16932	318	renamed_GCF_000008685.2	cp32-3	16585	16903	318	100.0	2.414e-66
B331P	contig_6	19224	18276	948	renamed_GCF_000008685.2	cp32-3	19228	18286	948	98.0	3.249e-210
B331P	contig_6	21266	22022	756	renamed_GCF_000008685.2	cp32-4	20608	21364	756	99.2	4.353e-166
B331P	contig_6	26181	25404	777	renamed_GCF_000008685.2	cp32-7	25720	24943	777	100.0	1.414e-173
B331P	contig_7	4865	5219	354	renamed_GCF_000008685.2	cp32-7	16093	16447	354	99.1	3.249e-77
B331P	contig_8	3374	3950	576	renamed_GCF_000008685.2	cp32-6	3372	3948	576	100.0	4.521e-127
B331P	contig_19	3750	3348	402	renamed_GCF_000008685.2	lp28-2	25979	26390	402	88.0	3.163e-77
B331P	contig_19	16202	16541	339	renamed_GCF_000008685.2	lp28-2	13495	13156	339	100.0	3.422e-74
B331P	contig_19	16945	17389	444	renamed_GCF_000008685.2	lp28-2	12752	12308	444	100.0	8.866e-98
B331P	contig_1	11448	12189	741	renamed_GCF_000008685.2	chromosome	11420	12161	741	99.1	2.049e-163
B331P	contig_1	15750	15372	378	renamed_GCF_000008685.2	chromosome	15716	15344	378	99.1	3.937e-79
B331P	contig_1	18332	17819	513	renamed_GCF_000008685.2	chromosome	18304	17791	513	99.4	1.872e-109
B331P	contig_1	41310	40638	672	renamed_GCF_000008685.2	chromosome	41432	40760	672	100.0	1.856e-144
B331P	contig_1	42759	42357	402	renamed_GCF_000008685.2	chromosome	42881	42479	402	100.0	2.405e-88
B331P	contig_1	45323	45869	546	renamed_GCF_000008685.2	chromosome	45445	45991	546	98.8	3.601e-116
B331P	contig_1	47043	47718	675	renamed_GCF_000008685.2	chromosome	47166	47841	675	99.1	4.326e-144
B331P	contig_1	49136	48479	657	renamed_GCF_000008685.2	chromosome	49259	48602	657	99.0	5.221e-139
B331P	contig_1	59914	58975	939	renamed_GCF_000008685.2	chromosome	60039	59100	939	99.6	9.091e-206
B331P	contig_1	61132	60442	690	renamed_GCF_000008685.2	chromosome	61257	60567	690	98.2	8.357e-148
B331P	contig_1	63912	65151	1239	renamed_GCF_000008685.2	chromosome	64037	65276	1239	99.7	1.268e-278
B331P	contig_1	100104	100626	522	renamed_GCF_000008685.2	chromosome	100227	100749	522	97.6	3.604e-112
B331P	contig_1	102826	101401	1425	renamed_GCF_000008685.2	chromosome	102949	101524	1425	99.1	1.211e-310
B331P	contig_1	122367	121755	612	renamed_GCF_000008685.2	chromosome	122491	121879	612	99.0	7.99e-127
B331P	contig_1	124690	124024	666	renamed_GCF_000008685.2	chromosome	124814	124148	666	99.0	1.008e-141
B331P	contig_1	126177	125409	768	renamed_GCF_000008685.2	chromosome	126301	125533	768	99.6	3.291e-171
B331P	contig_1	130008	127302	2706	renamed_GCF_000008685.2	chromosome	130132	127426	2706	99.4	0.0
B331P	contig_1	131173	132301	1128	renamed_GCF_000008685.2	chromosome	131297	132425	1128	99.7	1.76e-247
B331P	contig_1	148540	147529	1011	renamed_GCF_000008685.2	chromosome	148659	147648	1011	99.7	2.697e-214
B331P	contig_1	152085	152892	807	renamed_GCF_000008685.2	chromosome	152205	153012	807	99.2	2.384e-181
B331P	contig_1	156280	153580	2700	renamed_GCF_000008685.2	chromosome	156400	153700	2700	99.5	0.0
B331P	contig_1	194757	195618	861	renamed_GCF_000008685.2	chromosome	194875	195736	861	98.9	3.489e-186
B331P	contig_1	202476	200949	1527	renamed_GCF_000008685.2	chromosome	202578	201051	1527	100.0	0.0
B331P	contig_1	204034	204970	936	renamed_GCF_000008685.2	chromosome	204136	205072	936	100.0	4.7e-204
B331P	contig_1	206426	207977	1551	renamed_GCF_000008685.2	chromosome	206528	208106	1551	99.8	0.0
B331P	contig_1	226669	224884	1785	renamed_GCF_000008685.2	chromosome	226610	224825	1785	99.6	0.0
B331P	contig_1	228580	227872	708	renamed_GCF_000008685.2	chromosome	228521	227813	708	99.5	4.758e-157
B331P	contig_1	281368	279463	1905	renamed_GCF_000008685.2	chromosome	281311	279406	1905	99.6	0.0
B331P	contig_1	282744	281856	888	renamed_GCF_000008685.2	chromosome	282687	281799	888	100.0	4.025e-189
B331P	contig_1	293265	292482	783	renamed_GCF_000008685.2	chromosome	293208	292425	783	100.0	6.057e-167
B331P	contig_1	294837	293508	1329	renamed_GCF_000008685.2	chromosome	294780	293451	1329	99.5	1.183e-294
B331P	contig_1	296477	295298	1179	renamed_GCF_000008685.2	chromosome	296420	295241	1179	98.4	1.549e-257
B331P	contig_1	297526	297094	432	renamed_GCF_000008685.2	chromosome	297469	297037	432	98.6	4.841e-94
B331P	contig_1	299772	298851	921	renamed_GCF_000008685.2	chromosome	299715	298794	921	99.0	2.516e-191
B331P	contig_1	310579	309835	744	renamed_GCF_000008685.2	chromosome	310523	309779	744	100.0	5.245e-162
B331P	contig_1	312771	311715	1056	renamed_GCF_000008685.2	chromosome	312715	311659	1056	100.0	1.239e-230
B331P	contig_1	314484	314202	282	renamed_GCF_000008685.2	chromosome	314427	314145	282	100.0	2.699e-59
B331P	contig_1	361144	359578	1566	renamed_GCF_000008685.2	chromosome	361078	359512	1566	99.8	0.0
B331P	contig_1	364183	362383	1800	renamed_GCF_000008685.2	chromosome	364117	362317	1800	99.6	0.0
B331P	contig_1	386224	387403	1179	renamed_GCF_000008685.2	chromosome	386158	387337	1179	99.7	9.776e-263
B331P	contig_1	388546	387883	663	renamed_GCF_000008685.2	chromosome	388480	387817	663	98.6	5.998e-147
B331P	contig_1	390407	389042	1365	renamed_GCF_000008685.2	chromosome	390341	388976	1365	99.3	3.579e-288
B331P	contig_1	393023	391997	1026	renamed_GCF_000008685.2	chromosome	392957	391931	1026	99.4	6.082e-225
B331P	contig_1	395232	394170	1062	renamed_GCF_000008685.2	chromosome	395166	394104	1062	99.7	9.401e-235
B331P	contig_1	408448	408268	180	renamed_GCF_000008685.2	chromosome	408380	408200	180	100.0	2.118e-37
B331P	contig_1	410515	409483	1032	renamed_GCF_000008685.2	chromosome	410447	409415	1032	100.0	9.895e-238
B331P	contig_1	413068	411523	1545	renamed_GCF_000008685.2	chromosome	413006	411455	1545	98.4	0.0
B331P	contig_1	469464	467358	2106	renamed_GCF_000008685.2	chromosome	469387	467281	2106	99.7	0.0
B331P	contig_1	470048	469754	294	renamed_GCF_000008685.2	chromosome	469971	469677	294	100.0	2.2e-63
B331P	contig_1	482673	484356	1683	renamed_GCF_000008685.2	chromosome	482599	484282	1683	99.6	0.0
B331P	contig_1	484830	485340	510	renamed_GCF_000008685.2	chromosome	484756	485266	510	100.0	1.216e-113
B331P	contig_1	486147	486843	696	renamed_GCF_000008685.2	chromosome	486073	486769	696	100.0	2.835e-152
B331P	contig_1	487608	488298	690	renamed_GCF_000008685.2	chromosome	487534	488224	690	99.5	4.749e-154
B331P	contig_1	489056	489569	513	renamed_GCF_000008685.2	chromosome	488982	489495	513	100.0	1.545e-111
B331P	contig_1	499128	499407	279	renamed_GCF_000008685.2	chromosome	499055	499334	279	100.0	1.411e-57
B331P	contig_1	499779	500661	882	renamed_GCF_000008685.2	chromosome	499706	500588	882	98.2	1.649e-189
B331P	contig_1	501084	501285	201	renamed_GCF_000008685.2	chromosome	501014	501212	201	98.4	1.098e-39
B331P	contig_1	543117	543885	768	renamed_GCF_000008685.2	chromosome	543048	543816	768	99.6	4.167e-177
B331P	contig_1	557431	556630	801	renamed_GCF_000008685.2	chromosome	557423	556562	801	93.0	1.119e-171
B331P	contig_1	560740	558013	2727	renamed_GCF_000008685.2	chromosome	560732	558005	2727	99.7	0.0
B331P	contig_1	561562	561124	438	renamed_GCF_000008685.2	chromosome	561554	561116	438	100.0	1.44e-91
B331P	contig_1	562192	564175	1983	renamed_GCF_000008685.2	chromosome	562184	564167	1983	99.5	0.0
B331P	contig_1	565969	567832	1863	renamed_GCF_000008685.2	chromosome	565954	567823	1863	99.1	0.0
B331P	contig_1	577957	578269	312	renamed_GCF_000008685.2	chromosome	577949	578261	312	100.0	5.387e-65
B331P	contig_1	580507	581665	1158	renamed_GCF_000008685.2	chromosome	580485	581643	1158	100.0	7.971e-253
B331P	contig_1	583479	583854	375	renamed_GCF_000008685.2	chromosome	583457	583832	375	99.1	1.859e-78
B331P	contig_1	642312	642465	153	renamed_GCF_000008685.2	chromosome	642288	642441	153	98.0	2.814e-30
B331P	contig_1	644675	643319	1356	renamed_GCF_000008685.2	chromosome	644650	643294	1356	99.5	1.919e-302
B331P	contig_1	661533	659661	1872	renamed_GCF_000008685.2	chromosome	661515	659643	1872	98.3	0.0
B331P	contig_1	662935	662620	315	renamed_GCF_000008685.2	chromosome	662917	662602	315	99.0	2.806e-64
B331P	contig_1	665029	663196	1833	renamed_GCF_000008685.2	chromosome	665011	663178	1833	99.6	0.0
B331P	contig_1	673358	674795	1437	renamed_GCF_000008685.2	chromosome	673341	674778	1437	99.3	0.0
B331P	contig_1	690205	690502	297	renamed_GCF_000008685.2	chromosome	690192	690489	297	100.0	1.037e-63
B331P	contig_1	690897	692658	1761	renamed_GCF_000008685.2	chromosome	690884	692645	1761	99.8	0.0
B331P	contig_1	736706	736967	261	renamed_GCF_000008685.2	chromosome	736698	736959	261	100.0	3.165e-54
B331P	contig_1	737219	737720	501	renamed_GCF_000008685.2	chromosome	737211	737712	501	99.3	4.586e-106
B331P	contig_1	738413	738779	366	renamed_GCF_000008685.2	chromosome	738405	738771	366	100.0	9.695e-76
B331P	contig_1	739692	740184	492	renamed_GCF_000008685.2	chromosome	739684	740176	492	100.0	4.374e-105
B331P	contig_1	740453	740696	243	renamed_GCF_000008685.2	chromosome	740445	740688	243	100.0	1.755e-49
B331P	contig_1	742636	741403	1233	renamed_GCF_000008685.2	chromosome	742628	741395	1233	99.2	4.064e-273
B331P	contig_1	744529	744853	324	renamed_GCF_000008685.2	chromosome	744521	744845	324	100.0	1.32e-65
B331P	contig_1	745309	746341	1032	renamed_GCF_000008685.2	chromosome	745301	746333	1032	98.8	6.089e-226
B331P	contig_1	807996	806949	1047	renamed_GCF_000008685.2	chromosome	807966	806919	1047	99.7	5.315e-230
B331P	contig_1	809582	808490	1092	renamed_GCF_000008685.2	chromosome	809552	808460	1092	100.0	7.863e-242
B331P	contig_1	853801	854869	1068	renamed_GCF_000008685.2	chromosome	853774	854842	1068	100.0	1.362e-231
B331P	contig_1	856015	857536	1521	renamed_GCF_000008685.2	chromosome	855988	857509	1521	99.6	0.0
B331P	contig_1	860138	858965	1173	renamed_GCF_000008685.2	chromosome	860111	858938	1173	99.2	6.965e-257
B331P	contig_1	870051	869535	516	renamed_GCF_000008685.2	chromosome	870023	869507	516	99.4	3.605e-111
B331P	contig_1	875160	872613	2547	renamed_GCF_000008685.2	chromosome	875132	872585	2547	100.0	0.0
B331P	contig_1	876456	879309	2853	renamed_GCF_000008685.2	chromosome	876491	879281	2853	99.7	0.0
B331P	contig_1	881119	880294	825	renamed_GCF_000008685.2	chromosome	881091	880266	825	100.0	2.882e-182
B331P	contig_1	886475	884255	2220	renamed_GCF_000008685.2	chromosome	886447	884227	2220	99.5	0.0
B331P	contig_2	751	307	444	renamed_GCF_000008685.2	cp26	751	307	444	98.6	3.617e-99
B331P	contig_2	3797	2474	1323	renamed_GCF_000008685.2	cp26	3798	2475	1323	99.0	3.455e-290
B331P	contig_5	22343	22922	579	renamed_GCF_000008685.2	cp32-8	22112	22691	579	100.0	3.43e-122
B331P	contig_5	24793	25219	426	renamed_GCF_000008685.2	cp32-3	25068	25494	426	98.5	3.989e-95
B331P	contig_5	27976	28543	567	renamed_GCF_000008685.2	cp32-7	28884	29451	567	100.0	5.734e-123
B331P	contig_6	7832	8261	429	renamed_GCF_000008685.2	lp56	11296	11725	429	99.2	1.246e-91
B331P	contig_6	8728	8965	237	renamed_GCF_000008685.2	cp32-9	8741	8978	237	100.0	1.76e-48
B331P	contig_6	11932	12487	555	renamed_GCF_000008685.2	cp32-6	11929	12484	555	100.0	3.12e-119
B331P	contig_6	12845	13724	879	renamed_GCF_000008685.2	cp32-7	12831	13710	879	97.2	4.212e-187
B331P	contig_6	28701	29268	567	renamed_GCF_000008685.2	cp32-1	28834	29401	567	93.6	6.073e-114
B331P	contig_8	15143	15347	204	renamed_GCF_000008685.2	cp32-1	15214	15418	204	100.0	2.578e-39
B331P	contig_8	17166	17592	426	renamed_GCF_000008685.2	cp32-3	17802	18249	426	82.1	1.031e-76
B331P	contig_11	6330	6657	327	renamed_GCF_000008685.2	lp17	7784	8111	327	99.0	2.291e-68
B331P	contig_11	6812	7925	1113	renamed_GCF_000008685.2	lp17	8266	9379	1113	97.8	2.209e-242
B331P	contig_11	12035	12776	741	renamed_GCF_000008685.2	lp17	13338	14079	741	100.0	7.64e-166
B331P	contig_11	14813	14582	231	renamed_GCF_000008685.2	lp17	16119	15888	231	98.6	8.774e-47
B331P	contig_12	6682	7546	864	renamed_GCF_000008685.2	lp25	6897	7761	864	98.6	2.295e-191
B331P	contig_12	23062	22330	732	renamed_GCF_000008685.2	lp25	22677	21945	732	99.5	5.755e-159
B331P	contig_13	242	392	150	renamed_GCF_000008685.2	lp56	52726	52531	150	100.0	1.293e-22
B331P	contig_13	9110	8495	615	renamed_GCF_000008685.2	lp28-3	10516	9847	615	91.8	2.251e-124
B331P	contig_16	13341	12414	927	renamed_GCF_000008685.2	lp36	15760	14833	927	99.0	1.526e-206
B331P	contig_16	13854	14466	612	renamed_GCF_000008685.2	lp36	16274	16886	612	100.0	9.153e-134
B331P	contig_16	14959	15163	204	renamed_GCF_000008685.2	lp36	17379	17583	204	100.0	8.441e-43
B331P	contig_16	17968	19033	1065	renamed_GCF_000008685.2	lp36	20388	21453	1065	96.3	2.479e-224
B331P	contig_16	19494	19716	222	renamed_GCF_000008685.2	lp36	21911	22133	222	98.6	2.07e-44
B331P	contig_16	20688	20982	294	renamed_GCF_000008685.2	lp28-1	10895	10697	294	100.0	9.155e-41
B331P	contig_16	22623	23064	441	renamed_GCF_000008685.2	lp36	6040	5287	441	97.9	8.241e-90
B331P	contig_18	5498	6254	756	renamed_GCF_000008685.2	lp54	47228	46472	756	99.2	5.251e-164
B331P	contig_18	9249	10098	849	renamed_GCF_000008685.2	lp54	44533	43684	849	100.0	7.054e-185
B331P	contig_18	19409	18845	564	renamed_GCF_000008685.2	lp54	34384	34948	564	98.9	1.78e-118
B331P	contig_18	21052	20833	219	renamed_GCF_000008685.2	lp54	32741	32960	219	100.0	7.958e-46
B331P	contig_19	27456	26562	894	renamed_GCF_000008685.2	lp28-2	115	1009	894	92.9	5.518e-178
B331P	contig_1	1823	794	1029	renamed_GCF_000008685.2	chromosome	1796	767	1029	98.8	2.869e-225
B331P	contig_1	3422	5216	1794	renamed_GCF_000008685.2	chromosome	3418	5188	1794	99.3	0.0
B331P	contig_1	6334	5278	1056	renamed_GCF_000008685.2	chromosome	6306	5250	1056	99.1	1.902e-234
B331P	contig_1	35715	33915	1800	renamed_GCF_000008685.2	chromosome	35836	34036	1800	99.8	0.0
B331P	contig_1	39517	38014	1503	renamed_GCF_000008685.2	chromosome	39638	38135	1503	99.8	0.0
B331P	contig_1	51127	50365	762	renamed_GCF_000008685.2	chromosome	51251	50489	762	100.0	1.168e-164
B331P	contig_1	53337	52329	1008	renamed_GCF_000008685.2	chromosome	53461	52453	1008	100.0	6.65e-221
B331P	contig_1	56156	55376	780	renamed_GCF_000008685.2	chromosome	56280	55500	780	99.6	1.628e-172
B331P	contig_1	57061	56707	354	renamed_GCF_000008685.2	chromosome	57185	56831	354	99.1	6.554e-78
B331P	contig_1	58912	57904	1008	renamed_GCF_000008685.2	chromosome	58982	58028	1008	98.7	6.479e-204
B331P	contig_1	71078	72488	1410	renamed_GCF_000008685.2	chromosome	71200	72610	1410	99.3	6.232e-307
B331P	contig_1	118247	117554	693	renamed_GCF_000008685.2	chromosome	118370	117677	693	98.2	6.012e-152
B331P	contig_1	119680	118840	840	renamed_GCF_000008685.2	chromosome	119803	118963	840	96.4	7.682e-174
B331P	contig_1	120958	120679	279	renamed_GCF_000008685.2	chromosome	121082	120803	279	96.7	3.477e-56
B331P	contig_1	133850	135740	1890	renamed_GCF_000008685.2	chromosome	133974	135864	1890	99.6	0.0
B331P	contig_1	138624	138312	312	renamed_GCF_000008685.2	chromosome	138745	138433	312	100.0	9.828e-67
B331P	contig_1	144147	142824	1323	renamed_GCF_000008685.2	chromosome	144230	142943	1323	99.5	8.634e-280
B331P	contig_1	145339	144466	873	renamed_GCF_000008685.2	chromosome	145458	144585	873	99.3	3.059e-198
B331P	contig_1	158508	159225	717	renamed_GCF_000008685.2	chromosome	158627	159344	717	100.0	1.01e-158
B331P	contig_1	159970	161089	1119	renamed_GCF_000008685.2	chromosome	160089	161208	1119	99.7	1.16e-250
B331P	contig_1	162758	162926	168	renamed_GCF_000008685.2	chromosome	162877	163045	168	100.0	5.294e-34
B331P	contig_1	219858	220698	840	renamed_GCF_000008685.2	chromosome	219799	220639	840	100.0	1.641e-182
B331P	contig_1	221692	223237	1545	renamed_GCF_000008685.2	chromosome	221741	223178	1545	98.7	3.462e-310
B331P	contig_1	235593	235347	246	renamed_GCF_000008685.2	chromosome	235534	235288	246	98.7	3.025e-52
B331P	contig_1	237688	237280	408	renamed_GCF_000008685.2	chromosome	237629	237221	408	100.0	2.649e-88
B331P	contig_1	238285	238027	258	renamed_GCF_000008685.2	chromosome	238226	237968	258	98.8	2.031e-50
B331P	contig_1	240309	239202	1107	renamed_GCF_000008685.2	chromosome	240250	239143	1107	99.7	3.718e-244
B331P	contig_1	242496	244062	1566	renamed_GCF_000008685.2	chromosome	242437	244003	1566	98.6	0.0
B331P	contig_1	255703	256318	615	renamed_GCF_000008685.2	chromosome	255645	256260	615	99.5	1.16e-131
B331P	contig_1	264044	266171	2127	renamed_GCF_000008685.2	chromosome	263987	266114	2127	99.4	0.0
B331P	contig_1	305718	305169	549	renamed_GCF_000008685.2	chromosome	305661	305112	549	100.0	9.24e-115
B331P	contig_1	307373	306680	693	renamed_GCF_000008685.2	chromosome	307317	306624	693	100.0	2.971e-151
B331P	contig_1	319693	319162	531	renamed_GCF_000008685.2	chromosome	319636	319105	531	100.0	1.699e-113
B331P	contig_1	320365	321409	1044	renamed_GCF_000008685.2	chromosome	320308	321352	1044	99.7	6.693e-227
B331P	contig_1	322903	322096	807	renamed_GCF_000008685.2	chromosome	322846	322039	807	99.6	2.064e-174
B331P	contig_1	325293	323832	1461	renamed_GCF_000008685.2	chromosome	325236	323775	1461	99.7	0.0
B331P	contig_1	327784	326755	1029	renamed_GCF_000008685.2	chromosome	327757	326698	1029	99.1	8.128e-231
B331P	contig_1	343270	344242	972	renamed_GCF_000008685.2	chromosome	343207	344179	972	100.0	3.579e-213
B331P	contig_1	346904	346493	411	renamed_GCF_000008685.2	chromosome	346841	346430	411	100.0	6.821e-87
B331P	contig_1	348223	347413	810	renamed_GCF_000008685.2	chromosome	348160	347350	810	99.2	4.608e-183
B331P	contig_1	384228	383460	768	renamed_GCF_000008685.2	chromosome	384162	383394	768	99.6	9.689e-168
B331P	contig_1	396574	395548	1026	renamed_GCF_000008685.2	chromosome	396506	395480	1026	99.7	3.294e-223
B331P	contig_1	397544	397169	375	renamed_GCF_000008685.2	chromosome	397476	397101	375	100.0	1.385e-81
B331P	contig_1	405685	405310	375	renamed_GCF_000008685.2	chromosome	405617	405242	375	99.1	2.753e-74
B331P	contig_1	406244	405755	489	renamed_GCF_000008685.2	chromosome	406176	405687	489	100.0	1.238e-101
B331P	contig_1	406929	406248	681	renamed_GCF_000008685.2	chromosome	406861	406180	681	100.0	2.702e-150
B331P	contig_1	407360	406928	432	renamed_GCF_000008685.2	chromosome	407292	406860	432	100.0	3.534e-89
B331P	contig_1	407966	407411	555	renamed_GCF_000008685.2	chromosome	407898	407343	555	100.0	5.734e-121
B331P	contig_1	417169	417781	612	renamed_GCF_000008685.2	chromosome	417101	417713	612	100.0	4.975e-132
B331P	contig_1	448782	449388	606	renamed_GCF_000008685.2	chromosome	448707	449310	606	99.5	2.46e-130
B331P	contig_1	449496	450249	753	renamed_GCF_000008685.2	chromosome	449418	450171	753	99.2	8.002e-159
B331P	contig_1	451999	451216	783	renamed_GCF_000008685.2	chromosome	451921	451138	783	99.6	5.024e-169
B331P	contig_1	454550	452117	2433	renamed_GCF_000008685.2	chromosome	454472	452039	2433	99.8	0.0
B331P	contig_1	456466	454561	1905	renamed_GCF_000008685.2	chromosome	456388	454483	1905	99.6	0.0
B331P	contig_1	456653	458114	1461	renamed_GCF_000008685.2	chromosome	456575	458036	1461	100.0	0.0
B331P	contig_1	458354	459512	1158	renamed_GCF_000008685.2	chromosome	458276	459434	1158	99.4	1.343e-255
B331P	contig_1	459602	459902	300	renamed_GCF_000008685.2	chromosome	459524	459824	300	95.9	4.432e-57
B331P	contig_1	471297	470037	1260	renamed_GCF_000008685.2	chromosome	471220	469960	1260	99.2	1.373e-272
B331P	contig_1	489806	490628	822	renamed_GCF_000008685.2	chromosome	489732	490554	822	99.2	6.708e-181
B331P	contig_1	490717	492001	1284	renamed_GCF_000008685.2	chromosome	490643	491927	1284	100.0	9.564e-281
B331P	contig_1	492660	494025	1365	renamed_GCF_000008685.2	chromosome	492587	493952	1365	100.0	1.721e-296
B331P	contig_1	494615	494222	393	renamed_GCF_000008685.2	chromosome	494539	494149	393	99.2	2.252e-79
B331P	contig_1	495105	496290	1185	renamed_GCF_000008685.2	chromosome	495032	496217	1185	100.0	4.832e-263
B331P	contig_1	496340	496652	312	renamed_GCF_000008685.2	chromosome	496267	496579	312	100.0	2.953e-63
B331P	contig_1	496687	497308	621	renamed_GCF_000008685.2	chromosome	496614	497235	621	100.0	8.732e-136
B331P	contig_1	497317	497947	630	renamed_GCF_000008685.2	chromosome	497244	497874	630	99.5	2.239e-135
B331P	contig_1	497967	498264	297	renamed_GCF_000008685.2	chromosome	497894	498191	297	100.0	5.69e-62
B331P	contig_1	502828	503014	186	renamed_GCF_000008685.2	chromosome	502755	502941	186	100.0	7.664e-41
B331P	contig_1	524622	526323	1701	renamed_GCF_000008685.2	chromosome	524553	526254	1701	99.1	0.0
B331P	contig_1	529266	528171	1095	renamed_GCF_000008685.2	chromosome	529198	528103	1095	100.0	3.934e-250
B331P	contig_1	531173	529265	1908	renamed_GCF_000008685.2	chromosome	531105	529197	1908	100.0	0.0
B331P	contig_1	531760	531196	564	renamed_GCF_000008685.2	chromosome	531692	531128	564	100.0	2.704e-122
B331P	contig_1	534369	535224	855	renamed_GCF_000008685.2	chromosome	534300	535155	855	98.9	2.402e-189
B331P	contig_1	544654	547456	2802	renamed_GCF_000008685.2	chromosome	544585	547387	2802	98.4	0.0
B331P	contig_1	569285	569546	261	renamed_GCF_000008685.2	chromosome	569277	569538	261	100.0	9.575e-51
B331P	contig_1	569566	571288	1722	renamed_GCF_000008685.2	chromosome	569558	571280	1722	100.0	0.0
B331P	contig_1	571290	571860	570	renamed_GCF_000008685.2	chromosome	571282	571852	570	99.4	7.275e-121
B331P	contig_1	573748	571897	1851	renamed_GCF_000008685.2	chromosome	573740	571889	1851	99.8	0.0
B331P	contig_1	573860	575255	1395	renamed_GCF_000008685.2	chromosome	573852	575247	1395	99.1	6.938e-312
B331P	contig_1	575824	575281	543	renamed_GCF_000008685.2	chromosome	575816	575273	543	99.4	6.941e-117
B331P	contig_1	576534	575988	546	renamed_GCF_000008685.2	chromosome	576499	575980	546	100.0	1.781e-115
B331P	contig_1	577195	576589	606	renamed_GCF_000008685.2	chromosome	577187	576581	606	99.5	1.106e-130
B331P	contig_1	577402	577945	543	renamed_GCF_000008685.2	chromosome	577394	577937	543	100.0	3.121e-117
B331P	contig_1	590230	589705	525	renamed_GCF_000008685.2	chromosome	590208	589683	525	97.7	3.018e-106
B331P	contig_1	618849	621057	2208	renamed_GCF_000008685.2	chromosome	618827	621035	2208	99.7	0.0
B331P	contig_1	621975	621066	909	renamed_GCF_000008685.2	chromosome	621953	621044	909	99.0	1.832e-201
B331P	contig_1	622026	623469	1443	renamed_GCF_000008685.2	chromosome	622004	623447	1443	99.1	0.0
B331P	contig_1	623472	625029	1557	renamed_GCF_000008685.2	chromosome	623450	625007	1557	98.6	0.0
B331P	contig_6	5772	6162	390	renamed_GCF_000008685.2	cp32-4	5777	6167	390	100.0	3.229e-83
B331P	contig_6	17117	17705	588	renamed_GCF_000008685.2	cp32-7	16551	17139	588	97.9	1.778e-122
B331P	contig_8	1307	2000	693	renamed_GCF_000008685.2	lp56	35114	35807	693	98.6	2.837e-143
B331P	contig_8	5405	5789	384	renamed_GCF_000008685.2	lp56	8866	9250	384	100.0	2.931e-83
B331P	contig_8	20674	21424	750	renamed_GCF_000008685.2	cp32-6	20720	21470	750	100.0	4.35e-165
B331P	contig_8	21473	22052	579	renamed_GCF_000008685.2	cp32-6	21519	22098	579	100.0	5.735e-125
B331P	contig_8	22055	22724	669	renamed_GCF_000008685.2	cp32-6	22101	22770	669	100.0	2.138e-142
B331P	contig_9	8737	8974	237	renamed_GCF_000008685.2	cp32-7	8725	8962	237	100.0	7.893e-49
B331P	contig_9	8981	10319	1338	renamed_GCF_000008685.2	cp32-7	8969	10304	1338	97.7	8.274e-283
B331P	contig_9	10331	10973	642	renamed_GCF_000008685.2	cp32-7	10316	10958	642	95.7	1.337e-134
B331P	contig_9	10976	11918	942	renamed_GCF_000008685.2	cp32-7	10961	11903	942	98.4	7.211e-209
B331P	contig_9	18737	17723	1014	renamed_GCF_000008685.2	cp32-1	18728	17714	1014	97.3	2.27e-225
B331P	contig_9	19128	20226	1098	renamed_GCF_000008685.2	cp32-7	19116	20214	1098	97.2	3.543e-243
B331P	contig_9	20235	20802	567	renamed_GCF_000008685.2	cp32-4	20066	20633	567	100.0	2.944e-130
B331P	contig_9	20777	21527	750	renamed_GCF_000008685.2	cp32-7	20765	21515	750	100.0	2.593e-162
B331P	contig_9	21566	22088	522	renamed_GCF_000008685.2	cp32-7	21521	22076	522	100.0	1.473e-113
B331P	contig_11	1626	906	720	renamed_GCF_000008685.2	lp28-3	2970	2259	720	94.1	5.218e-141
B331P	contig_11	3593	4277	684	renamed_GCF_000008685.2	lp17	5055	5739	684	99.5	1.274e-150
B331P	contig_11	5001	4422	579	renamed_GCF_000008685.2	lp17	6452	5873	579	98.9	1.16e-125
B331P	contig_12	9996	9375	621	renamed_GCF_000008685.2	lp25	10187	9566	621	94.1	1.275e-131
B331P	contig_12	10509	10008	501	renamed_GCF_000008685.2	lp25	10694	10199	501	81.0	1.053e-88
B331P	contig_12	11880	11298	582	renamed_GCF_000008685.2	lp25	12079	11497	582	100.0	4.521e-128
B331P	contig_12	12655	11896	759	renamed_GCF_000008685.2	lp25	12854	12095	759	100.0	2.255e-165
B331P	contig_12	13194	12630	564	renamed_GCF_000008685.2	lp25	13393	12829	564	98.9	1.105e-123
B331P	contig_13	25172	24254	918	renamed_GCF_000008685.2	lp28-3	26371	25432	918	89.8	4.747e-175
B331P	contig_13	26294	25826	468	renamed_GCF_000008685.2	lp28-3	27445	26977	468	98.7	6.628e-105
B331P	contig_13	26617	27172	555	renamed_GCF_000008685.2	lp28-4	26359	26914	555	98.9	1.054e-122
B331P	contig_15	9313	10096	783	renamed_GCF_000008685.2	lp28-2	19619	18836	783	80.7	3.91e-146
B331P	contig_16	334	580	246	renamed_GCF_000008685.2	lp21	16548	16227	246	90.7	5.597e-46
B331P	contig_16	887	1439	552	renamed_GCF_000008685.2	lp56	855	1407	552	97.2	7.279e-118
B331P	contig_16	1435	2284	849	renamed_GCF_000008685.2	lp36	35443	34594	849	97.5	6.426e-186
B331P	contig_16	3226	3568	342	renamed_GCF_000008685.2	lp28-3	8017	8431	342	61.5	0.0002439
B331P	contig_16	25539	25161	378	renamed_GCF_000008685.2	lp21	252	618	378	66.4	1.526e-48
B331P	contig_16	28361	28961	600	renamed_GCF_000008685.2	lp28-1	8771	9029	600	45.1	7.015e-14
B331P	contig_17	36318	35703	615	renamed_GCF_000008685.2	lp38	36248	35633	615	99.5	1.402e-129
B331P	contig_17	36712	37048	336	renamed_GCF_000008685.2	lp5	4387	4819	336	51.8	2.184e-30
B331P	contig_17	38406	37491	915	renamed_GCF_000008685.2	lp28-1	26996	28073	915	37.8	1.889e-43
B331P	contig_18	10262	11171	909	renamed_GCF_000008685.2	lp54	43532	42623	909	99.6	5.38e-198
B331P	contig_18	11528	11321	207	renamed_GCF_000008685.2	lp54	42266	42473	207	100.0	9.856e-42
B331P	contig_18	11775	12399	624	renamed_GCF_000008685.2	lp54	42019	41395	624	99.5	1.532e-138
B331P	contig_18	12749	13583	834	renamed_GCF_000008685.2	lp54	41045	40211	834	99.6	1.639e-181
B331P	contig_18	13682	13922	240	renamed_GCF_000008685.2	lp54	40112	39872	240	100.0	3.722e-49
B331P	contig_18	14388	15633	1245	renamed_GCF_000008685.2	lp54	39405	38160	1245	99.2	2.65e-271
B331P	contig_18	50861	51710	849	renamed_GCF_000008685.2	lp54	2893	2044	849	100.0	5.332e-188
B331P	contig_18	53104	52618	486	renamed_GCF_000008685.2	lp28-3	28197	27624	486	48.4	2.052e-45
B331P	contig_19	1698	984	714	renamed_GCF_000008685.2	lp28-2	28030	28831	714	88.3	3.94e-143
B331P	contig_19	3077	2648	429	renamed_GCF_000008685.2	lp28-2	26569	27085	429	94.3	6.173e-91
B331P	contig_19	5244	3774	1470	renamed_GCF_000008685.2	lp28-2	24488	25955	1470	92.4	4.595e-303
B331P	contig_1	10608	11448	840	renamed_GCF_000008685.2	chromosome	10580	11420	840	99.6	3.841e-190
B331P	contig_1	12181	12781	600	renamed_GCF_000008685.2	chromosome	12153	12753	600	99.4	2.034e-131
B331P	contig_1	63021	63903	882	renamed_GCF_000008685.2	chromosome	63146	64028	882	99.6	6.762e-191
B331P	contig_1	65165	65627	462	renamed_GCF_000008685.2	chromosome	65290	65752	462	98.6	3.873e-93
B331P	contig_1	67122	69447	2325	renamed_GCF_000008685.2	chromosome	67247	69569	2325	99.4	0.0
B331P	contig_1	80859	81285	426	renamed_GCF_000008685.2	chromosome	80982	81408	426	99.2	2.643e-91
B331P	contig_1	83797	82846	951	renamed_GCF_000008685.2	chromosome	83920	82969	951	99.6	3.736e-209
B331P	contig_1	86731	85756	975	renamed_GCF_000008685.2	chromosome	86854	85879	975	100.0	4.354e-220
B331P	contig_1	90992	89687	1305	renamed_GCF_000008685.2	chromosome	91115	89810	1305	100.0	2.863e-289
B331P	contig_1	93301	92755	546	renamed_GCF_000008685.2	chromosome	93423	92877	546	97.7	1.472e-117
B331P	contig_1	150853	152059	1206	renamed_GCF_000008685.2	chromosome	150973	152179	1206	99.7	1.095e-274
B331P	contig_1	153566	152954	612	renamed_GCF_000008685.2	chromosome	153686	153074	612	99.5	5.181e-140
B331P	contig_1	156342	157479	1137	renamed_GCF_000008685.2	chromosome	156461	157598	1137	100.0	1.164e-253
B331P	contig_1	157938	158355	417	renamed_GCF_000008685.2	chromosome	158075	158474	417	100.0	2.72e-81
B331P	contig_1	171131	171365	234	renamed_GCF_000008685.2	chromosome	171262	171484	234	98.6	1.134e-44
B331P	contig_1	173997	173409	588	renamed_GCF_000008685.2	chromosome	174116	173528	588	98.4	4.112e-130
B331P	contig_1	177734	176858	876	renamed_GCF_000008685.2	chromosome	177853	176977	876	100.0	9.427e-195
B331P	contig_1	179424	178797	627	renamed_GCF_000008685.2	chromosome	179543	178916	627	98.5	6.931e-131
B331P	contig_1	189157	188956	201	renamed_GCF_000008685.2	chromosome	189276	189075	201	98.4	4.922e-40
B331P	contig_1	189944	190598	654	renamed_GCF_000008685.2	chromosome	190186	190717	654	100.0	6.314e-111
B331P	contig_1	192208	191398	810	renamed_GCF_000008685.2	chromosome	192327	191517	810	98.8	1.235e-180
B331P	contig_1	195574	197578	2004	renamed_GCF_000008685.2	chromosome	195692	197696	2004	99.7	0.0
B331P	contig_1	200948	199862	1086	renamed_GCF_000008685.2	chromosome	201050	199964	1086	99.1	7.16e-242
B331P	contig_1	202747	203986	1239	renamed_GCF_000008685.2	chromosome	202849	204088	1239	99.5	1.471e-259
B331P	contig_1	204970	205942	972	renamed_GCF_000008685.2	chromosome	205174	206044	972	99.6	3.289e-188
B331P	contig_1	208517	207980	537	renamed_GCF_000008685.2	chromosome	208581	208083	537	98.7	8.112e-106
B331P	contig_1	224844	224022	822	renamed_GCF_000008685.2	chromosome	224785	223963	822	100.0	3.638e-179
B331P	contig_1	276553	275299	1254	renamed_GCF_000008685.2	chromosome	276496	275242	1254	99.5	2.463e-282
B331P	contig_1	278616	277146	1470	renamed_GCF_000008685.2	chromosome	278559	277089	1470	99.7	4.387e-321
B331P	contig_1	279437	279134	303	renamed_GCF_000008685.2	chromosome	279380	279077	303	99.0	2.307e-64
B331P	contig_1	281850	281370	480	renamed_GCF_000008685.2	chromosome	281793	281313	480	99.3	5.307e-101
B331P	contig_1	292483	291700	783	renamed_GCF_000008685.2	chromosome	292426	291643	783	100.0	1.874e-171
B331P	contig_1	293486	293261	225	renamed_GCF_000008685.2	chromosome	293429	293204	225	100.0	8.8e-46
B331P	contig_1	295285	294841	444	renamed_GCF_000008685.2	chromosome	295228	294784	444	99.3	2.638e-94
B331P	contig_1	297102	296484	618	renamed_GCF_000008685.2	chromosome	297045	296427	618	99.5	5.47e-132
B331P	contig_1	298833	297522	1311	renamed_GCF_000008685.2	chromosome	298776	297465	1311	100.0	6.981e-289
B331P	contig_1	309836	308594	1242	renamed_GCF_000008685.2	chromosome	309780	308538	1242	100.0	1.368e-269
B331P	contig_1	355364	354713	651	renamed_GCF_000008685.2	chromosome	355298	354647	651	100.0	1.769e-141
B331P	contig_1	357072	358506	1434	renamed_GCF_000008685.2	chromosome	357006	358440	1434	99.7	4.764e-314
B331P	contig_1	359561	359282	279	renamed_GCF_000008685.2	chromosome	359495	359216	279	100.0	2.841e-58
B331P	contig_1	361265	362387	1122	renamed_GCF_000008685.2	chromosome	361187	362321	1122	99.4	5.47e-251
B331P	contig_1	385514	386228	714	renamed_GCF_000008685.2	chromosome	385448	386162	714	100.0	3.427e-153
B331P	contig_1	387399	387873	474	renamed_GCF_000008685.2	chromosome	387333	387807	474	100.0	1.339e-106
B331P	contig_1	388992	388572	420	renamed_GCF_000008685.2	chromosome	388926	388506	420	100.0	9.787e-93
B331P	contig_1	391885	390460	1425	renamed_GCF_000008685.2	chromosome	391819	390391	1425	99.5	0.0
B331P	contig_1	394129	393109	1020	renamed_GCF_000008685.2	chromosome	394063	393043	1020	100.0	6.665e-223
B331P	contig_1	408160	407989	171	renamed_GCF_000008685.2	chromosome	408092	407921	171	100.0	1.118e-34
B331P	contig_1	462896	463964	1068	renamed_GCF_000008685.2	chromosome	462818	463886	1068	100.0	4.491e-244
B331P	contig_1	467355	465594	1761	renamed_GCF_000008685.2	chromosome	467278	465517	1761	99.4	0.0
B331P	contig_1	469742	469466	276	renamed_GCF_000008685.2	chromosome	469665	469389	276	97.8	9.032e-54
B331P	contig_1	482131	481417	714	renamed_GCF_000008685.2	chromosome	482057	481343	714	100.0	3.944e-160
B331P	contig_1	484360	484660	300	renamed_GCF_000008685.2	chromosome	484286	484586	300	100.0	5.976e-62
B331P	contig_1	485623	486151	528	renamed_GCF_000008685.2	chromosome	485549	486077	528	100.0	1.004e-118
B331P	contig_1	486790	487612	822	renamed_GCF_000008685.2	chromosome	486746	487538	822	99.6	9.243e-169
B331P	contig_1	488299	489046	747	renamed_GCF_000008685.2	chromosome	488225	488972	747	99.5	1.867e-165
B331P	contig_1	498285	499119	834	renamed_GCF_000008685.2	chromosome	498212	499046	834	100.0	1.895e-188
B331P	contig_1	539344	538396	948	renamed_GCF_000008685.2	chromosome	539275	538327	948	100.0	1.008e-214
B331P	contig_1	542331	543093	762	renamed_GCF_000008685.2	chromosome	542262	543024	762	99.2	1.347e-171
B331P	contig_1	543900	544674	774	renamed_GCF_000008685.2	chromosome	543831	544605	774	99.2	1.962e-169
B331P	contig_1	558032	557414	618	renamed_GCF_000008685.2	chromosome	558024	557406	618	100.0	1.216e-131
B331P	contig_1	561135	560736	399	renamed_GCF_000008685.2	chromosome	561127	560728	399	100.0	7.535e-84
B331P	contig_1	561951	561570	381	renamed_GCF_000008685.2	chromosome	561943	561562	381	99.2	5.027e-77
B331P	contig_1	567818	568286	468	renamed_GCF_000008685.2	chromosome	567809	568277	468	99.3	4.381e-101
B331P	contig_1	578284	580429	2145	renamed_GCF_000008685.2	chromosome	578276	580421	2145	99.7	0.0
B331P	contig_1	634605	636036	1431	renamed_GCF_000008685.2	chromosome	634580	636011	1431	97.8	1.01e-313
B331P	contig_1	637986	638580	594	renamed_GCF_000008685.2	chromosome	637971	638556	594	100.0	1.47e-125
B331P	contig_1	639864	642273	2409	renamed_GCF_000008685.2	chromosome	639858	642249	2409	99.4	0.0
B331P	contig_1	643151	642524	627	renamed_GCF_000008685.2	chromosome	643126	642499	627	100.0	8.735e-137
B331P	contig_1	658915	659641	726	renamed_GCF_000008685.2	chromosome	658897	659623	726	100.0	3.429e-155
B331P	contig_1	661623	662547	924	renamed_GCF_000008685.2	chromosome	661605	662529	924	99.3	2.542e-200
B331P	contig_1	668535	665025	3510	renamed_GCF_000008685.2	chromosome	668517	665007	3510	99.5	0.0
B331P	contig_1	673229	671783	1446	renamed_GCF_000008685.2	chromosome	673167	671766	1446	98.7	5.364e-306
B331P	contig_1	675045	676389	1344	renamed_GCF_000008685.2	chromosome	675034	676378	1344	99.7	1.793e-292
B331P	contig_1	688502	690140	1638	renamed_GCF_000008685.2	chromosome	688489	690127	1638	100.0	0.0
B331P	contig_1	810524	809729	795	renamed_GCF_000008685.2	chromosome	810495	809700	795	100.0	1.877e-173
B331P	contig_1	812417	811535	882	renamed_GCF_000008685.2	chromosome	812388	811506	882	99.6	1.248e-192
B331P	contig_1	813763	813418	345	renamed_GCF_000008685.2	chromosome	813706	813385	345	92.0	6.146e-61
B331P	contig_1	821241	822426	1185	renamed_GCF_000008685.2	chromosome	821184	822369	1185	99.7	1.177e-261
B331P	contig_1	822400	822751	351	renamed_GCF_000008685.2	chromosome	822343	822694	351	97.4	3.769e-75
B331P	contig_1	823319	823868	549	renamed_GCF_000008685.2	chromosome	823262	823811	549	98.3	4.154e-115
B331P	contig_1	824438	825761	1323	renamed_GCF_000008685.2	chromosome	824381	825704	1323	99.5	2.183e-295
B331P	contig_1	827687	829169	1482	renamed_GCF_000008685.2	chromosome	827630	829112	1482	98.9	0.0
B331P	contig_1	830998	830374	624	renamed_GCF_000008685.2	chromosome	830941	830317	624	99.5	5.702e-141
B331P	contig_1	848845	851014	2169	renamed_GCF_000008685.2	chromosome	848836	850987	2169	99.7	0.0
B331P	contig_2	4082	4430	348	renamed_GCF_000008685.2	cp26	4083	4431	348	100.0	1.075e-71
B331P	contig_2	4767	5865	1098	renamed_GCF_000008685.2	cp26	4768	5866	1098	98.6	1.326e-245
B331P	contig_2	6676	7714	1038	renamed_GCF_000008685.2	cp26	6676	7714	1038	99.7	1.895e-231
B331P	contig_3	2579	3347	768	renamed_GCF_000008685.2	cp32-4	2579	3347	768	98.8	3.969e-169
B331P	contig_3	6164	6731	567	renamed_GCF_000008685.2	cp32-9	6169	6736	567	98.9	1.159e-123
B331P	contig_3	7838	8267	429	renamed_GCF_000008685.2	cp32-6	7837	8266	429	100.0	5.601e-92
B331P	contig_3	24680	25106	426	renamed_GCF_000008685.2	lp56	28298	28724	426	99.2	9.782e-94
B331P	contig_3	26336	27359	1023	renamed_GCF_000008685.2	lp56	29936	30974	1023	98.2	1.552e-222
B331P	contig_4	28823	30176	1353	renamed_GCF_000008685.2	cp32-8	29532	30885	1353	99.3	3.386e-304
B331P	contig_5	65	1289	1224	renamed_GCF_000008685.2	cp32-6	65	1289	1224	99.7	4.655e-270
B331P	contig_5	8731	8968	237	renamed_GCF_000008685.2	cp32-6	8733	8970	237	100.0	7.893e-49
B331P	contig_5	10959	11910	951	renamed_GCF_000008685.2	cp32-6	10961	11912	951	100.0	4.333e-216
B331P	contig_5	11927	12473	546	renamed_GCF_000008685.2	cp32-8	11919	12465	546	97.7	4.358e-114
B331P	contig_5	12831	13710	879	renamed_GCF_000008685.2	cp32-3	12823	13699	879	98.9	3.497e-189
B331P	contig_5	20971	21712	741	renamed_GCF_000008685.2	cp32-8	20739	21480	741	99.5	5.003e-162
B331P	contig_5	26001	25224	777	renamed_GCF_000008685.2	cp32-3	26276	25499	777	99.6	6.988e-173
B331P	contig_5	27267	27795	528	renamed_GCF_000008685.2	cp32-4	27675	28203	528	89.7	7.744e-105
B331P	contig_7	3993	4197	204	renamed_GCF_000008685.2	cp32-7	15221	15425	204	100.0	2.578e-39
B331P	contig_7	14951	15713	762	renamed_GCF_000008685.2	cp32-6	26256	27015	762	60.3	3.674e-91
B331P	contig_8	10273	10870	597	renamed_GCF_000008685.2	cp32-4	10295	10892	597	97.9	1.16e-128
B331P	contig_8	12426	12759	333	renamed_GCF_000008685.2	cp32-8	12494	12827	333	100.0	8.424e-72
B331P	contig_9	15778	16114	336	renamed_GCF_000008685.2	lp56	19256	19592	336	100.0	5.348e-69
B331P	contig_9	17080	16597	483	renamed_GCF_000008685.2	cp32-6	17075	16592	483	99.3	2.502e-101
B331P	contig_9	27378	27990	612	renamed_GCF_000008685.2	cp32-9	28025	28544	612	50.8	3.124e-51
B331P	contig_10	161	1289	1128	renamed_GCF_000008685.2	cp9	162	1272	1128	93.7	1.99e-237
B331P	contig_10	1901	2462	561	renamed_GCF_000008685.2	cp9	1891	2452	561	97.8	6.938e-120
B331P	contig_10	4390	3865	525	renamed_GCF_000008685.2	cp9	4377	3852	525	100.0	1.87e-111
B331P	contig_11	8437	8143	294	renamed_GCF_000008685.2	lp17	9980	9590	294	95.8	1.334e-60
B331P	contig_11	10196	9533	663	renamed_GCF_000008685.2	lp17	11646	10983	663	99.0	2.455e-148
B331P	contig_11	12766	13036	270	renamed_GCF_000008685.2	lp17	14069	14339	270	98.8	7.394e-55
B331P	contig_15	14574	15408	834	renamed_GCF_000008685.2	lp28-2	14341	13507	834	99.2	1.36e-183
B331P	contig_15	15774	16167	393	renamed_GCF_000008685.2	lp28-2	13141	12748	393	99.2	3.389e-83
B331P	contig_15	16596	17415	819	renamed_GCF_000008685.2	lp28-2	12319	11500	819	100.0	1.075e-183
B331P	contig_15	17424	17853	429	renamed_GCF_000008685.2	lp28-2	11491	11062	429	99.2	1.514e-89
B331P	contig_16	4043	4319	276	renamed_GCF_000008685.2	lp36	6365	6650	276	100.0	1.214e-58
B331P	contig_18	4459	5251	792	renamed_GCF_000008685.2	lp54	48267	47475	792	99.2	2.37e-170
B331P	contig_18	7834	9070	1236	renamed_GCF_000008685.2	lp54	45947	44711	1236	99.2	1.642e-266
B331P	contig_18	18806	17960	846	renamed_GCF_000008685.2	lp54	34987	35833	846	99.6	2.758e-186
B331P	contig_18	21533	21044	489	renamed_GCF_000008685.2	lp54	32260	32749	489	100.0	3.125e-108
B331P	contig_18	22014	21591	423	renamed_GCF_000008685.2	lp54	31779	32202	423	100.0	5.086e-92
B331P	contig_18	23084	22013	1071	renamed_GCF_000008685.2	lp54	30709	31780	1071	99.1	1.186e-233
B331P	contig_18	23700	23160	540	renamed_GCF_000008685.2	lp54	30093	30633	540	100.0	4.969e-120
B331P	contig_18	48615	49089	474	renamed_GCF_000008685.2	lp54	5140	4666	474	96.1	3.509e-96
B331P	contig_19	5617	5992	375	renamed_GCF_000008685.2	lp28-2	24108	23721	375	89.0	9.084e-70
B331P	contig_19	5988	6681	693	renamed_GCF_000008685.2	lp28-2	23725	23032	693	98.2	2.461e-153
B331P	contig_19	6680	7055	375	renamed_GCF_000008685.2	lp28-2	23033	22658	375	98.3	1.016e-76
B331P	contig_19	7054	7441	387	renamed_GCF_000008685.2	lp28-2	22659	22272	387	96.0	6.848e-83
B331P	contig_19	7403	10094	2691	renamed_GCF_000008685.2	lp28-2	22259	19619	2691	97.6	0.0
B331P	contig_19	10886	11666	780	renamed_GCF_000008685.2	lp28-2	18827	18029	780	73.6	3.134e-122
B331P	contig_19	11676	12015	339	renamed_GCF_000008685.2	lp28-2	18019	17680	339	100.0	5.085e-70
B331P	contig_1	308	677	369	renamed_GCF_000008685.2	chromosome	104	677	369	99.1	6.868e-80
B331P	contig_1	7425	6336	1089	renamed_GCF_000008685.2	chromosome	7397	6308	1089	100.0	1.828e-240
B331P	contig_1	8454	9225	771	renamed_GCF_000008685.2	chromosome	8426	9197	771	100.0	1.781e-161
B331P	contig_1	10230	10605	375	renamed_GCF_000008685.2	chromosome	10202	10577	375	99.1	8.349e-79
B331P	contig_1	22609	22015	594	renamed_GCF_000008685.2	chromosome	22739	22145	594	99.4	7.271e-125
B331P	contig_1	24566	23834	732	renamed_GCF_000008685.2	chromosome	24696	23964	732	100.0	2.844e-158
B331P	contig_1	25622	26261	639	renamed_GCF_000008685.2	chromosome	25752	26391	639	99.0	5.986e-143
B331P	contig_1	27735	27303	432	renamed_GCF_000008685.2	chromosome	27865	27433	432	100.0	2.641e-92
B331P	contig_1	29342	28361	981	renamed_GCF_000008685.2	chromosome	29472	28491	981	100.0	8.047e-223
B331P	contig_1	30899	31358	459	renamed_GCF_000008685.2	chromosome	31026	31479	459	99.3	5.582e-97
B331P	contig_1	116683	115381	1302	renamed_GCF_000008685.2	chromosome	116806	115504	1302	98.1	2.563e-281
B331P	contig_1	118806	118251	555	renamed_GCF_000008685.2	chromosome	118929	118374	555	99.4	3.776e-117
B331P	contig_1	120466	119683	783	renamed_GCF_000008685.2	chromosome	120589	119806	783	99.6	5.024e-169
B331P	contig_1	133718	132347	1371	renamed_GCF_000008685.2	chromosome	133842	132471	1371	100.0	2.422e-302
B331P	contig_1	137642	135749	1893	renamed_GCF_000008685.2	chromosome	137766	135873	1893	99.8	0.0
B331P	contig_1	142813	141859	954	renamed_GCF_000008685.2	chromosome	142932	141978	954	99.3	1.665e-201
B331P	contig_1	144187	144478	291	renamed_GCF_000008685.2	chromosome	144306	144597	291	95.8	6.971e-59
B331P	contig_1	146251	145351	900	renamed_GCF_000008685.2	chromosome	146370	145470	900	100.0	6.779e-194
B331P	contig_1	159248	159923	675	renamed_GCF_000008685.2	chromosome	159367	160042	675	98.2	2.35e-142
B331P	contig_1	162682	161080	1602	renamed_GCF_000008685.2	chromosome	162801	161199	1602	100.0	0.0
B331P	contig_1	164701	162952	1749	renamed_GCF_000008685.2	chromosome	164820	163071	1749	99.4	0.0
B331P	contig_1	167640	165795	1845	renamed_GCF_000008685.2	chromosome	167759	165914	1845	99.5	0.0
B331P	contig_1	169419	170589	1170	renamed_GCF_000008685.2	chromosome	169562	170708	1170	99.7	6.062e-258
B331P	contig_1	182683	181288	1395	renamed_GCF_000008685.2	chromosome	182802	181407	1395	100.0	4.219e-300
B331P	contig_1	186434	186827	393	renamed_GCF_000008685.2	chromosome	186553	186946	393	100.0	5.626e-86
B331P	contig_1	187712	187058	654	renamed_GCF_000008685.2	chromosome	187831	187177	654	100.0	1.397e-144
B331P	contig_1	188375	188114	261	renamed_GCF_000008685.2	chromosome	188494	188233	261	100.0	7.054e-54
B331P	contig_1	263769	261348	2421	renamed_GCF_000008685.2	chromosome	263712	261291	2421	99.8	0.0
B331P	contig_1	266163	267108	945	renamed_GCF_000008685.2	chromosome	266106	267051	945	100.0	6.277e-211
B331P	contig_1	272737	270544	2193	renamed_GCF_000008685.2	chromosome	272641	270487	2193	99.7	0.0
B331P	contig_1	286016	283925	2091	renamed_GCF_000008685.2	chromosome	285962	283868	2091	99.7	0.0
B331P	contig_1	287934	287145	789	renamed_GCF_000008685.2	chromosome	287877	287088	789	99.6	4.349e-163
B331P	contig_1	289003	288238	765	renamed_GCF_000008685.2	chromosome	288946	288181	765	99.6	5.507e-165
B331P	contig_1	289974	289632	342	renamed_GCF_000008685.2	chromosome	289917	289575	342	100.0	1.077e-70
B331P	contig_1	291652	291115	537	renamed_GCF_000008685.2	chromosome	291595	291058	537	99.4	3.778e-114
B331P	contig_1	302546	300836	1710	renamed_GCF_000008685.2	chromosome	302489	300779	1710	99.8	0.0
B331P	contig_1	303366	302907	459	renamed_GCF_000008685.2	chromosome	303309	302850	459	100.0	4.601e-99
B331P	contig_1	305177	303830	1347	renamed_GCF_000008685.2	chromosome	305120	303773	1347	100.0	1.016e-290
B331P	contig_1	306674	305726	948	renamed_GCF_000008685.2	chromosome	306615	305670	948	99.0	9.536e-207
B331P	contig_1	308573	307373	1200	renamed_GCF_000008685.2	chromosome	308517	307317	1200	99.7	1.629e-260
B331P	contig_1	319173	318333	840	renamed_GCF_000008685.2	chromosome	319116	318276	840	99.6	1.977e-180
B331P	contig_1	320315	319736	579	renamed_GCF_000008685.2	chromosome	320249	319679	579	99.4	6.936e-123
B331P	contig_1	321408	322095	687	renamed_GCF_000008685.2	chromosome	321351	322038	687	100.0	1.336e-150
B331P	contig_1	323836	322903	933	renamed_GCF_000008685.2	chromosome	323779	322846	933	98.7	1.093e-202
B331P	contig_1	326345	325292	1053	renamed_GCF_000008685.2	chromosome	326288	325235	1053	99.7	1.991e-233
B331P	contig_1	342397	343270	873	renamed_GCF_000008685.2	chromosome	342334	343207	873	99.6	7.766e-188
B331P	contig_1	345125	346427	1302	renamed_GCF_000008685.2	chromosome	345062	346364	1302	99.7	2.995e-288
B331P	contig_1	347364	346923	441	renamed_GCF_000008685.2	chromosome	347301	346860	441	99.3	1.88e-97
B331P	contig_1	349673	348215	1458	renamed_GCF_000008685.2	chromosome	349610	348152	1458	98.9	7e-323
B331P	contig_1	351394	351118	276	renamed_GCF_000008685.2	chromosome	351331	351055	276	94.5	2.228e-52
B331P	contig_1	365669	365180	489	renamed_GCF_000008685.2	chromosome	365603	365114	489	100.0	3.787e-106
B331P	contig_1	368521	368947	426	renamed_GCF_000008685.2	chromosome	368455	368881	426	98.5	9.562e-86
B331P	contig_1	370092	371079	987	renamed_GCF_000008685.2	chromosome	370026	371013	987	99.3	3.978e-223
B331P	contig_1	373205	373586	381	renamed_GCF_000008685.2	chromosome	373139	373520	381	100.0	1.683e-80
B331P	contig_1	374342	375719	1377	renamed_GCF_000008685.2	chromosome	374276	375653	1377	98.9	7.568e-308
B331P	contig_1	377085	376026	1059	renamed_GCF_000008685.2	chromosome	377019	375960	1059	98.2	7.708e-228
B331P	contig_1	380624	379406	1218	renamed_GCF_000008685.2	chromosome	380558	379340	1218	98.5	5.097e-268
B331P	contig_1	383448	381975	1473	renamed_GCF_000008685.2	chromosome	383382	381909	1473	99.7	0.0
B331P	contig_1	384352	385492	1140	renamed_GCF_000008685.2	chromosome	384286	385426	1140	100.0	7.242e-251
B331P	contig_1	397145	396671	474	renamed_GCF_000008685.2	chromosome	397077	396603	474	99.3	4.822e-101
B331P	contig_1	401745	397611	4134	renamed_GCF_000008685.2	chromosome	401677	397543	4134	99.7	0.0
B331P	contig_1	625028	626282	1254	renamed_GCF_000008685.2	chromosome	625006	626260	1254	99.7	4.276e-276
B331P	contig_1	626307	627060	753	renamed_GCF_000008685.2	chromosome	626285	627038	753	100.0	9.23e-166
B331P	contig_1	628973	627113	1860	renamed_GCF_000008685.2	chromosome	628948	627091	1860	99.5	0.0
B331P	contig_1	769479	768087	1392	renamed_GCF_000008685.2	chromosome	769470	768078	1392	100.0	1.696e-292
B331P	contig_1	771147	769554	1593	renamed_GCF_000008685.2	chromosome	771139	769546	1593	100.0	0.0
B331P	contig_1	771571	771169	402	renamed_GCF_000008685.2	chromosome	771563	771161	402	100.0	3.917e-83
B331P	contig_1	774415	771577	2838	renamed_GCF_000008685.2	chromosome	774368	771569	2838	98.2	0.0
B331P	contig_1	774723	775509	786	renamed_GCF_000008685.2	chromosome	774676	775462	786	100.0	1.17e-168
B331P	contig_1	776726	775712	1014	renamed_GCF_000008685.2	chromosome	776679	775665	1014	99.7	8.011e-220
B331P	contig_1	776831	777620	789	renamed_GCF_000008685.2	chromosome	776784	777573	789	99.2	2.06e-171
B331P	contig_1	777811	778801	990	renamed_GCF_000008685.2	chromosome	777764	778754	990	99.0	3.8e-224
B331P	contig_1	778804	781432	2628	renamed_GCF_000008685.2	chromosome	778757	781385	2628	99.2	0.0
B331P	contig_1	794884	793870	1014	renamed_GCF_000008685.2	chromosome	794855	793841	1014	99.4	9.31e-227
B331P	contig_1	798077	797147	930	renamed_GCF_000008685.2	chromosome	798048	797118	930	100.0	3.063e-199
B331P	contig_1	799045	798085	960	renamed_GCF_000008685.2	chromosome	799016	798056	960	99.6	2.967e-213
B331P	contig_1	800304	799236	1068	renamed_GCF_000008685.2	chromosome	800275	799207	1068	99.4	4.094e-245
B331P	contig_1	800504	801101	597	renamed_GCF_000008685.2	chromosome	800475	801072	597	99.4	1.402e-126
B331P	contig_1	801039	801807	768	renamed_GCF_000008685.2	chromosome	801118	801778	768	98.6	2.676e-139
B331P	contig_1	802828	801970	858	renamed_GCF_000008685.2	chromosome	802798	801940	858	99.6	1.709e-176
B331P	contig_1	803197	802867	330	renamed_GCF_000008685.2	chromosome	803167	802837	330	100.0	2.178e-69
B331P	contig_1	868142	867770	372	renamed_GCF_000008685.2	chromosome	868114	867742	372	99.1	1.771e-78
B331P	contig_1	868222	868768	546	renamed_GCF_000008685.2	chromosome	868194	868740	546	99.4	4.105e-123
B331P	contig_1	888210	886497	1713	renamed_GCF_000008685.2	chromosome	888179	886469	1713	99.2	0.0
B331P	contig_1	890352	893205	2853	renamed_GCF_000008685.2	chromosome	890321	893174	2853	99.7	0.0
B331P	contig_1	893159	896600	3441	renamed_GCF_000008685.2	chromosome	893128	896569	3441	98.1	0.0
B331P	contig_1	897155	896609	546	renamed_GCF_000008685.2	chromosome	897127	896578	546	98.8	1.619e-116
B331P	contig_1	897723	897123	600	renamed_GCF_000008685.2	chromosome	897695	897095	600	99.4	6.881e-135
B331P	contig_1	899348	897731	1617	renamed_GCF_000008685.2	chromosome	899320	897703	1617	99.0	0.0
B331P	contig_1	899526	900759	1233	renamed_GCF_000008685.2	chromosome	899498	900731	1233	98.5	1.085e-270
B331P	contig_2	19329	17973	1356	renamed_GCF_000008685.2	cp26	19321	17965	1356	99.3	2.16e-292
B331P	contig_2	20794	19438	1356	renamed_GCF_000008685.2	cp26	20786	19430	1356	98.6	2.367e-291
B331P	contig_2	21372	20865	507	renamed_GCF_000008685.2	cp26	21364	20857	507	100.0	3.123e-111
B331P	contig_2	21832	21346	486	renamed_GCF_000008685.2	cp26	21833	21338	486	99.3	1.623e-106
B331P	contig_2	21905	22601	696	renamed_GCF_000008685.2	cp26	21897	22593	696	99.1	3.423e-150
B331P	contig_2	23162	22610	552	renamed_GCF_000008685.2	cp26	23154	22602	552	99.4	2.975e-119
B331P	contig_2	23262	24507	1245	renamed_GCF_000008685.2	cp26	23254	24499	1245	99.2	5.716e-280
B331P	contig_2	24832	26461	1629	renamed_GCF_000008685.2	cp26	24824	26453	1629	100.0	0.0
B331P	contig_3	65	1289	1224	renamed_GCF_000008685.2	cp32-4	65	1289	1224	99.5	2.298e-269
B331P	contig_3	15168	15372	204	renamed_GCF_000008685.2	lp56	18712	18916	204	100.0	2.578e-39
B331P	contig_3	15375	15723	348	renamed_GCF_000008685.2	cp32-8	15421	15769	348	100.0	8.822e-74
B331P	contig_3	15712	16048	336	renamed_GCF_000008685.2	cp32-8	15758	16094	336	100.0	5.348e-69
B331P	contig_3	16855	17281	426	renamed_GCF_000008685.2	cp32-1	17231	17678	426	77.5	4.533e-69
B331P	contig_3	17302	17917	615	renamed_GCF_000008685.2	lp56	20843	21455	615	74.2	5.286e-98
B331P	contig_4	7837	8266	429	renamed_GCF_000008685.2	cp32-1	7827	8256	429	100.0	5.601e-92
B331P	contig_4	15436	15784	348	renamed_GCF_000008685.2	cp32-1	15421	15769	348	99.1	4.373e-73
B331P	contig_4	15773	16109	336	renamed_GCF_000008685.2	cp32-1	15758	16094	336	94.5	3.572e-65
B331P	contig_4	16559	17222	663	renamed_GCF_000008685.2	lp56	20042	20738	663	86.5	5.234e-123
B331P	contig_4	17327	17765	438	renamed_GCF_000008685.2	cp32-9	17301	17730	438	80.2	1.667e-73
B331P	contig_4	19122	20223	1101	renamed_GCF_000008685.2	cp32-3	19604	20705	1101	96.7	1.671e-243
B331P	contig_5	19322	20420	1098	renamed_GCF_000008685.2	lp56	22868	23966	1098	97.2	1.749e-242
B331P	contig_5	20429	20996	567	renamed_GCF_000008685.2	cp32-1	20223	20790	567	100.0	2.944e-130
B331P	contig_6	65	1289	1224	renamed_GCF_000008685.2	cp32-1	65	1289	1224	99.7	4.655e-270
B331P	contig_6	3370	3946	576	renamed_GCF_000008685.2	lp56	6835	7411	576	97.9	2.459e-125
B331P	contig_8	5776	6166	390	renamed_GCF_000008685.2	cp32-1	5767	6157	390	100.0	3.229e-83
B331P	contig_18	17526	17259	267	renamed_GCF_000008685.2	lp54	36255	36534	267	98.8	1.568e-54
B331P	contig_18	17840	17564	276	renamed_GCF_000008685.2	lp54	35953	36229	276	100.0	3.31e-56
B331P	contig_18	24859	24406	453	renamed_GCF_000008685.2	lp54	28934	29387	453	100.0	2.51e-96
B331P	contig_18	25780	24862	918	renamed_GCF_000008685.2	lp54	28013	28931	918	100.0	2.109e-201
B331P	contig_18	28331	27089	1242	renamed_GCF_000008685.2	lp54	25467	26694	1242	100.0	1.5e-268
B331P	contig_18	30001	29368	633	renamed_GCF_000008685.2	lp54	23776	24415	633	96.6	1.694e-130
B331P	contig_18	32688	32148	540	renamed_GCF_000008685.2	lp54	21086	21626	540	98.3	9.697e-113
B331P	contig_18	35005	33652	1353	renamed_GCF_000008685.2	lp54	18724	20077	1353	99.7	7.521e-304
B331P	contig_18	36470	37034	564	renamed_GCF_000008685.2	lp54	17259	16695	564	100.0	1.065e-115
B331P	contig_18	38369	37937	432	renamed_GCF_000008685.2	lp54	15369	15801	432	97.9	1.974e-95
B331P	contig_18	40184	39431	753	renamed_GCF_000008685.2	lp54	13554	14307	753	100.0	4.561e-165
B331P	contig_18	49498	50752	1254	renamed_GCF_000008685.2	lp54	4256	3002	1254	99.7	7.21e-279
B331P	contig_18	52295	51785	510	renamed_GCF_000008685.2	lp54	1460	1970	510	99.4	4.368e-108
B331P	contig_19	197	962	765	renamed_GCF_000008685.2	lp28-2	29618	28853	765	99.2	4.158e-168
B331P	contig_19	2616	1788	828	renamed_GCF_000008685.2	lp28-2	27112	27940	828	97.4	1.07e-176
B331P	contig_1	69443	70004	561	renamed_GCF_000008685.2	chromosome	69565	70126	561	100.0	3.775e-118
B331P	contig_1	81281	82817	1536	renamed_GCF_000008685.2	chromosome	81404	82940	1536	100.0	0.0
B331P	contig_1	85597	83917	1680	renamed_GCF_000008685.2	chromosome	85720	84040	1680	100.0	0.0
B331P	contig_1	87237	86802	435	renamed_GCF_000008685.2	chromosome	87360	86925	435	100.0	2.772e-92
B331P	contig_1	89685	89076	609	renamed_GCF_000008685.2	chromosome	89808	89199	609	100.0	1.275e-129
B331P	contig_1	93910	93310	600	renamed_GCF_000008685.2	chromosome	94032	93432	600	99.4	7.27e-126
B331P	contig_1	96831	94488	2343	renamed_GCF_000008685.2	chromosome	96953	94610	2343	98.8	0.0
B331P	contig_1	98658	97740	918	renamed_GCF_000008685.2	chromosome	98648	97862	918	99.6	5.205e-174
B331P	contig_1	157507	157942	435	renamed_GCF_000008685.2	chromosome	157626	158061	435	99.3	1.372e-91
B331P	contig_1	170978	170600	378	renamed_GCF_000008685.2	chromosome	171097	170719	378	98.4	1.768e-79
B331P	contig_1	173461	171412	2049	renamed_GCF_000008685.2	chromosome	173535	171531	2049	99.2	0.0
B331P	contig_1	174965	173978	987	renamed_GCF_000008685.2	chromosome	174970	174097	987	99.3	1.865e-188
B331P	contig_1	176855	175949	906	renamed_GCF_000008685.2	chromosome	176974	176068	906	100.0	1.374e-195
B331P	contig_1	178741	177748	993	renamed_GCF_000008685.2	chromosome	178860	177867	993	99.3	4.967e-213
B331P	contig_1	189740	189179	561	renamed_GCF_000008685.2	chromosome	189859	189298	561	100.0	1.275e-121
B331P	contig_1	190599	191340	741	renamed_GCF_000008685.2	chromosome	190718	191459	741	100.0	7.281e-158
B331P	contig_1	193344	192204	1140	renamed_GCF_000008685.2	chromosome	193463	192323	1140	99.2	4.567e-256
B331P	contig_1	231550	230272	1278	renamed_GCF_000008685.2	chromosome	231491	230213	1278	99.5	1.017e-287
B331P	contig_1	232396	235312	2916	renamed_GCF_000008685.2	chromosome	232337	235253	2916	99.4	0.0
B331P	contig_1	245847	246612	765	renamed_GCF_000008685.2	chromosome	245789	246554	765	100.0	7.663e-170
B331P	contig_1	248584	250147	1563	renamed_GCF_000008685.2	chromosome	248505	250089	1563	99.6	0.0
B331P	contig_1	251269	250714	555	renamed_GCF_000008685.2	chromosome	251211	250656	555	100.0	3.12e-119
B331P	contig_1	252491	253097	606	renamed_GCF_000008685.2	chromosome	252433	253039	606	100.0	4.115e-133
B331P	contig_1	255002	255707	705	renamed_GCF_000008685.2	chromosome	254944	255649	705	99.1	3.943e-150
B331P	contig_1	273910	275293	1383	renamed_GCF_000008685.2	chromosome	273856	275236	1383	99.5	1.314e-302
B331P	contig_1	276614	277121	507	renamed_GCF_000008685.2	chromosome	276671	277064	507	100.0	6.298e-87
B331P	contig_1	279115	278593	522	renamed_GCF_000008685.2	chromosome	279058	278536	522	99.4	8.822e-111
B331P	contig_1	316200	315363	837	renamed_GCF_000008685.2	chromosome	316143	315306	837	100.0	2.887e-184
B331P	contig_1	318062	317303	759	renamed_GCF_000008685.2	chromosome	318005	317246	759	100.0	1.223e-163
B331P	contig_1	329321	329681	360	renamed_GCF_000008685.2	chromosome	329261	329621	360	100.0	1.609e-77
B331P	contig_1	333658	330862	2796	renamed_GCF_000008685.2	chromosome	333598	330802	2796	100.0	0.0
B331P	contig_1	334996	336568	1572	renamed_GCF_000008685.2	chromosome	334936	336508	1572	100.0	0.0
B331P	contig_1	338417	340043	1626	renamed_GCF_000008685.2	chromosome	338357	339983	1626	99.6	0.0
B331P	contig_1	341336	342386	1050	renamed_GCF_000008685.2	chromosome	341273	342323	1050	99.4	1.633e-226
B331P	contig_1	354702	353502	1200	renamed_GCF_000008685.2	chromosome	354636	353439	1200	98.9	1.486e-261
B331P	contig_1	355556	356975	1419	renamed_GCF_000008685.2	chromosome	355490	356909	1419	99.7	6.982e-316
B331P	contig_1	358523	359264	741	renamed_GCF_000008685.2	chromosome	358457	359198	741	99.1	2.251e-162
B331P	contig_1	415861	414394	1467	renamed_GCF_000008685.2	chromosome	415793	414326	1467	99.7	0.0
B331P	contig_1	416756	417173	417	renamed_GCF_000008685.2	chromosome	416688	417105	417	99.2	1.376e-88
B331P	contig_1	428056	428692	636	renamed_GCF_000008685.2	chromosome	427986	428622	636	99.5	1.686e-139
B331P	contig_1	430686	429762	924	renamed_GCF_000008685.2	chromosome	430616	429692	924	100.0	4.275e-203
B331P	contig_1	442625	441785	840	renamed_GCF_000008685.2	chromosome	442552	441712	840	98.9	7.382e-183
B331P	contig_1	446952	446403	549	renamed_GCF_000008685.2	chromosome	446875	446326	549	99.4	4.738e-122
B331P	contig_1	447932	448250	318	renamed_GCF_000008685.2	chromosome	447854	448172	318	100.0	8.883e-69
B331P	contig_1	460129	460489	360	renamed_GCF_000008685.2	chromosome	460051	460411	360	99.1	5.311e-73
B331P	contig_1	462122	462851	729	renamed_GCF_000008685.2	chromosome	462044	462773	729	99.1	5.489e-159
B331P	contig_1	464130	465210	1080	renamed_GCF_000008685.2	chromosome	464052	465132	1080	100.0	9.122e-247
B331P	contig_1	501569	501938	369	renamed_GCF_000008685.2	chromosome	501496	501865	369	99.1	4.571e-76
B331P	contig_1	502263	502812	549	renamed_GCF_000008685.2	chromosome	502190	502739	549	100.0	1.698e-116
B331P	contig_1	507886	508921	1035	renamed_GCF_000008685.2	chromosome	507813	508848	1035	99.7	1.013e-220
B331P	contig_1	509386	510919	1533	renamed_GCF_000008685.2	chromosome	509313	510846	1533	100.0	0.0
B331P	contig_1	513212	512465	747	renamed_GCF_000008685.2	chromosome	513139	512392	747	100.0	7.284e-159
B331P	contig_1	514596	515856	1260	renamed_GCF_000008685.2	chromosome	514523	515783	1260	100.0	5.48e-283
B331P	contig_1	535669	535246	423	renamed_GCF_000008685.2	chromosome	535600	535177	423	99.2	2.776e-90
B331P	contig_1	537588	538377	789	renamed_GCF_000008685.2	chromosome	537543	538308	789	99.2	6.654e-167
B331P	contig_1	585113	586178	1065	renamed_GCF_000008685.2	chromosome	585079	586156	1065	97.4	4.863e-234
B331P	contig_1	587052	587904	852	renamed_GCF_000008685.2	chromosome	587030	587882	852	98.5	4.638e-190
B331P	contig_1	604791	603747	1044	renamed_GCF_000008685.2	chromosome	604769	603725	1044	100.0	3.194e-235
B331P	contig_1	607159	607957	798	renamed_GCF_000008685.2	chromosome	607137	607935	798	99.6	4.801e-172
B331P	contig_1	611215	609964	1251	renamed_GCF_000008685.2	chromosome	611193	609942	1251	99.7	7.081e-270
B331P	contig_1	612069	614007	1938	renamed_GCF_000008685.2	chromosome	612047	613985	1938	99.6	0.0
B331P	contig_1	616412	615785	627	renamed_GCF_000008685.2	chromosome	616390	615763	627	99.0	6.305e-132
B331P	contig_1	632509	634489	1980	renamed_GCF_000008685.2	chromosome	632484	634464	1980	99.0	0.0
B331P	contig_1	636616	637981	1365	renamed_GCF_000008685.2	chromosome	636592	637957	1365	99.1	3.824e-296
B331P	contig_1	638603	639896	1293	renamed_GCF_000008685.2	chromosome	638579	639872	1293	99.3	3.43e-285
B331P	contig_1	693566	694709	1143	renamed_GCF_000008685.2	chromosome	693553	694696	1143	100.0	3.979e-258
B331P	contig_1	695644	696778	1134	renamed_GCF_000008685.2	chromosome	695630	696764	1134	99.2	7.681e-258
B331P	contig_1	705587	706613	1026	renamed_GCF_000008685.2	chromosome	705579	706605	1026	100.0	2.737e-225
B331P	contig_1	709281	710682	1401	renamed_GCF_000008685.2	chromosome	709273	710674	1401	99.7	9.148e-310
B331P	contig_1	711218	711659	441	renamed_GCF_000008685.2	chromosome	711210	711651	441	100.0	1.245e-93
B331P	contig_1	713258	712211	1047	renamed_GCF_000008685.2	chromosome	713250	712203	1047	99.7	8.437e-225
B331P	contig_1	714774	714111	663	renamed_GCF_000008685.2	chromosome	714766	714103	663	99.0	3.258e-145
B331P	contig_1	729620	730514	894	renamed_GCF_000008685.2	chromosome	729612	730506	894	99.6	1.25e-194
B331P	contig_1	731191	731728	537	renamed_GCF_000008685.2	chromosome	731183	731720	537	100.0	1.936e-121
B331P	contig_1	734088	735297	1209	renamed_GCF_000008685.2	chromosome	734080	735289	1209	99.7	1.819e-269
B331P	contig_1	811539	810498	1041	renamed_GCF_000008685.2	chromosome	811510	810469	1041	99.7	3.047e-235
B331P	contig_1	813268	812467	801	renamed_GCF_000008685.2	chromosome	813239	812438	801	100.0	9.279e-174
B331P	contig_1	814754	813746	1008	renamed_GCF_000008685.2	chromosome	814697	813689	1008	99.4	2.823e-213
B331P	contig_1	822866	823160	294	renamed_GCF_000008685.2	chromosome	822809	823103	294	100.0	1.207e-61
B331P	contig_1	823872	824439	567	renamed_GCF_000008685.2	chromosome	823815	824382	567	99.4	6.307e-122
B331P	contig_1	825757	827677	1920	renamed_GCF_000008685.2	chromosome	825700	827620	1920	99.6	0.0
B331P	contig_1	829274	830378	1104	renamed_GCF_000008685.2	chromosome	829217	830321	1104	99.4	2.452e-248
B331P	contig_1	847517	848366	849	renamed_GCF_000008685.2	chromosome	847490	848339	849	98.5	1.721e-183
B331P	contig_1	848564	848831	267	renamed_GCF_000008685.2	chromosome	848537	848804	267	100.0	3.495e-54
B331P	contig_1	851020	852541	1521	renamed_GCF_000008685.2	chromosome	850993	852514	1521	99.6	0.0
B331P	contig_2	4438	4756	318	renamed_GCF_000008685.2	cp26	4481	4757	318	100.0	7.253e-55
B331P	contig_2	7835	8765	930	renamed_GCF_000008685.2	cp26	7835	8765	930	98.7	4.695e-203
B331P	contig_3	3973	4933	960	renamed_GCF_000008685.2	cp32-4	3972	4932	960	100.0	6.008e-214
B331P	contig_3	6711	7824	1113	renamed_GCF_000008685.2	cp32-4	6710	7823	1113	99.1	1.675e-245
B331P	contig_3	8282	8738	456	renamed_GCF_000008685.2	cp32-7	8273	8729	456	98.0	2.171e-98
B331P	contig_3	22306	22810	504	renamed_GCF_000008685.2	lp56	25889	26426	504	93.2	1.178e-104
B331P	contig_3	25906	25111	795	renamed_GCF_000008685.2	cp32-4	25435	24640	795	98.1	8.445e-174
B331P	contig_3	27522	28095	573	renamed_GCF_000008685.2	lp56	31167	31710	573	98.8	1.35e-114
B331P	contig_4	1308	2001	693	renamed_GCF_000008685.2	cp32-6	1305	1998	693	100.0	1.162e-144
B331P	contig_4	8733	8970	237	renamed_GCF_000008685.2	cp32-4	8733	8970	237	100.0	1.76e-48
B331P	contig_4	11928	12474	546	renamed_GCF_000008685.2	cp32-7	11927	12473	546	97.7	4.794e-113
B331P	contig_4	12832	13708	876	renamed_GCF_000008685.2	cp32-8	12823	13699	876	98.6	3.337e-189
B331P	contig_4	14332	15154	822	renamed_GCF_000008685.2	lp56	17822	18638	822	75.4	6.292e-130
B331P	contig_4	25785	25008	777	renamed_GCF_000008685.2	lp56	29506	28729	777	97.2	1.016e-168
B331P	contig_4	28260	28827	567	renamed_GCF_000008685.2	cp32-8	28969	29536	567	93.6	6.073e-114
B331P	contig_5	7835	8264	429	renamed_GCF_000008685.2	cp32-4	7837	8266	429	100.0	5.601e-92
B331P	contig_5	10272	10956	684	renamed_GCF_000008685.2	cp32-8	10264	10948	684	99.5	1.538e-148
B331P	contig_5	12502	12835	333	renamed_GCF_000008685.2	cp32-3	12494	12827	333	100.0	8.424e-72
B331P	contig_8	8976	10251	1275	renamed_GCF_000008685.2	cp32-6	8977	10252	1275	96.9	5.067e-269
B331P	contig_9	15234	15438	204	renamed_GCF_000008685.2	cp32-3	15211	15415	204	100.0	2.578e-39
B331P	contig_9	16106	16460	354	renamed_GCF_000008685.2	cp32-1	16086	16440	354	98.2	1.61e-76
B331P	contig_10	1298	1850	552	renamed_GCF_000008685.2	cp9	1281	1839	552	58.3	4.732e-72
B331P	contig_10	2816	3725	909	renamed_GCF_000008685.2	cp9	2803	3712	909	99.3	8.699e-210
B331P	contig_14	21860	20861	999	renamed_GCF_000008685.2	lp28-1	466	1465	999	99.6	3.433e-218
B331P	contig_16	11907	11157	750	renamed_GCF_000008685.2	lp36	14326	13576	750	99.5	5.248e-163
B331P	contig_16	12422	11882	540	renamed_GCF_000008685.2	lp36	14841	14301	540	100.0	2.234e-120
B331P	contig_16	25033	24661	372	renamed_GCF_000008685.2	lp5	1207	1576	372	81.29	1.564e-63
B331P	contig_17	16606	17416	810	renamed_GCF_000008685.2	lp38	16519	17329	810	98.5	1.97e-175
B331P	contig_17	17474	18257	783	renamed_GCF_000008685.2	lp38	17387	18170	783	99.6	1.707e-172
B331P	contig_17	18300	19341	1041	renamed_GCF_000008685.2	lp38	18213	19254	1041	100.0	2.778e-236
B331P	contig_17	19399	20095	696	renamed_GCF_000008685.2	lp38	19312	20008	696	100.0	6.303e-152
B331P	contig_17	20087	21317	1230	renamed_GCF_000008685.2	lp38	20000	21230	1230	99.7	3.323e-266
B331P	contig_17	22057	23095	1038	renamed_GCF_000008685.2	lp38	22042	23008	1038	99.3	5.745e-219
B331P	contig_17	24838	25897	1059	renamed_GCF_000008685.2	lp38	28053	26994	1059	97.1	2.259e-224
B331P	contig_18	972	174	798	renamed_GCF_000008685.2	lp54	52705	53503	798	98.8	7.342e-176
B331P	contig_18	3600	3825	225	renamed_GCF_000008685.2	lp54	50077	49852	225	98.6	4.854e-44
B331P	contig_1	8343	7485	858	renamed_GCF_000008685.2	chromosome	8315	7457	858	100.0	6.472e-196
B331P	contig_1	9229	10234	1005	renamed_GCF_000008685.2	chromosome	9201	10206	1005	99.7	3.77e-218
B331P	contig_1	21971	20927	1044	renamed_GCF_000008685.2	chromosome	22101	21057	1044	100.0	6.693e-227
B331P	contig_1	22688	23828	1140	renamed_GCF_000008685.2	chromosome	22818	23958	1140	97.6	4.164e-257
B331P	contig_1	25493	24566	927	renamed_GCF_000008685.2	chromosome	25623	24696	927	99.3	2.923e-199
B331P	contig_1	26268	27318	1050	renamed_GCF_000008685.2	chromosome	26398	27448	1050	100.0	7.794e-235
B331P	contig_1	28360	27724	636	renamed_GCF_000008685.2	chromosome	28490	27854	636	99.5	4.12e-138
B331P	contig_1	29412	30894	1482	renamed_GCF_000008685.2	chromosome	29542	31015	1482	98.9	0.0
B331P	contig_1	31968	31428	540	renamed_GCF_000008685.2	chromosome	32089	31549	540	98.8	8.011e-115
B331P	contig_1	75650	76331	681	renamed_GCF_000008685.2	chromosome	75773	76454	681	100.0	3.584e-147
B331P	contig_1	78886	77587	1299	renamed_GCF_000008685.2	chromosome	79009	77710	1299	99.5	4.523e-283
B331P	contig_1	79381	80650	1269	renamed_GCF_000008685.2	chromosome	79504	80773	1269	100.0	1.4e-282
B331P	contig_1	105308	103640	1668	renamed_GCF_000008685.2	chromosome	105299	103763	1668	99.8	0.0
B331P	contig_1	106771	105760	1011	renamed_GCF_000008685.2	chromosome	106894	105883	1011	100.0	4.14e-218
B331P	contig_1	108183	109548	1365	renamed_GCF_000008685.2	chromosome	108306	109671	1365	99.7	2.146e-311
B331P	contig_1	111444	110922	522	renamed_GCF_000008685.2	chromosome	111567	111045	522	100.0	1.783e-111
B331P	contig_1	112214	111764	450	renamed_GCF_000008685.2	chromosome	112338	111888	450	99.3	9.762e-98
B331P	contig_1	114480	112785	1695	renamed_GCF_000008685.2	chromosome	114603	112908	1695	100.0	0.0
B331P	contig_1	165768	164781	987	renamed_GCF_000008685.2	chromosome	165887	164900	987	100.0	2.687e-210
B331P	contig_1	169280	167759	1521	renamed_GCF_000008685.2	chromosome	169399	167878	1521	99.6	0.0
B331P	contig_1	181286	179420	1866	renamed_GCF_000008685.2	chromosome	181405	179539	1866	99.6	0.0
B331P	contig_1	182766	183261	495	renamed_GCF_000008685.2	chromosome	182885	183380	495	100.0	9.271e-106
B331P	contig_1	186829	187075	246	renamed_GCF_000008685.2	chromosome	186948	187194	246	100.0	9.168e-49
B331P	contig_1	188118	187704	414	renamed_GCF_000008685.2	chromosome	188237	187823	414	99.2	2.918e-88
B331P	contig_1	211197	211965	768	renamed_GCF_000008685.2	chromosome	211300	212068	768	100.0	8.822e-169
B331P	contig_1	215485	217318	1833	renamed_GCF_000008685.2	chromosome	215426	217259	1833	100.0	0.0
B331P	contig_1	219137	218483	654	renamed_GCF_000008685.2	chromosome	219078	218424	654	99.0	5.201e-147
B331P	contig_1	267122	267332	210	renamed_GCF_000008685.2	chromosome	267065	267275	210	100.0	4.647e-42
B331P	contig_1	270530	269729	801	renamed_GCF_000008685.2	chromosome	270473	269672	801	99.6	3.29e-168
B331P	contig_1	283922	282755	1167	renamed_GCF_000008685.2	chromosome	283865	282698	1167	100.0	1.172e-258
B331P	contig_1	287146	286027	1119	renamed_GCF_000008685.2	chromosome	287089	285970	1119	99.1	1.197e-241
B331P	contig_1	288230	287966	264	renamed_GCF_000008685.2	chromosome	288173	287909	264	100.0	2.025e-51
B331P	contig_1	289640	289013	627	renamed_GCF_000008685.2	chromosome	289583	288956	627	97.1	4.14e-128
B331P	contig_1	291078	290019	1059	renamed_GCF_000008685.2	chromosome	291021	289962	1059	100.0	3.164e-229
B331P	contig_1	300821	299786	1035	renamed_GCF_000008685.2	chromosome	300764	299729	1035	99.7	3.255e-216
B331P	contig_1	302896	302560	336	renamed_GCF_000008685.2	chromosome	302839	302503	336	99.0	5.906e-68
B331P	contig_1	303797	303389	408	renamed_GCF_000008685.2	chromosome	303740	303332	408	99.2	2.649e-88
B331P	contig_1	351108	349662	1446	renamed_GCF_000008685.2	chromosome	351045	349599	1446	99.3	1.635e-319
B331P	contig_1	365146	364195	951	renamed_GCF_000008685.2	chromosome	364972	364129	951	98.9	6.357e-186
B331P	contig_1	367026	366294	732	renamed_GCF_000008685.2	chromosome	366960	366228	732	98.7	1.279e-158
B331P	contig_1	368950	370093	1143	renamed_GCF_000008685.2	chromosome	368884	370027	1143	99.2	1.738e-241
B331P	contig_1	371099	373112	2013	renamed_GCF_000008685.2	chromosome	371033	373046	2013	98.9	0.0
B331P	contig_1	374217	373632	585	renamed_GCF_000008685.2	chromosome	374151	373566	585	99.4	4.312e-129
B331P	contig_1	375726	376005	279	renamed_GCF_000008685.2	chromosome	375660	375939	279	98.9	3.477e-56
B331P	contig_1	379396	377104	2292	renamed_GCF_000008685.2	chromosome	379258	377038	2292	98.7	0.0
B331P	contig_1	381958	380620	1338	renamed_GCF_000008685.2	chromosome	381892	380554	1338	100.0	1.408e-311
B331P	contig_1	417791	418403	612	renamed_GCF_000008685.2	chromosome	417723	418335	612	98.5	3.744e-135
B331P	contig_1	419574	418455	1119	renamed_GCF_000008685.2	chromosome	419506	418387	1119	100.0	8.015e-255
B331P	contig_1	421448	419570	1878	renamed_GCF_000008685.2	chromosome	421380	419502	1878	99.2	0.0
B331P	contig_1	421621	422251	630	renamed_GCF_000008685.2	chromosome	421553	422183	630	99.5	6.272e-141
B331P	contig_1	423125	423905	780	renamed_GCF_000008685.2	chromosome	423054	423834	780	100.0	3.296e-173
B331P	contig_1	424516	423892	624	renamed_GCF_000008685.2	chromosome	424442	423821	624	99.0	4.527e-135
B331P	contig_1	424763	425621	858	renamed_GCF_000008685.2	chromosome	424693	425551	858	100.0	1.579e-194
B331P	contig_1	425653	426781	1128	renamed_GCF_000008685.2	chromosome	425583	426711	1128	100.0	1.044e-244
B331P	contig_1	448669	448279	390	renamed_GCF_000008685.2	chromosome	448591	448201	390	100.0	7.926e-82
B331P	contig_1	471833	471299	534	renamed_GCF_000008685.2	chromosome	471756	471222	534	98.8	4.361e-112
B331P	contig_1	472552	471847	705	renamed_GCF_000008685.2	chromosome	472358	471770	705	99.4	1.099e-121
B331P	contig_1	472642	473485	843	renamed_GCF_000008685.2	chromosome	472565	473408	843	99.6	2.632e-186
B331P	contig_1	474633	473481	1152	renamed_GCF_000008685.2	chromosome	474556	473404	1152	99.7	3.808e-260
B331P	contig_1	474689	475679	990	renamed_GCF_000008685.2	chromosome	474612	475602	990	99.3	9.601e-214
B331P	contig_1	475682	476288	606	renamed_GCF_000008685.2	chromosome	475605	476211	606	98.5	5.47e-130
B331P	contig_1	478151	476339	1812	renamed_GCF_000008685.2	chromosome	478005	476262	1812	99.8	0.0
B331P	contig_1	479782	481093	1311	renamed_GCF_000008685.2	chromosome	479708	481019	1311	100.0	7.438e-297
B331P	contig_1	489565	489793	228	renamed_GCF_000008685.2	chromosome	489539	489719	228	96.6	3.611e-32
B331P	contig_1	503023	503422	399	renamed_GCF_000008685.2	chromosome	502950	503349	399	100.0	3.071e-85
B331P	contig_1	503438	503981	543	renamed_GCF_000008685.2	chromosome	503365	503908	543	100.0	7.636e-116
B331P	contig_1	503998	504358	360	renamed_GCF_000008685.2	chromosome	503925	504285	360	100.0	4.361e-75
B331P	contig_1	504370	504868	498	renamed_GCF_000008685.2	chromosome	504297	504795	498	100.0	1.785e-107
B331P	contig_1	504871	505177	306	renamed_GCF_000008685.2	chromosome	504798	505104	306	98.0	7.287e-61
B331P	contig_1	505176	505614	438	renamed_GCF_000008685.2	chromosome	505103	505541	438	98.6	5.873e-93
B331P	contig_1	505626	506931	1305	renamed_GCF_000008685.2	chromosome	505553	506858	1305	99.3	2.235e-283
B331P	contig_1	506943	507057	114	renamed_GCF_000008685.2	chromosome	506864	506984	114	100.0	7.638e-22
B331P	contig_1	507074	507452	378	renamed_GCF_000008685.2	chromosome	507001	507379	378	99.2	1.951e-78
B331P	contig_1	516561	523062	6501	renamed_GCF_000008685.2	chromosome	516492	522993	6501	99.3	0.0
B331P	contig_1	548559	547914	645	renamed_GCF_000008685.2	chromosome	548490	547845	645	99.5	2.348e-137
B331P	contig_1	548954	548555	399	renamed_GCF_000008685.2	chromosome	548885	548486	399	99.2	3.385e-84
B331P	contig_1	549687	548988	699	renamed_GCF_000008685.2	chromosome	549618	548919	699	99.5	2.351e-146
B331P	contig_1	551792	549710	2082	renamed_GCF_000008685.2	chromosome	551723	549641	2082	99.8	0.0
B331P	contig_1	553206	553857	651	renamed_GCF_000008685.2	chromosome	553138	553789	651	98.6	1.609e-142
B331P	contig_1	554059	555280	1221	renamed_GCF_000008685.2	chromosome	553991	555212	1221	99.7	2.636e-267
B331P	contig_1	555283	556648	1365	renamed_GCF_000008685.2	chromosome	555215	556580	1365	99.1	1.676e-305
B331P	contig_1	568278	569148	870	renamed_GCF_000008685.2	chromosome	568269	569139	870	99.6	3.86e-195
B331P	contig_1	590369	590957	588	renamed_GCF_000008685.2	chromosome	590347	590935	588	100.0	4.112e-130
B331P	contig_1	591209	592379	1170	renamed_GCF_000008685.2	chromosome	591187	592357	1170	99.7	2.134e-252
B331P	contig_1	592509	595953	3444	renamed_GCF_000008685.2	chromosome	592445	595931	3444	99.2	0.0
B331P	contig_1	595964	596543	579	renamed_GCF_000008685.2	chromosome	595942	596521	579	99.4	1.865e-120
B331P	contig_1	596552	598613	2061	renamed_GCF_000008685.2	chromosome	596530	598591	2061	99.8	0.0
B331P	contig_1	599398	598609	789	renamed_GCF_000008685.2	chromosome	599376	598587	789	99.2	5.285e-178
B331P	contig_1	599516	600866	1350	renamed_GCF_000008685.2	chromosome	599494	600844	1350	100.0	3.989e-293
B331P	contig_1	601031	602366	1335	renamed_GCF_000008685.2	chromosome	601009	602344	1335	99.5	3.464e-292
B331P	contig_1	602395	603751	1356	renamed_GCF_000008685.2	chromosome	602373	603729	1356	99.3	2.526e-299
B331P	contig_1	618581	616433	2148	renamed_GCF_000008685.2	chromosome	618559	616411	2148	99.8	0.0
B331P	contig_6	20724	21291	567	renamed_GCF_000008685.2	lp56	23975	24542	567	98.9	7.201e-129
B331P	contig_6	22072	22618	546	renamed_GCF_000008685.2	cp32-4	21414	21960	546	97.7	3.962e-115
B331P	contig_6	27355	28459	1104	renamed_GCF_000008685.2	cp32-7	26892	27984	1104	95.8	5.802e-230
B331P	contig_7	7651	6703	948	renamed_GCF_000008685.2	cp32-6	18680	17732	948	97.7	2.459e-213
B331P	contig_8	24570	24996	426	renamed_GCF_000008685.2	cp32-7	24512	24938	426	100.0	8.056e-96
B331P	contig_8	25778	25001	777	renamed_GCF_000008685.2	cp32-8	25951	25174	777	95.3	6.054e-166
B331P	contig_8	26208	26781	573	renamed_GCF_000008685.2	cp32-9	26209	26770	573	93.1	1.35e-114
B331P	contig_8	26808	27858	1050	renamed_GCF_000008685.2	cp32-9	26797	27829	1050	97.3	5.755e-221
B331P	contig_9	6713	7826	1113	renamed_GCF_000008685.2	cp32-6	6710	7823	1113	98.6	4.476e-243
B331P	contig_9	22099	22672	573	renamed_GCF_000008685.2	cp32-7	22087	22660	573	100.0	7.629e-121
B331P	contig_9	23149	24475	1326	renamed_GCF_000008685.2	cp32-7	23134	24460	1326	99.0	3.52e-299
B331P	contig_10	4801	4516	285	renamed_GCF_000008685.2	cp9	4788	4503	285	100.0	2.564e-60
B331P	contig_10	6285	7083	798	renamed_GCF_000008685.2	cp9	6973	7771	798	100.0	6.09e-178
B331P	contig_11	243	393	150	renamed_GCF_000008685.2	lp17	211	406	150	100.0	1.293e-22
B331P	contig_12	14277	13203	1074	renamed_GCF_000008685.2	lp25	14530	13402	1074	98.5	1.202e-242
B331P	contig_12	15379	14842	537	renamed_GCF_000008685.2	lp25	15545	15041	537	99.4	7.638e-115
B331P	contig_13	15116	16169	1053	renamed_GCF_000008685.2	lp28-3	16518	17415	1053	82.5	1.135e-187
B331P	contig_13	16161	16728	567	renamed_GCF_000008685.2	lp28-3	17407	17974	567	99.4	9.584e-126
B331P	contig_13	16700	17456	756	renamed_GCF_000008685.2	lp28-3	17946	18702	756	100.0	8.81e-167
B331P	contig_13	17551	18181	630	renamed_GCF_000008685.2	lp28-3	18797	19427	630	100.0	1.007e-135
B331P	contig_13	20224	20974	750	renamed_GCF_000008685.2	lp28-3	21469	22219	750	100.0	6.33e-161
B331P	contig_13	21432	21705	273	renamed_GCF_000008685.2	lp28-3	22677	22953	273	100.0	7.02e-56
B331P	contig_15	11230	12421	1191	renamed_GCF_000008685.2	lp28-2	17684	16493	1191	100.0	6.781e-269
B331P	contig_15	12432	13458	1026	renamed_GCF_000008685.2	lp28-2	16482	15456	1026	99.7	8.508e-230
B331P	contig_17	6120	6894	774	renamed_GCF_000008685.2	lp38	6088	6862	774	98.4	2.47e-158
B331P	contig_17	9160	8944	216	renamed_GCF_000008685.2	lp38	9155	8876	216	97.1	2.077e-43
B331P	contig_17	11193	10605	588	renamed_GCF_000008685.2	lp38	11105	10517	588	97.4	6.613e-125
B331P	contig_17	11978	11240	738	renamed_GCF_000008685.2	lp38	11889	11151	738	96.7	2.59e-160
B331P	contig_17	12541	11950	591	renamed_GCF_000008685.2	lp38	12452	11861	591	94.3	6.306e-126
B331P	contig_17	13523	12533	990	renamed_GCF_000008685.2	lp38	13440	12444	990	93.0	8.256e-207
B331P	contig_17	15307	15508	201	renamed_GCF_000008685.2	lp38	15219	15375	201	100.0	1.426e-29
B331P	contig_17	30847	29980	867	renamed_GCF_000008685.2	lp28-4	25089	24222	867	97.2	2.28e-183
B331P	contig_17	32562	33291	729	renamed_GCF_000008685.2	lp38	23365	24088	729	94.9	3.423e-147
B331P	contig_17	34739	34475	264	renamed_GCF_000008685.2	lp38	34668	34371	264	100.0	8.206e-53
B331P	contig_17	35661	34974	687	renamed_GCF_000008685.2	lp38	35591	34904	687	99.1	1.007e-153
B331P	contig_18	26404	25795	609	renamed_GCF_000008685.2	lp54	27389	27998	609	100.0	2.346e-131
B331P	contig_18	29286	28680	606	renamed_GCF_000008685.2	lp54	24497	25103	606	99.0	1.616e-126
B331P	contig_18	30504	32091	1587	renamed_GCF_000008685.2	lp54	23273	21683	1587	98.8	0.0
B331P	contig_18	33057	32862	195	renamed_GCF_000008685.2	lp54	20717	20912	195	100.0	2.214e-39
B331P	contig_18	35602	35008	594	renamed_GCF_000008685.2	lp54	18127	18721	594	99.4	7.271e-125
B331P	contig_18	37153	37738	585	renamed_GCF_000008685.2	lp54	16576	16000	585	79.2	3.504e-89
B331P	contig_18	39401	38855	546	renamed_GCF_000008685.2	lp54	14337	14883	546	100.0	1.338e-118
B331P	contig_18	40744	40159	585	renamed_GCF_000008685.2	lp54	12994	13579	585	100.0	1.763e-130
B331P	contig_1	12773	14756	1983	renamed_GCF_000008685.2	chromosome	12745	14728	1983	99.6	0.0
B331P	contig_1	15373	14752	621	renamed_GCF_000008685.2	chromosome	15345	14724	621	100.0	3.249e-138
B331P	contig_1	15872	16832	960	renamed_GCF_000008685.2	chromosome	15994	16804	960	99.2	1.19e-171
B331P	contig_1	42361	41320	1041	renamed_GCF_000008685.2	chromosome	42483	41442	1041	99.1	1.075e-229
B331P	contig_1	45232	42784	2448	renamed_GCF_000008685.2	chromosome	45354	42906	2448	99.3	0.0
B331P	contig_1	46257	45888	369	renamed_GCF_000008685.2	chromosome	46379	46010	369	99.1	1.529e-79
B331P	contig_1	47781	48483	702	renamed_GCF_000008685.2	chromosome	47916	48606	702	99.1	1.109e-146
B331P	contig_1	49217	49889	672	renamed_GCF_000008685.2	chromosome	49340	50012	672	100.0	9.591e-152
B331P	contig_1	60408	59910	498	renamed_GCF_000008685.2	chromosome	60533	60035	498	98.7	8.026e-108
B331P	contig_1	94483	94096	387	renamed_GCF_000008685.2	chromosome	94605	94218	387	100.0	1.031e-86
B331P	contig_1	97744	96820	924	renamed_GCF_000008685.2	chromosome	97866	96942	924	99.3	8.657e-204
B331P	contig_1	98693	100082	1389	renamed_GCF_000008685.2	chromosome	98816	100205	1389	99.7	1.066e-314
B331P	contig_1	101216	100622	594	renamed_GCF_000008685.2	chromosome	101339	100745	594	100.0	6.255e-135
B331P	contig_1	121699	120976	723	renamed_GCF_000008685.2	chromosome	121823	121100	723	98.7	1.011e-159
B331P	contig_1	124022	122366	1656	renamed_GCF_000008685.2	chromosome	124146	122490	1656	99.2	0.0
B331P	contig_1	125423	124673	750	renamed_GCF_000008685.2	chromosome	125547	124797	750	98.7	6.952e-160
B331P	contig_1	127289	126191	1098	renamed_GCF_000008685.2	chromosome	127413	126315	1098	98.9	7.411e-235
B331P	contig_1	130990	130045	945	renamed_GCF_000008685.2	chromosome	131114	130169	945	100.0	6.888e-210
B331P	contig_1	147376	146257	1119	renamed_GCF_000008685.2	chromosome	147495	146376	1119	100.0	3.727e-246
B331P	contig_1	227886	226668	1218	renamed_GCF_000008685.2	chromosome	227827	226609	1218	100.0	6.126e-266
B331P	contig_1	229275	230283	1008	renamed_GCF_000008685.2	chromosome	229216	230224	1008	99.1	1.478e-220
B331P	contig_1	231679	232381	702	renamed_GCF_000008685.2	chromosome	231620	232322	702	99.1	1.276e-153
B331P	contig_1	245438	244835	603	renamed_GCF_000008685.2	chromosome	245382	244776	603	99.5	7.936e-134
B331P	contig_1	246654	248160	1506	renamed_GCF_000008685.2	chromosome	246596	248102	1506	100.0	0.0
B331P	contig_1	250728	250233	495	renamed_GCF_000008685.2	chromosome	250670	250175	495	100.0	5.051e-104
B331P	contig_1	252295	251269	1026	renamed_GCF_000008685.2	chromosome	252237	251211	1026	99.7	2.737e-225
B331P	contig_1	253216	254989	1773	renamed_GCF_000008685.2	chromosome	253158	254931	1773	98.3	0.0
B331P	contig_1	273704	272690	1014	renamed_GCF_000008685.2	chromosome	273647	272633	1014	97.3	9.638e-218
B331P	contig_1	311709	310614	1095	renamed_GCF_000008685.2	chromosome	311617	310558	1095	99.4	1.229e-228
B331P	contig_1	314180	312788	1392	renamed_GCF_000008685.2	chromosome	314123	312728	1392	99.7	5.166e-306
B331P	contig_1	315371	314480	891	renamed_GCF_000008685.2	chromosome	315314	314423	891	99.3	2.2e-196
B331P	contig_1	317273	316196	1077	renamed_GCF_000008685.2	chromosome	317216	316139	1077	99.7	9.003e-238
B331P	contig_1	328088	329225	1137	renamed_GCF_000008685.2	chromosome	328031	329165	1137	99.4	1.536e-250
B331P	contig_1	330812	329702	1110	renamed_GCF_000008685.2	chromosome	330752	329642	1110	99.7	1.105e-249
B331P	contig_1	334575	333678	897	renamed_GCF_000008685.2	chromosome	334515	333618	897	100.0	1.666e-200
B331P	contig_1	340403	341324	921	renamed_GCF_000008685.2	chromosome	340340	341261	921	98.6	3.516e-196
B331P	contig_1	353503	351403	2100	renamed_GCF_000008685.2	chromosome	353437	351340	2100	97.4	0.0
B331P	contig_1	409470	408621	849	renamed_GCF_000008685.2	chromosome	409402	408553	849	99.6	2.186e-189
B331P	contig_1	410854	411514	660	renamed_GCF_000008685.2	chromosome	410786	411446	660	96.3	6.61e-137
B331P	contig_1	413180	414383	1203	renamed_GCF_000008685.2	chromosome	413112	414315	1203	99.0	7.684e-261
B331P	contig_1	416591	415913	678	renamed_GCF_000008685.2	chromosome	416478	415845	678	99.0	1.108e-142
B331P	contig_1	426805	428020	1215	renamed_GCF_000008685.2	chromosome	426735	427950	1215	99.2	4.167e-261
B331P	contig_1	428715	429744	1029	renamed_GCF_000008685.2	chromosome	428645	429674	1029	99.4	4.248e-238
B331P	contig_1	435173	430688	4485	renamed_GCF_000008685.2	chromosome	435103	430618	4485	99.5	0.0
B331P	contig_1	443318	442757	561	renamed_GCF_000008685.2	chromosome	443248	442687	561	99.4	1.054e-123
B331P	contig_1	447763	447046	717	renamed_GCF_000008685.2	chromosome	447736	446968	717	99.1	3.946e-152
B331P	contig_1	459993	460149	156	renamed_GCF_000008685.2	chromosome	459915	460071	156	100.0	2.965e-30
B331P	contig_1	499413	499776	363	renamed_GCF_000008685.2	chromosome	499340	499703	363	100.0	3.407e-78
B331P	contig_1	500665	501082	417	renamed_GCF_000008685.2	chromosome	500592	501009	417	100.0	2.778e-89
B331P	contig_1	501287	501542	255	renamed_GCF_000008685.2	chromosome	501214	501469	255	100.0	1.745e-51
B331P	contig_1	501952	502258	306	renamed_GCF_000008685.2	chromosome	501879	502185	306	100.0	2.959e-62
B331P	contig_1	507478	507871	393	renamed_GCF_000008685.2	chromosome	507405	507798	393	100.0	3.073e-84
B331P	contig_1	508942	509314	372	renamed_GCF_000008685.2	chromosome	508869	509241	372	99.1	4.349e-77
B331P	contig_1	510908	511697	789	renamed_GCF_000008685.2	chromosome	510835	511624	789	98.0	4.169e-172
B331P	contig_1	513298	514600	1302	renamed_GCF_000008685.2	chromosome	513225	514527	1302	99.7	3.945e-285
B331P	contig_1	535772	537596	1824	renamed_GCF_000008685.2	chromosome	535703	537527	1824	98.8	0.0
B331P	contig_1	581666	583439	1773	renamed_GCF_000008685.2	chromosome	581644	583417	1773	99.8	0.0
B331P	contig_1	584902	584212	690	renamed_GCF_000008685.2	chromosome	584880	584190	690	99.1	4.749e-154
B331P	contig_1	588087	589689	1602	renamed_GCF_000008685.2	chromosome	588065	589667	1602	100.0	0.0
B331P	contig_1	607005	604800	2205	renamed_GCF_000008685.2	chromosome	606983	604778	2205	99.8	0.0
B331P	contig_1	609928	609082	846	renamed_GCF_000008685.2	chromosome	609906	609060	846	100.0	3.324e-184
B331P	contig_1	611330	612044	714	renamed_GCF_000008685.2	chromosome	611308	612022	714	100.0	1.949e-159
B331P	contig_1	615793	614035	1758	renamed_GCF_000008685.2	chromosome	615771	614013	1758	98.9	0.0
B331P	contig_1	632015	632507	492	renamed_GCF_000008685.2	chromosome	631990	632482	492	100.0	1.786e-106
B331P	contig_1	690515	690812	297	renamed_GCF_000008685.2	chromosome	690481	690799	297	98.9	6.955e-60
B331P	contig_1	692641	693541	900	renamed_GCF_000008685.2	chromosome	692628	693528	900	99.6	4.423e-190
B331P	contig_1	695536	694705	831	renamed_GCF_000008685.2	chromosome	695523	694692	831	99.6	1.298e-183
B331P	contig_1	697451	696764	687	renamed_GCF_000008685.2	chromosome	697437	696750	687	99.5	1.468e-149
B331P	contig_1	706680	709275	2595	renamed_GCF_000008685.2	chromosome	706672	709267	2595	99.4	0.0
B331P	contig_1	710693	711179	486	renamed_GCF_000008685.2	chromosome	710685	711171	486	100.0	5.304e-102
B331P	contig_1	712215	711699	516	renamed_GCF_000008685.2	chromosome	712207	711691	516	99.4	8.019e-111
B331P	contig_1	714115	713251	864	renamed_GCF_000008685.2	chromosome	714107	713243	864	100.0	1.134e-190
B331P	contig_1	715016	716627	1611	renamed_GCF_000008685.2	chromosome	715008	716619	1611	100.0	0.0
B331P	contig_1	731107	730639	468	renamed_GCF_000008685.2	chromosome	731099	730631	468	100.0	1.969e-101
B331P	contig_1	731801	733811	2010	renamed_GCF_000008685.2	chromosome	731793	733803	2010	98.8	0.0
B331P	contig_1	735359	736694	1335	renamed_GCF_000008685.2	chromosome	735351	736686	1335	99.5	6.578e-285
B331P	contig_1	736967	737216	249	renamed_GCF_000008685.2	chromosome	736959	737208	249	100.0	2.148e-48
B331P	contig_1	737716	738436	720	renamed_GCF_000008685.2	chromosome	737708	738428	720	99.5	4.764e-159
B331P	contig_1	739151	739691	540	renamed_GCF_000008685.2	chromosome	739143	739683	540	100.0	2.458e-119
B331P	contig_1	740247	740430	183	renamed_GCF_000008685.2	chromosome	740239	740422	183	100.0	1.805e-39
B331P	contig_1	740695	741433	738	renamed_GCF_000008685.2	chromosome	740687	741425	738	100.0	4.772e-162
B331P	contig_1	742751	744524	1773	renamed_GCF_000008685.2	chromosome	742743	744516	1773	99.3	0.0
B331P	contig_1	806953	805804	1149	renamed_GCF_000008685.2	chromosome	806923	805774	1149	99.7	5.42e-247
B331P	contig_1	808494	808005	489	renamed_GCF_000008685.2	chromosome	808464	807975	489	100.0	6.125e-101
B331P	contig_1	852515	853805	1290	renamed_GCF_000008685.2	chromosome	852488	853778	1290	99.7	1.474e-285
B331P	contig_1	854895	856023	1128	renamed_GCF_000008685.2	chromosome	854868	855996	1128	96.2	7.224e-249
B331P	contig_1	857532	858942	1410	renamed_GCF_000008685.2	chromosome	857505	858915	1410	99.1	1.821e-303
B331P	contig_1	869543	868760	783	renamed_GCF_000008685.2	chromosome	869380	868732	783	99.0	4.291e-145
B331P	contig_1	872611	870139	2472	renamed_GCF_000008685.2	chromosome	872583	870111	2472	99.8	0.0
B331P	contig_1	875234	876476	1242	renamed_GCF_000008685.2	chromosome	875206	876448	1242	98.3	3.236e-277
B331P	contig_1	879342	880278	936	renamed_GCF_000008685.2	chromosome	879314	880250	936	99.6	1.601e-207
B331P	contig_1	884241	881112	3129	renamed_GCF_000008685.2	chromosome	884213	881084	3129	99.9	0.0
B331P	contig_2	45	324	279	renamed_GCF_000008685.2	cp26	45	324	279	98.9	5.175e-60
B331P	contig_2	2186	836	1350	renamed_GCF_000008685.2	cp26	2186	836	1350	100.0	7.868e-303
B331P	contig_3	28276	28843	567	renamed_GCF_000008685.2	lp56	31891	32458	567	98.4	6.937e-121
B331P	contig_4	8281	8737	456	renamed_GCF_000008685.2	cp32-6	8281	8737	456	99.3	4.385e-99
B331P	contig_4	8977	10252	1275	renamed_GCF_000008685.2	cp32-3	8967	10242	1275	96.9	5.553e-268
B331P	contig_4	12503	12836	333	renamed_GCF_000008685.2	cp32-4	12447	12780	333	100.0	8.424e-72
B331P	contig_4	13717	14323	606	renamed_GCF_000008685.2	cp32-8	13708	14314	606	99.5	1.216e-129
B331P	contig_4	26215	26908	693	renamed_GCF_000008685.2	cp32-7	26151	26841	693	94.3	8.36e-140
B331P	contig_6	8276	8732	456	renamed_GCF_000008685.2	cp32-4	8281	8737	456	100.0	1.971e-99
B331P	contig_6	12516	12849	333	renamed_GCF_000008685.2	cp32-6	12513	12846	333	100.0	8.424e-72
B331P	contig_6	29264	30617	1353	renamed_GCF_000008685.2	cp32-6	28485	29838	1353	99.5	6.861e-305
B331P	contig_8	16473	17061	588	renamed_GCF_000008685.2	cp32-3	17088	17697	588	87.3	2.744e-109
B331P	contig_9	2012	2579	567	renamed_GCF_000008685.2	lp56	35818	36385	567	100.0	4.74e-125
B331P	contig_9	12517	12850	333	renamed_GCF_000008685.2	cp32-1	12494	12827	333	100.0	8.424e-72
B331P	contig_9	15441	15789	348	renamed_GCF_000008685.2	cp32-9	15518	15866	348	100.0	8.822e-74
B331P	contig_12	24035	23852	183	renamed_GCF_000008685.2	lp5	743	1097	183	64.1	8.032e-18
B331P	contig_13	6377	2543	3834	renamed_GCF_000008685.2	lp28-3	7728	3891	3834	89.1	0.0
B331P	contig_14	15499	14941	558	renamed_GCF_000008685.2	lp28-1	7869	7353	558	99.4	8.805e-117
B331P	contig_15	13483	14029	546	renamed_GCF_000008685.2	lp28-2	15431	14885	546	99.4	2.156e-113
B331P	contig_15	14029	14539	510	renamed_GCF_000008685.2	lp28-2	14885	14375	510	98.8	3.969e-109
B331P	contig_16	6439	5743	696	renamed_GCF_000008685.2	lp36	8859	8163	696	97.8	8.359e-149
B331P	contig_16	6952	7351	399	renamed_GCF_000008685.2	lp36	9372	9999	399	98.3	1.228e-78
B331P	contig_16	7881	9528	1647	renamed_GCF_000008685.2	lp36	10300	11947	1647	99.8	0.0
B331P	contig_16	10182	10818	636	renamed_GCF_000008685.2	lp36	12601	13237	636	100.0	3.41e-140
B331P	contig_17	21309	22035	726	renamed_GCF_000008685.2	lp38	21222	21948	726	99.1	1.279e-157
B331P	contig_17	26486	27557	1071	renamed_GCF_000008685.2	lp38	26407	25336	1071	96.6	9.289e-228
B331P	contig_18	1972	1198	774	renamed_GCF_000008685.2	lp54	51705	52479	774	99.6	2.049e-160
B331P	contig_18	2501	3392	891	renamed_GCF_000008685.2	lp54	51176	50285	891	98.9	4.455e-197
B331P	contig_18	24410	24035	375	renamed_GCF_000008685.2	lp54	29383	29758	375	100.0	1.685e-79
B331P	contig_18	43468	42577	891	renamed_GCF_000008685.2	lp54	10287	11178	891	98.9	2.286e-187
B331P	contig_18	44299	43477	822	renamed_GCF_000008685.2	lp54	9456	10278	822	99.2	6.989e-172
B331P	contig_18	45314	44888	426	renamed_GCF_000008685.2	lp54	8441	8867	426	100.0	3.21e-89
B331P	contig_18	45490	45310	180	renamed_GCF_000008685.2	lp54	8265	8445	180	100.0	1.452e-33
B331P	contig_18	46547	45512	1035	renamed_GCF_000008685.2	lp54	7208	8243	1035	100.0	8.138e-232
B331P	contig_18	47235	46608	627	renamed_GCF_000008685.2	lp54	6520	7147	627	100.0	4.747e-135
B331P	contig_18	48110	47237	873	renamed_GCF_000008685.2	lp54	5645	6518	873	99.3	2.643e-191
B331P	contig_18	48442	48106	336	renamed_GCF_000008685.2	lp54	5313	5649	336	100.0	1.784e-72
B331P	contig_19	23397	23934	537	renamed_GCF_000008685.2	lp56	6339	5802	537	91.0	1.869e-113
B331P	contig_19	23906	24668	762	renamed_GCF_000008685.2	lp56	5830	5068	762	95.2	1.408e-162
B331P	contig_19	24755	25373	618	renamed_GCF_000008685.2	lp56	4986	4248	618	88.9	4.16e-118
B331P	contig_19	26364	26010	354	renamed_GCF_000008685.2	lp28-2	1046	1928	354	92.1	7.9e-68