QUERY_ID	QUERY_NAME	QUERY_START	QUERY_END	QUERY_LENGTH	REF_ID	REF_NAME	REF_START	REF_END	REF_LENGTH	IDENTITY	EVALUE
URI91H	contig_1	31018	31471	453	renamed_GCF_000008685.2	chromosome	31026	31479	453	100.0	2.279e-97
URI91H	contig_1	34029	32148	1881	renamed_GCF_000008685.2	chromosome	34037	32156	1881	100.0	0.0
URI91H	contig_1	36601	35848	753	renamed_GCF_000008685.2	chromosome	36609	35856	753	100.0	1.343e-161
URI91H	contig_1	39630	38127	1503	renamed_GCF_000008685.2	chromosome	39638	38135	1503	100.0	0.0
URI91H	contig_1	41424	40752	672	renamed_GCF_000008685.2	chromosome	41432	40760	672	100.0	1.856e-144
URI91H	contig_1	42873	42471	402	renamed_GCF_000008685.2	chromosome	42881	42479	402	100.0	2.405e-88
URI91H	contig_1	45437	45983	546	renamed_GCF_000008685.2	chromosome	45445	45991	546	100.0	3.273e-117
URI91H	contig_1	47158	47833	675	renamed_GCF_000008685.2	chromosome	47166	47841	675	100.0	3.937e-145
URI91H	contig_1	60525	60027	498	renamed_GCF_000008685.2	chromosome	60533	60035	498	100.0	3.278e-109
URI91H	contig_1	64029	65268	1239	renamed_GCF_000008685.2	chromosome	64037	65276	1239	100.0	5.707e-279
URI91H	contig_1	69557	70118	561	renamed_GCF_000008685.2	chromosome	69565	70126	561	100.0	3.775e-118
URI91H	contig_1	71192	72602	1410	renamed_GCF_000008685.2	chromosome	71200	72610	1410	100.0	2.56e-308
URI91H	contig_1	75764	76445	681	renamed_GCF_000008685.2	chromosome	75773	76454	681	100.0	3.584e-147
URI91H	contig_1	79000	77701	1299	renamed_GCF_000008685.2	chromosome	79009	77710	1299	100.0	8.363e-285
URI91H	contig_1	79495	80764	1269	renamed_GCF_000008685.2	chromosome	79504	80773	1269	100.0	1.4e-282
URI91H	contig_1	81395	82931	1536	renamed_GCF_000008685.2	chromosome	81404	82940	1536	100.0	0.0
URI91H	contig_1	86845	85870	975	renamed_GCF_000008685.2	chromosome	86854	85879	975	100.0	4.354e-220
URI91H	contig_1	118361	117668	693	renamed_GCF_000008685.2	chromosome	118370	117677	693	100.0	4.532e-155
URI91H	contig_1	119794	118954	840	renamed_GCF_000008685.2	chromosome	119803	118963	840	100.0	4.393e-180
URI91H	contig_1	121073	120794	279	renamed_GCF_000008685.2	chromosome	121082	120803	279	100.0	1.411e-57
URI91H	contig_1	133965	135855	1890	renamed_GCF_000008685.2	chromosome	133974	135864	1890	100.0	0.0
URI91H	contig_15	19199	17846	1353	renamed_GCF_000008685.2	cp32-3	28870	30223	1353	100.0	1.268e-306
URI91H	contig_16	208	691	483	renamed_GCF_000008685.2	cp32-6	17075	16592	483	100.0	5.056e-102
URI91H	contig_16	1509	1173	336	renamed_GCF_000008685.2	lp56	19256	19592	336	100.0	5.348e-69
URI91H	contig_16	3556	2950	606	renamed_GCF_000008685.2	cp32-6	13727	14333	606	100.0	5.47e-130
URI91H	contig_1	3386	5180	1794	renamed_GCF_000008685.2	chromosome	3418	5188	1794	100.0	0.0
URI91H	contig_1	6298	5242	1056	renamed_GCF_000008685.2	chromosome	6306	5250	1056	100.0	7.804e-236
URI91H	contig_1	7389	6300	1089	renamed_GCF_000008685.2	chromosome	7397	6308	1089	100.0	1.828e-240
URI91H	contig_1	8307	7449	858	renamed_GCF_000008685.2	chromosome	8315	7457	858	100.0	6.472e-196
URI91H	contig_1	8418	9189	771	renamed_GCF_000008685.2	chromosome	8426	9197	771	100.0	1.781e-161
URI91H	contig_1	9193	10198	1005	renamed_GCF_000008685.2	chromosome	9201	10206	1005	100.0	1.697e-218
URI91H	contig_1	10194	10569	375	renamed_GCF_000008685.2	chromosome	10202	10577	375	100.0	3.75e-79
URI91H	contig_1	11412	12153	741	renamed_GCF_000008685.2	chromosome	11420	12161	741	100.0	4.147e-164
URI91H	contig_1	12145	12745	600	renamed_GCF_000008685.2	chromosome	12153	12753	600	100.0	4.114e-132
URI91H	contig_1	15337	14716	621	renamed_GCF_000008685.2	chromosome	15345	14724	621	100.0	3.249e-138
URI91H	contig_1	15714	15336	378	renamed_GCF_000008685.2	chromosome	15716	15344	378	100.0	1.768e-79
URI91H	contig_1	18296	17783	513	renamed_GCF_000008685.2	chromosome	18304	17791	513	100.0	1.701e-110
URI91H	contig_1	22810	23950	1140	renamed_GCF_000008685.2	chromosome	22818	23958	1140	100.0	2.624e-262
URI91H	contig_1	25615	24688	927	renamed_GCF_000008685.2	chromosome	25623	24696	927	100.0	1.199e-200
URI91H	contig_1	25744	26383	639	renamed_GCF_000008685.2	chromosome	25752	26391	639	100.0	1.211e-143
URI91H	contig_1	27857	27425	432	renamed_GCF_000008685.2	chromosome	27865	27433	432	100.0	2.641e-92
URI91H	contig_1	29464	28483	981	renamed_GCF_000008685.2	chromosome	29472	28491	981	100.0	8.047e-223
URI91H	contig_1	29534	31007	1473	renamed_GCF_000008685.2	chromosome	29542	31015	1473	99.7	0.0
URI91H	contig_1	50466	50103	363	renamed_GCF_000008685.2	chromosome	50474	50111	363	100.0	4.578e-75
URI91H	contig_1	51243	50481	762	renamed_GCF_000008685.2	chromosome	51251	50489	762	100.0	1.168e-164
URI91H	contig_1	52426	51244	1182	renamed_GCF_000008685.2	chromosome	52434	51252	1182	100.0	6.664e-259
URI91H	contig_1	53453	52445	1008	renamed_GCF_000008685.2	chromosome	53461	52453	1008	100.0	6.65e-221
URI91H	contig_1	55496	53525	1971	renamed_GCF_000008685.2	chromosome	55504	53533	1971	100.0	0.0
URI91H	contig_1	56272	55492	780	renamed_GCF_000008685.2	chromosome	56280	55500	780	99.6	1.628e-172
URI91H	contig_1	56740	56272	468	renamed_GCF_000008685.2	chromosome	56748	56280	468	100.0	3.979e-102
URI91H	contig_1	57177	56823	354	renamed_GCF_000008685.2	chromosome	57185	56831	354	100.0	1.322e-78
URI91H	contig_1	57250	57967	717	renamed_GCF_000008685.2	chromosome	57258	57975	717	100.0	1.471e-154
URI91H	contig_1	59028	58020	1008	renamed_GCF_000008685.2	chromosome	58982	58028	1008	100.0	2.425e-206
URI91H	contig_1	80973	81399	426	renamed_GCF_000008685.2	chromosome	80982	81408	426	100.0	5.338e-92
URI91H	contig_1	83911	82960	951	renamed_GCF_000008685.2	chromosome	83920	82969	951	99.6	3.736e-209
URI91H	contig_1	85711	84031	1680	renamed_GCF_000008685.2	chromosome	85720	84040	1680	100.0	0.0
URI91H	contig_1	89799	89190	609	renamed_GCF_000008685.2	chromosome	89808	89199	609	100.0	1.275e-129
URI91H	contig_1	105422	103754	1668	renamed_GCF_000008685.2	chromosome	105299	103763	1668	100.0	0.0
URI91H	contig_1	106885	105874	1011	renamed_GCF_000008685.2	chromosome	106894	105883	1011	100.0	4.14e-218
URI91H	contig_1	108161	106964	1197	renamed_GCF_000008685.2	chromosome	108170	106973	1197	100.0	8.414e-259
URI91H	contig_1	108297	109662	1365	renamed_GCF_000008685.2	chromosome	108306	109671	1365	100.0	4.349e-312
URI91H	contig_1	111866	111575	291	renamed_GCF_000008685.2	chromosome	111875	111584	291	100.0	1.894e-64
URI91H	contig_1	144259	142936	1323	renamed_GCF_000008685.2	chromosome	144230	142943	1323	99.7	1.75e-280
URI91H	contig_1	145451	144578	873	renamed_GCF_000008685.2	chromosome	145458	144585	873	100.0	2.787e-199
URI91H	contig_1	146363	145463	900	renamed_GCF_000008685.2	chromosome	146370	145470	900	100.0	6.779e-194
URI91H	contig_1	158620	159337	717	renamed_GCF_000008685.2	chromosome	158627	159344	717	100.0	1.01e-158
URI91H	contig_1	159360	160035	675	renamed_GCF_000008685.2	chromosome	159367	160042	675	100.0	1.946e-144
URI91H	contig_1	160082	161201	1119	renamed_GCF_000008685.2	chromosome	160089	161208	1119	100.0	2.349e-251
URI91H	contig_1	162794	161192	1602	renamed_GCF_000008685.2	chromosome	162801	161199	1602	100.0	0.0
URI91H	contig_1	162870	163038	168	renamed_GCF_000008685.2	chromosome	162877	163045	168	100.0	5.294e-34
URI91H	contig_1	164813	163064	1749	renamed_GCF_000008685.2	chromosome	164820	163071	1749	100.0	0.0
URI91H	contig_1	186941	187187	246	renamed_GCF_000008685.2	chromosome	186948	187194	246	100.0	9.168e-49
URI91H	contig_1	187824	187170	654	renamed_GCF_000008685.2	chromosome	187831	187177	654	100.0	1.397e-144
URI91H	contig_1	188230	187816	414	renamed_GCF_000008685.2	chromosome	188237	187823	414	100.0	2.918e-88
URI91H	contig_1	188487	188226	261	renamed_GCF_000008685.2	chromosome	188494	188233	261	100.0	7.054e-54
URI91H	contig_1	201043	199957	1086	renamed_GCF_000008685.2	chromosome	201050	199964	1086	100.0	2.679e-244
URI91H	contig_1	202571	201044	1527	renamed_GCF_000008685.2	chromosome	202578	201051	1527	100.0	0.0
URI91H	contig_1	202842	204081	1239	renamed_GCF_000008685.2	chromosome	202849	204088	1239	100.0	5.514e-262
URI91H	contig_1	204129	205065	936	renamed_GCF_000008685.2	chromosome	204136	205072	936	100.0	4.7e-204
URI91H	contig_1	205065	206037	972	renamed_GCF_000008685.2	chromosome	205174	206044	972	99.6	3.289e-188
URI91H	contig_1	219792	220632	840	renamed_GCF_000008685.2	chromosome	219799	220639	840	100.0	1.641e-182
URI91H	contig_1	220721	221630	909	renamed_GCF_000008685.2	chromosome	220728	221637	909	100.0	9.393e-192
URI91H	contig_1	221626	223171	1545	renamed_GCF_000008685.2	chromosome	221741	223178	1545	99.7	1.424e-311
URI91H	contig_1	223171	223954	783	renamed_GCF_000008685.2	chromosome	223178	223961	783	100.0	3.455e-173
URI91H	contig_1	245372	244769	603	renamed_GCF_000008685.2	chromosome	245382	244776	603	99.5	7.936e-134
URI91H	contig_1	245782	246547	765	renamed_GCF_000008685.2	chromosome	245789	246554	765	100.0	7.663e-170
URI91H	contig_1	246589	248095	1506	renamed_GCF_000008685.2	chromosome	246596	248102	1506	100.0	0.0
URI91H	contig_1	248519	250082	1563	renamed_GCF_000008685.2	chromosome	248505	250089	1563	100.0	0.0
URI91H	contig_1	250663	250168	495	renamed_GCF_000008685.2	chromosome	250670	250175	495	100.0	5.051e-104
URI91H	contig_1	251204	250649	555	renamed_GCF_000008685.2	chromosome	251211	250656	555	100.0	3.12e-119
URI91H	contig_1	279373	279070	303	renamed_GCF_000008685.2	chromosome	279380	279077	303	100.0	2.087e-65
URI91H	contig_1	281304	279399	1905	renamed_GCF_000008685.2	chromosome	281311	279406	1905	100.0	0.0
URI91H	contig_1	281786	281306	480	renamed_GCF_000008685.2	chromosome	281793	281313	480	100.0	1.072e-101
URI91H	contig_1	282680	281792	888	renamed_GCF_000008685.2	chromosome	282687	281799	888	100.0	4.025e-189
URI91H	contig_1	300757	299722	1035	renamed_GCF_000008685.2	chromosome	300764	299729	1035	100.0	3.255e-216
URI91H	contig_1	302482	300772	1710	renamed_GCF_000008685.2	chromosome	302489	300779	1710	100.0	0.0
URI91H	contig_1	302829	302496	333	renamed_GCF_000008685.2	chromosome	302839	302503	333	99.0	1.253e-67
URI91H	contig_1	303302	302843	459	renamed_GCF_000008685.2	chromosome	303309	302850	459	100.0	4.601e-99
URI91H	contig_1	303733	303325	408	renamed_GCF_000008685.2	chromosome	303740	303332	408	100.0	2.649e-88
URI91H	contig_1	305113	303766	1347	renamed_GCF_000008685.2	chromosome	305120	303773	1347	100.0	1.016e-290
URI91H	contig_1	315308	314417	891	renamed_GCF_000008685.2	chromosome	315314	314423	891	100.0	4.455e-197
URI91H	contig_1	316137	315300	837	renamed_GCF_000008685.2	chromosome	316143	315306	837	100.0	2.887e-184
URI91H	contig_1	317210	316133	1077	renamed_GCF_000008685.2	chromosome	317216	316139	1077	100.0	1.824e-238
URI91H	contig_1	317999	317240	759	renamed_GCF_000008685.2	chromosome	318005	317246	759	100.0	1.223e-163
URI91H	contig_1	342328	343201	873	renamed_GCF_000008685.2	chromosome	342334	343207	873	100.0	1.573e-188
URI91H	contig_1	343201	344173	972	renamed_GCF_000008685.2	chromosome	343207	344179	972	100.0	3.579e-213
URI91H	contig_1	345056	346358	1302	renamed_GCF_000008685.2	chromosome	345062	346364	1302	100.0	6.07e-289
URI91H	contig_1	346835	346424	411	renamed_GCF_000008685.2	chromosome	346841	346430	411	100.0	6.821e-87
URI91H	contig_1	347295	346854	441	renamed_GCF_000008685.2	chromosome	347301	346860	441	100.0	1.706e-98
URI91H	contig_1	348154	347344	810	renamed_GCF_000008685.2	chromosome	348160	347350	810	100.0	1.888e-184
URI91H	contig_1	349604	348146	1458	renamed_GCF_000008685.2	chromosome	349610	348152	1458	100.0	0.0
URI91H	contig_1	351042	349593	1449	renamed_GCF_000008685.2	chromosome	351045	349599	1449	99.7	6.4e-322
URI91H	contig_1	351325	351049	276	renamed_GCF_000008685.2	chromosome	351331	351055	276	100.0	8.162e-55
URI91H	contig_1	365074	364123	951	renamed_GCF_000008685.2	chromosome	364972	364129	951	99.6	1.174e-187
URI91H	contig_1	365597	365108	489	renamed_GCF_000008685.2	chromosome	365603	365114	489	100.0	3.787e-106
URI91H	contig_1	366954	366222	732	renamed_GCF_000008685.2	chromosome	366960	366228	732	100.0	5.239e-160
URI91H	contig_1	368449	368875	426	renamed_GCF_000008685.2	chromosome	368455	368881	426	100.0	3.899e-87
URI91H	contig_1	391813	390388	1425	renamed_GCF_000008685.2	chromosome	391819	390391	1425	100.0	0.0
URI91H	contig_1	392951	391925	1026	renamed_GCF_000008685.2	chromosome	392957	391931	1026	100.0	1.232e-225
URI91H	contig_1	394057	393037	1020	renamed_GCF_000008685.2	chromosome	394063	393043	1020	100.0	6.665e-223
URI91H	contig_1	395160	394098	1062	renamed_GCF_000008685.2	chromosome	395166	394104	1062	100.0	1.904e-235
URI91H	contig_1	408086	407915	171	renamed_GCF_000008685.2	chromosome	408092	407921	171	100.0	1.118e-34
URI91H	contig_1	408374	408194	180	renamed_GCF_000008685.2	chromosome	408380	408200	180	100.0	2.118e-37
URI91H	contig_1	409396	408547	849	renamed_GCF_000008685.2	chromosome	409402	408553	849	100.0	9.834e-190
URI91H	contig_1	410441	409409	1032	renamed_GCF_000008685.2	chromosome	410447	409415	1032	100.0	9.895e-238
URI91H	contig_1	410780	411440	660	renamed_GCF_000008685.2	chromosome	410786	411446	660	100.0	1.008e-140
URI91H	contig_1	412994	411449	1545	renamed_GCF_000008685.2	chromosome	413006	411455	1545	99.8	0.0
URI91H	contig_1	443244	442683	561	renamed_GCF_000008685.2	chromosome	443248	442687	561	100.0	1.054e-123
URI91H	contig_1	446871	446322	549	renamed_GCF_000008685.2	chromosome	446875	446326	549	100.0	4.738e-122
URI91H	contig_1	447756	446964	792	renamed_GCF_000008685.2	chromosome	447736	446968	792	99.6	3.782e-165
URI91H	contig_1	469967	469673	294	renamed_GCF_000008685.2	chromosome	469971	469677	294	100.0	2.2e-63
URI91H	contig_1	471216	469956	1260	renamed_GCF_000008685.2	chromosome	471220	469960	1260	100.0	2.539e-274
URI91H	contig_1	471752	471218	534	renamed_GCF_000008685.2	chromosome	471756	471222	534	100.0	8.816e-113
URI91H	contig_1	472471	471766	705	renamed_GCF_000008685.2	chromosome	472358	471770	705	99.4	1.099e-121
URI91H	contig_1	472561	473404	843	renamed_GCF_000008685.2	chromosome	472565	473408	843	100.0	5.328e-187
URI91H	contig_1	474552	473400	1152	renamed_GCF_000008685.2	chromosome	474556	473404	1152	100.0	7.714e-261
URI91H	contig_1	495028	496213	1185	renamed_GCF_000008685.2	chromosome	495032	496217	1185	100.0	4.832e-263
URI91H	contig_1	496263	496575	312	renamed_GCF_000008685.2	chromosome	496267	496579	312	100.0	2.953e-63
URI91H	contig_1	496610	497231	621	renamed_GCF_000008685.2	chromosome	496614	497235	621	100.0	8.732e-136
URI91H	contig_1	497240	497870	630	renamed_GCF_000008685.2	chromosome	497244	497874	630	100.0	4.528e-136
URI91H	contig_1	502186	502735	549	renamed_GCF_000008685.2	chromosome	502190	502739	549	100.0	1.698e-116
URI91H	contig_1	502751	502937	186	renamed_GCF_000008685.2	chromosome	502755	502941	186	100.0	7.664e-41
URI91H	contig_1	502946	503345	399	renamed_GCF_000008685.2	chromosome	502950	503349	399	100.0	3.071e-85
URI91H	contig_1	503361	503904	543	renamed_GCF_000008685.2	chromosome	503365	503908	543	100.0	7.636e-116
URI91H	contig_1	503921	504281	360	renamed_GCF_000008685.2	chromosome	503925	504285	360	100.0	4.361e-75
URI91H	contig_1	504293	504791	498	renamed_GCF_000008685.2	chromosome	504297	504795	498	100.0	1.785e-107
URI91H	contig_1	529189	528094	1095	renamed_GCF_000008685.2	chromosome	529198	528103	1095	100.0	3.934e-250
URI91H	contig_1	531096	529188	1908	renamed_GCF_000008685.2	chromosome	531105	529197	1908	100.0	0.0
URI91H	contig_1	531683	531119	564	renamed_GCF_000008685.2	chromosome	531692	531128	564	100.0	2.704e-122
URI91H	contig_1	543823	544597	774	renamed_GCF_000008685.2	chromosome	543831	544605	774	100.0	1.787e-170
URI91H	contig_1	544577	547379	2802	renamed_GCF_000008685.2	chromosome	544585	547387	2802	99.8	0.0
URI91H	contig_1	548482	547837	645	renamed_GCF_000008685.2	chromosome	548490	547845	645	100.0	1.056e-137
URI91H	contig_1	548877	548478	399	renamed_GCF_000008685.2	chromosome	548885	548486	399	100.0	1.521e-84
URI91H	contig_1	549610	548911	699	renamed_GCF_000008685.2	chromosome	549618	548919	699	100.0	1.058e-146
URI91H	contig_1	551715	549633	2082	renamed_GCF_000008685.2	chromosome	551723	549641	2082	100.0	0.0
URI91H	contig_1	573843	575238	1395	renamed_GCF_000008685.2	chromosome	573852	575247	1395	100.0	2.85e-313
URI91H	contig_1	575807	575264	543	renamed_GCF_000008685.2	chromosome	575816	575273	543	100.0	3.121e-117
URI91H	contig_1	576517	575971	546	renamed_GCF_000008685.2	chromosome	576499	575980	546	100.0	1.781e-115
URI91H	contig_1	577178	576572	606	renamed_GCF_000008685.2	chromosome	577187	576581	606	100.0	4.975e-131
URI91H	contig_1	602364	603720	1356	renamed_GCF_000008685.2	chromosome	602373	603729	1356	100.0	2.305e-300
URI91H	contig_1	604760	603716	1044	renamed_GCF_000008685.2	chromosome	604769	603725	1044	100.0	3.194e-235
URI91H	contig_1	606974	604769	2205	renamed_GCF_000008685.2	chromosome	606983	604778	2205	100.0	0.0
URI91H	contig_1	607128	607926	798	renamed_GCF_000008685.2	chromosome	607137	607935	798	100.0	9.72e-173
URI91H	contig_1	609897	609051	846	renamed_GCF_000008685.2	chromosome	609906	609060	846	100.0	3.324e-184
URI91H	contig_1	638569	639862	1293	renamed_GCF_000008685.2	chromosome	638579	639872	1293	100.0	3.129e-286
URI91H	contig_1	639830	642239	2409	renamed_GCF_000008685.2	chromosome	639858	642249	2409	100.0	0.0
URI91H	contig_1	642278	642431	153	renamed_GCF_000008685.2	chromosome	642288	642441	153	100.0	5.64e-31
URI91H	contig_1	643116	642489	627	renamed_GCF_000008685.2	chromosome	643126	642499	627	100.0	8.735e-137
URI91H	contig_1	658887	659613	726	renamed_GCF_000008685.2	chromosome	658897	659623	726	100.0	3.429e-155
URI91H	contig_1	661505	659633	1872	renamed_GCF_000008685.2	chromosome	661515	659643	1872	100.0	0.0
URI91H	contig_1	661595	662519	924	renamed_GCF_000008685.2	chromosome	661605	662529	924	100.0	4.691e-202
URI91H	contig_1	662907	662592	315	renamed_GCF_000008685.2	chromosome	662917	662602	315	100.0	5.657e-65
URI91H	contig_1	665001	663168	1833	renamed_GCF_000008685.2	chromosome	665011	663178	1833	100.0	0.0
URI91H	contig_1	740676	741414	738	renamed_GCF_000008685.2	chromosome	740687	741425	738	100.0	4.772e-162
URI91H	contig_1	742617	741384	1233	renamed_GCF_000008685.2	chromosome	742628	741395	1233	100.0	3.707e-274
URI91H	contig_1	742732	744505	1773	renamed_GCF_000008685.2	chromosome	742743	744516	1773	100.0	0.0
URI91H	contig_1	744510	744834	324	renamed_GCF_000008685.2	chromosome	744521	744845	324	100.0	1.32e-65
URI91H	contig_1	759575	760205	630	renamed_GCF_000008685.2	chromosome	759585	760215	630	100.0	3.747e-138
URI91H	contig_1	760191	761637	1446	renamed_GCF_000008685.2	chromosome	760225	761647	1446	99.7	9.686e-317
URI91H	contig_1	763568	764351	783	renamed_GCF_000008685.2	chromosome	763578	764361	783	100.0	1.874e-171
URI91H	contig_1	764360	765332	972	renamed_GCF_000008685.2	chromosome	764370	765342	972	100.0	2.973e-215
URI91H	contig_1	765362	766706	1344	renamed_GCF_000008685.2	chromosome	765372	766716	1344	100.0	2.685e-305
URI91H	contig_1	768054	766722	1332	renamed_GCF_000008685.2	chromosome	768064	766732	1332	100.0	1.239e-294
URI91H	contig_1	769460	768068	1392	renamed_GCF_000008685.2	chromosome	769470	768078	1392	100.0	1.696e-292
URI91H	contig_1	771129	769536	1593	renamed_GCF_000008685.2	chromosome	771139	769546	1593	100.0	0.0
URI91H	contig_1	771553	771151	402	renamed_GCF_000008685.2	chromosome	771563	771161	402	100.0	3.917e-83
URI91H	contig_1	774358	771559	2799	renamed_GCF_000008685.2	chromosome	774368	771569	2799	100.0	0.0
URI91H	contig_1	774666	775452	786	renamed_GCF_000008685.2	chromosome	774676	775462	786	100.0	1.17e-168
URI91H	contig_1	776669	775655	1014	renamed_GCF_000008685.2	chromosome	776679	775665	1014	100.0	1.623e-220
URI91H	contig_1	776774	777563	789	renamed_GCF_000008685.2	chromosome	776784	777573	789	100.0	8.439e-173
URI91H	contig_1	818604	818916	312	renamed_GCF_000008685.2	chromosome	818604	818916	312	100.0	1.086e-65
URI91H	contig_1	818921	819242	321	renamed_GCF_000008685.2	chromosome	819035	819242	321	98.5	2.552e-42
URI91H	contig_1	819241	819487	246	renamed_GCF_000008685.2	chromosome	819241	819487	246	100.0	8.275e-50
URI91H	contig_1	819541	820528	987	renamed_GCF_000008685.2	chromosome	819541	820528	987	100.0	5.255e-220
URI91H	contig_1	830941	830317	624	renamed_GCF_000008685.2	chromosome	830941	830317	624	100.0	5.187e-142
URI91H	contig_1	831563	830954	609	renamed_GCF_000008685.2	chromosome	831563	830954	609	100.0	7.938e-135
URI91H	contig_1	836060	838526	2466	renamed_GCF_000008685.2	chromosome	836060	838526	2466	100.0	0.0
URI91H	contig_1	838546	839080	534	renamed_GCF_000008685.2	chromosome	838546	839080	534	100.0	7.282e-115
URI91H	contig_1	839243	841832	2589	renamed_GCF_000008685.2	chromosome	839243	841832	2589	100.0	0.0
URI91H	contig_1	841833	842451	618	renamed_GCF_000008685.2	chromosome	841833	842451	618	100.0	1.393e-138
URI91H	contig_1	842551	842989	438	renamed_GCF_000008685.2	chromosome	842500	842989	438	99.3	1.307e-92
URI91H	contig_1	843002	844451	1449	renamed_GCF_000008685.2	chromosome	843002	844451	1449	100.0	7.712e-320
URI91H	contig_1	844453	847069	2616	renamed_GCF_000008685.2	chromosome	844453	847102	2616	98.7	0.0
URI91H	contig_1	868162	868708	546	renamed_GCF_000008685.2	chromosome	868194	868740	546	100.0	1.846e-123
URI91H	contig_1	869483	868700	783	renamed_GCF_000008685.2	chromosome	869380	868732	783	99.5	1.931e-145
URI91H	contig_1	869991	869475	516	renamed_GCF_000008685.2	chromosome	870023	869507	516	100.0	1.621e-111
URI91H	contig_1	872551	870079	2472	renamed_GCF_000008685.2	chromosome	872583	870111	2472	100.0	0.0
URI91H	contig_1	875100	872553	2547	renamed_GCF_000008685.2	chromosome	875132	872585	2547	100.0	0.0
URI91H	contig_1	875174	876416	1242	renamed_GCF_000008685.2	chromosome	875206	876448	1242	100.0	1.008e-281
URI91H	contig_2	3515	3758	243	renamed_GCF_000008685.2	lp54	50077	49852	243	98.6	5.904e-45
URI91H	contig_2	5343	6135	792	renamed_GCF_000008685.2	lp54	48267	47475	792	100.0	4.37e-172
URI91H	contig_2	6382	7138	756	renamed_GCF_000008685.2	lp54	47228	46472	756	100.0	2.151e-165
URI91H	contig_2	7663	8899	1236	renamed_GCF_000008685.2	lp54	45947	44711	1236	100.0	1.366e-268
URI91H	contig_2	9077	9926	849	renamed_GCF_000008685.2	lp54	44533	43684	849	100.0	7.054e-185
URI91H	contig_2	10078	10987	909	renamed_GCF_000008685.2	lp54	43532	42623	909	100.0	1.089e-198
URI91H	contig_2	11344	11137	207	renamed_GCF_000008685.2	lp54	42266	42473	207	100.0	9.856e-42
URI91H	contig_2	11591	12215	624	renamed_GCF_000008685.2	lp54	42019	41395	624	100.0	3.1e-139
URI91H	contig_2	12565	13399	834	renamed_GCF_000008685.2	lp54	41045	40211	834	100.0	3.319e-182
URI91H	contig_2	28148	26906	1242	renamed_GCF_000008685.2	lp54	25467	26694	1242	100.0	1.5e-268
URI91H	contig_2	29103	28497	606	renamed_GCF_000008685.2	lp54	24497	25103	606	100.0	6.612e-128
URI91H	contig_2	29824	29185	639	renamed_GCF_000008685.2	lp54	23776	24415	639	100.0	9.606e-138
URI91H	contig_2	30327	31917	1590	renamed_GCF_000008685.2	lp54	23273	21683	1590	100.0	0.0
URI91H	contig_2	40606	40021	585	renamed_GCF_000008685.2	lp54	12994	13579	585	100.0	1.763e-130
URI91H	contig_2	43313	42422	891	renamed_GCF_000008685.2	lp54	10287	11178	891	100.0	1.898e-189
URI91H	contig_2	44144	43322	822	renamed_GCF_000008685.2	lp54	9456	10278	822	100.0	5.801e-174
URI91H	contig_2	45159	44733	426	renamed_GCF_000008685.2	lp54	8441	8867	426	100.0	3.21e-89
URI91H	contig_3	16247	15554	693	renamed_GCF_000008685.2	lp56	35114	35807	693	100.0	1.057e-145
URI91H	contig_3	18907	17554	1353	renamed_GCF_000008685.2	lp56	32454	33807	1353	100.0	5.71e-307
URI91H	contig_3	19470	18903	567	renamed_GCF_000008685.2	lp56	31891	32458	567	100.0	5.734e-123
URI91H	contig_3	20224	19651	573	renamed_GCF_000008685.2	lp56	31167	31710	573	100.0	2.482e-116
URI91H	contig_3	30518	29906	612	renamed_GCF_000008685.2	lp56	20843	21455	612	100.0	1.152e-139
URI91H	contig_3	31319	30623	696	renamed_GCF_000008685.2	lp56	20042	20738	696	100.0	9.184e-148
URI91H	contig_3	31777	31423	354	renamed_GCF_000008685.2	lp56	19584	19938	354	100.0	1.459e-77
URI91H	contig_3	32105	31769	336	renamed_GCF_000008685.2	cp32-8	15758	16094	336	100.0	5.348e-69
URI91H	contig_3	32442	32094	348	renamed_GCF_000008685.2	cp32-8	15421	15769	348	100.0	8.822e-74
URI91H	contig_3	32649	32445	204	renamed_GCF_000008685.2	cp32-1	15214	15418	204	100.0	2.578e-39
URI91H	contig_4	16049	17108	1059	renamed_GCF_000008685.2	lp38	28053	26994	1059	100.0	1.184e-231
URI91H	contig_4	17695	18766	1071	renamed_GCF_000008685.2	lp38	26407	25336	1071	100.0	4.439e-236
URI91H	contig_4	20737	20014	723	renamed_GCF_000008685.2	lp38	23365	24088	723	100.0	6.027e-157
URI91H	contig_4	22132	21094	1038	renamed_GCF_000008685.2	lp38	22042	23008	1038	99.6	1.164e-219
URI91H	contig_4	22880	22154	726	renamed_GCF_000008685.2	lp38	21222	21948	726	100.0	1.164e-158
URI91H	contig_4	24102	22872	1230	renamed_GCF_000008685.2	lp38	20000	21230	1230	100.0	1.496e-266
URI91H	contig_4	24790	24094	696	renamed_GCF_000008685.2	lp38	19312	20008	696	100.0	6.303e-152
URI91H	contig_4	25889	24848	1041	renamed_GCF_000008685.2	lp38	18213	19254	1041	100.0	2.778e-236
URI91H	contig_4	26715	25932	783	renamed_GCF_000008685.2	lp38	17387	18170	783	100.0	3.455e-173
URI91H	contig_5	17123	16919	204	renamed_GCF_000008685.2	lp36	17379	17583	204	100.0	8.441e-43
URI91H	contig_5	18228	17616	612	renamed_GCF_000008685.2	lp36	16274	16886	612	100.0	9.153e-134
URI91H	contig_5	18742	19669	927	renamed_GCF_000008685.2	lp36	15760	14833	927	100.0	2.815e-208
URI91H	contig_5	19661	20201	540	renamed_GCF_000008685.2	lp36	14841	14301	540	100.0	2.234e-120
URI91H	contig_5	34315	33421	894	renamed_GCF_000008685.2	lp36	187	1081	894	100.0	7.433e-192
URI91H	contig_6	807	5994	5187	renamed_GCF_000008685.2	lp28-1	26996	28073	5187	55.3	3.742e-92
URI91H	contig_6	9664	9919	255	renamed_GCF_000008685.2	lp28-1	17805	17550	255	100.0	1.423e-53
URI91H	contig_6	19559	20117	558	renamed_GCF_000008685.2	lp28-1	7869	7353	558	100.0	3.959e-117
URI91H	contig_6	24692	24392	300	renamed_GCF_000008685.2	lp28-3	1044	1368	300	89.8	8.93e-58
URI91H	contig_7	17466	16617	849	renamed_GCF_000008685.2	lp36	35443	34594	849	93.9	1.124e-179
URI91H	contig_8	5110	6223	1113	renamed_GCF_000008685.2	lp56	10170	11283	1113	99.4	1.675e-245
URI91H	contig_8	6236	6665	429	renamed_GCF_000008685.2	lp56	11296	11725	429	100.0	5.601e-92
URI91H	contig_8	7132	7369	237	renamed_GCF_000008685.2	cp32-9	8741	8978	237	100.0	1.76e-48
URI91H	contig_9	4366	4750	384	renamed_GCF_000008685.2	cp32-1	5396	5780	384	100.0	2.931e-83
URI91H	contig_9	4737	5127	390	renamed_GCF_000008685.2	cp32-9	5783	6173	390	100.0	3.229e-83
URI91H	contig_9	5123	5690	567	renamed_GCF_000008685.2	cp32-1	6153	6720	567	100.0	9.584e-126
URI91H	contig_9	5670	6783	1113	renamed_GCF_000008685.2	cp32-1	6700	7813	1113	100.0	6.876e-247
URI91H	contig_9	6797	7226	429	renamed_GCF_000008685.2	cp32-6	7837	8266	429	100.0	5.601e-92
URI91H	contig_9	7241	7697	456	renamed_GCF_000008685.2	cp32-6	8281	8737	456	100.0	1.971e-99
URI91H	contig_10	7102	7531	429	renamed_GCF_000008685.2	cp32-1	7827	8256	429	100.0	5.601e-92
URI91H	contig_10	7546	8002	456	renamed_GCF_000008685.2	cp32-1	8271	8727	456	100.0	1.971e-99
URI91H	contig_10	7998	8235	237	renamed_GCF_000008685.2	cp32-3	8723	8960	237	100.0	7.893e-49
URI91H	contig_10	8242	9517	1275	renamed_GCF_000008685.2	cp32-8	8967	10242	1275	100.0	1.201e-276
URI91H	contig_10	15361	15715	354	renamed_GCF_000008685.2	cp32-7	16093	16447	354	100.0	1.459e-77
URI91H	contig_10	15819	16374	555	renamed_GCF_000008685.2	cp32-8	16544	17099	555	100.0	3.776e-117
URI91H	contig_10	16479	16926	447	renamed_GCF_000008685.2	cp32-8	17204	17651	447	100.0	1.879e-98
URI91H	contig_10	17976	16962	1014	renamed_GCF_000008685.2	cp32-1	18728	17714	1014	100.0	7.051e-230
URI91H	contig_10	18361	19462	1101	renamed_GCF_000008685.2	cp32-1	19113	20214	1101	100.0	1.773e-251
URI91H	contig_10	19471	20038	567	renamed_GCF_000008685.2	cp32-1	20223	20790	567	100.0	2.944e-130
URI91H	contig_11	16443	16107	336	renamed_GCF_000008685.2	cp32-9	15855	16191	336	100.0	5.348e-69
URI91H	contig_11	16780	16432	348	renamed_GCF_000008685.2	cp32-1	15421	15769	348	100.0	3.962e-74
URI91H	contig_11	16987	16783	204	renamed_GCF_000008685.2	cp32-7	15221	15425	204	100.0	2.578e-39
URI91H	contig_11	26417	26027	390	renamed_GCF_000008685.2	cp32-4	5777	6167	390	100.0	3.229e-83
URI91H	contig_11	26788	26404	384	renamed_GCF_000008685.2	cp32-9	5412	5796	384	100.0	2.931e-83
URI91H	contig_11	29610	28845	765	renamed_GCF_000008685.2	cp32-7	2573	3338	765	99.6	3.139e-171
URI91H	contig_12	14021	13481	540	renamed_GCF_000008685.2	cp32-8	28250	28790	540	100.0	1.472e-116
URI91H	contig_12	15341	14204	1137	renamed_GCF_000008685.2	cp32-1	26795	27932	1137	100.0	3.741e-249
URI91H	contig_12	15890	15368	522	renamed_GCF_000008685.2	cp32-8	26381	26903	522	100.0	1.338e-114
URI91H	contig_12	16320	17097	777	renamed_GCF_000008685.2	cp32-8	25951	25174	777	100.0	2.863e-174
URI91H	contig_13	447	18	429	renamed_GCF_000008685.2	cp32-9	17301	17730	429	100.0	2.284e-93
URI91H	contig_13	1107	552	555	renamed_GCF_000008685.2	cp32-9	16641	17196	555	100.0	1.867e-116
URI91H	contig_13	1565	1211	354	renamed_GCF_000008685.2	cp32-9	16183	16537	354	100.0	1.459e-77
URI91H	contig_13	1893	1557	336	renamed_GCF_000008685.2	cp32-4	15710	16046	336	100.0	5.348e-69
URI91H	contig_13	2230	1882	348	renamed_GCF_000008685.2	cp32-9	15518	15866	348	100.0	8.822e-74
URI91H	contig_13	2437	2233	204	renamed_GCF_000008685.2	lp56	18712	18916	204	100.0	2.578e-39
URI91H	contig_13	25042	23716	1326	renamed_GCF_000008685.2	cp32-9	23193	24519	1326	100.0	7.132e-300
URI91H	contig_13	25983	25443	540	renamed_GCF_000008685.2	cp32-9	22183	22723	540	100.0	1.782e-114
URI91H	contig_13	26553	25992	561	renamed_GCF_000008685.2	cp32-9	21613	22174	561	100.0	6.308e-121
URI91H	contig_13	27350	26594	756	renamed_GCF_000008685.2	cp32-9	20816	21572	756	100.0	2.151e-165
URI91H	contig_14	3051	4347	1296	renamed_GCF_000008685.2	cp32-4	8977	10273	1296	100.0	2.13e-282
URI91H	contig_14	4369	4966	597	renamed_GCF_000008685.2	cp32-4	10295	10892	597	100.0	4.743e-130
URI91H	contig_14	4969	5920	951	renamed_GCF_000008685.2	cp32-4	10895	11846	951	100.0	4.333e-216
URI91H	contig_14	5937	6492	555	renamed_GCF_000008685.2	cp32-4	11863	12418	555	100.0	3.12e-119
URI91H	contig_14	6521	6854	333	renamed_GCF_000008685.2	cp32-8	12494	12827	333	100.0	8.424e-72
URI91H	contig_14	6850	7726	876	renamed_GCF_000008685.2	cp32-4	12776	13652	876	100.0	5.609e-192
URI91H	contig_14	29324	29780	456	renamed_GCF_000008685.2	cp32-4	4951	5407	456	100.0	1.075e-97
URI91H	contig_14	29779	30163	384	renamed_GCF_000008685.2	cp32-4	5406	5790	384	100.0	2.931e-83
URI91H	contig_15	758	149	609	renamed_GCF_000008685.2	cp32-3	17088	17697	609	100.0	2.836e-129
URI91H	contig_15	1261	943	318	renamed_GCF_000008685.2	cp32-3	16585	16903	318	100.0	2.414e-66
URI91H	contig_15	7582	6898	684	renamed_GCF_000008685.2	cp32-3	10264	10948	684	100.0	6.297e-150
URI91H	contig_15	8879	7604	1275	renamed_GCF_000008685.2	cp32-3	8967	10242	1275	100.0	2.667e-276
URI91H	contig_15	9123	8886	237	renamed_GCF_000008685.2	cp32-1	8723	8960	237	100.0	7.893e-49
URI91H	contig_15	9575	9119	456	renamed_GCF_000008685.2	cp32-8	8271	8727	456	100.0	1.971e-99
URI91H	contig_15	10019	9590	429	renamed_GCF_000008685.2	cp32-7	7829	8258	429	100.0	5.601e-92
URI91H	contig_15	11146	10033	1113	renamed_GCF_000008685.2	cp32-8	6700	7813	1113	100.0	6.876e-247
URI91H	contig_15	26813	26072	741	renamed_GCF_000008685.2	cp32-3	21256	21997	741	100.0	5.003e-162
URI91H	contig_15	27355	26788	567	renamed_GCF_000008685.2	cp32-3	20714	21281	567	100.0	2.944e-130
URI91H	contig_15	28465	27364	1101	renamed_GCF_000008685.2	cp32-3	19604	20705	1101	100.0	1.773e-251
URI91H	contig_15	28841	29783	942	renamed_GCF_000008685.2	cp32-3	19228	18286	942	100.0	4.129e-215
URI91H	contig_16	6322	5371	951	renamed_GCF_000008685.2	cp32-6	10961	11912	951	100.0	4.333e-216
URI91H	contig_16	7009	6325	684	renamed_GCF_000008685.2	cp32-8	10264	10948	684	100.0	3.113e-149
URI91H	contig_16	8306	7031	1275	renamed_GCF_000008685.2	cp32-6	8977	10252	1275	100.0	5.405e-277
URI91H	contig_16	8550	8313	237	renamed_GCF_000008685.2	cp32-6	8733	8970	237	100.0	7.893e-49
URI91H	contig_16	9002	8546	456	renamed_GCF_000008685.2	cp32-3	8271	8727	456	100.0	1.971e-99
URI91H	contig_16	9446	9017	429	renamed_GCF_000008685.2	cp32-8	7827	8256	429	100.0	5.601e-92
URI91H	contig_16	26401	25651	750	renamed_GCF_000008685.2	cp32-6	20720	21470	750	100.0	4.35e-165
URI91H	contig_16	26943	26376	567	renamed_GCF_000008685.2	cp32-6	20178	20745	567	100.0	6.547e-130
URI91H	contig_16	28053	26952	1101	renamed_GCF_000008685.2	cp32-6	19068	20169	1101	100.0	1.945e-250
URI91H	contig_16	28441	29389	948	renamed_GCF_000008685.2	cp32-6	18680	17732	948	100.0	7.628e-218
URI91H	contig_17	12362	11543	819	renamed_GCF_000008685.2	lp28-2	12319	11500	819	100.0	1.075e-183
URI91H	contig_17	12795	12351	444	renamed_GCF_000008685.2	lp28-2	12752	12308	444	100.0	8.866e-98
URI91H	contig_17	13184	12791	393	renamed_GCF_000008685.2	lp28-2	13141	12748	393	100.0	6.841e-84
URI91H	contig_17	13538	13199	339	renamed_GCF_000008685.2	lp28-2	13495	13156	339	100.0	3.422e-74
URI91H	contig_17	14384	13550	834	renamed_GCF_000008685.2	lp28-2	14341	13507	834	100.0	1.239e-184
URI91H	contig_17	14928	14418	510	renamed_GCF_000008685.2	lp28-2	14885	14375	510	100.0	3.606e-110
URI91H	contig_18	8882	8213	669	renamed_GCF_000008685.2	lp28-3	10516	9847	669	100.0	5.739e-140
URI91H	contig_19	1564	1012	552	renamed_GCF_000008685.2	lp36	35867	36422	552	99.4	5.467e-121
URI91H	contig_19	1887	2130	243	renamed_GCF_000008685.2	lp28-4	26036	25793	243	100.0	2.599e-53
URI91H	contig_19	2834	3701	867	renamed_GCF_000008685.2	lp28-4	25089	24222	867	100.0	1.188e-190
URI91H	contig_19	3928	4765	837	renamed_GCF_000008685.2	lp28-4	23995	23158	837	100.0	6.415e-184
URI91H	contig_19	4992	5829	837	renamed_GCF_000008685.2	lp28-4	22931	22094	837	100.0	1.426e-183
URI91H	contig_20	3835	4384	549	renamed_GCF_000008685.2	cp26	10103	10652	549	100.0	6.94e-118
URI91H	contig_20	5149	4651	498	renamed_GCF_000008685.2	cp26	11417	10919	498	100.0	3.608e-108
URI91H	contig_20	5745	7338	1593	renamed_GCF_000008685.2	cp26	12013	13606	1593	100.0	0.0
URI91H	contig_20	8839	7624	1215	renamed_GCF_000008685.2	cp26	15107	13892	1215	100.0	5.333e-267
URI91H	contig_20	20275	20554	279	renamed_GCF_000008685.2	cp26	45	324	279	100.0	2.323e-60
URI91H	contig_20	20981	20537	444	renamed_GCF_000008685.2	cp26	751	307	444	100.0	2.98e-101
URI91H	contig_20	22416	21066	1350	renamed_GCF_000008685.2	cp26	2186	836	1350	100.0	7.868e-303
URI91H	contig_20	24028	22705	1323	renamed_GCF_000008685.2	cp26	3798	2475	1323	100.0	1.419e-291
URI91H	contig_20	24313	24661	348	renamed_GCF_000008685.2	cp26	4083	4431	348	100.0	1.075e-71
URI91H	contig_20	24669	24987	318	renamed_GCF_000008685.2	cp26	4481	4757	318	100.0	7.253e-55
URI91H	contig_22	1414	1708	294	renamed_GCF_000008685.2	lp21	15790	16084	294	100.0	2.432e-62
URI91H	contig_22	2136	1851	285	renamed_GCF_000008685.2	lp21	16548	16227	285	100.0	4.225e-63
URI91H	contig_22	2509	3502	993	renamed_GCF_000008685.2	lp5	3339	4332	993	100.0	1.858e-215
URI91H	contig_22	3557	3989	432	renamed_GCF_000008685.2	lp5	4387	4819	432	99.3	2.641e-92
URI91H	contig_1	93414	92868	546	renamed_GCF_000008685.2	chromosome	93423	92877	546	100.0	2.704e-119
URI91H	contig_1	94023	93423	600	renamed_GCF_000008685.2	chromosome	94032	93432	600	100.0	1.47e-126
URI91H	contig_1	94596	94209	387	renamed_GCF_000008685.2	chromosome	94605	94218	387	100.0	1.031e-86
URI91H	contig_1	96944	94601	2343	renamed_GCF_000008685.2	chromosome	96953	94610	2343	100.0	0.0
URI91H	contig_1	97857	96933	924	renamed_GCF_000008685.2	chromosome	97866	96942	924	100.0	7.888e-205
URI91H	contig_1	98639	97853	786	renamed_GCF_000008685.2	chromosome	98648	97862	786	100.0	2.735e-176
URI91H	contig_1	127404	126306	1098	renamed_GCF_000008685.2	chromosome	127413	126315	1098	100.0	1.369e-236
URI91H	contig_1	130123	127417	2706	renamed_GCF_000008685.2	chromosome	130132	127426	2706	100.0	0.0
URI91H	contig_1	131105	130160	945	renamed_GCF_000008685.2	chromosome	131114	130169	945	100.0	6.888e-210
URI91H	contig_1	131288	132416	1128	renamed_GCF_000008685.2	chromosome	131297	132425	1128	100.0	3.566e-248
URI91H	contig_1	147488	146369	1119	renamed_GCF_000008685.2	chromosome	147495	146376	1119	100.0	3.727e-246
URI91H	contig_1	148652	147641	1011	renamed_GCF_000008685.2	chromosome	148659	147648	1011	100.0	5.463e-215
URI91H	contig_1	150966	152172	1206	renamed_GCF_000008685.2	chromosome	150973	152179	1206	100.0	4.93e-275
URI91H	contig_1	152198	153005	807	renamed_GCF_000008685.2	chromosome	152205	153012	807	100.0	9.769e-183
URI91H	contig_1	153679	153067	612	renamed_GCF_000008685.2	chromosome	153686	153074	612	100.0	4.712e-141
URI91H	contig_1	176967	176061	906	renamed_GCF_000008685.2	chromosome	176974	176068	906	100.0	1.374e-195
URI91H	contig_1	177846	176970	876	renamed_GCF_000008685.2	chromosome	177853	176977	876	100.0	9.427e-195
URI91H	contig_1	178853	177860	993	renamed_GCF_000008685.2	chromosome	178860	177867	993	100.0	4.528e-214
URI91H	contig_1	179536	178909	627	renamed_GCF_000008685.2	chromosome	179543	178916	627	100.0	1.275e-132
URI91H	contig_1	189269	189068	201	renamed_GCF_000008685.2	chromosome	189276	189075	201	100.0	9.889e-41
URI91H	contig_1	189852	189291	561	renamed_GCF_000008685.2	chromosome	189859	189298	561	100.0	1.275e-121
URI91H	contig_1	190056	190710	654	renamed_GCF_000008685.2	chromosome	190186	190717	654	100.0	6.314e-111
URI91H	contig_1	190711	191452	741	renamed_GCF_000008685.2	chromosome	190718	191459	741	100.0	7.281e-158
URI91H	contig_1	192320	191510	810	renamed_GCF_000008685.2	chromosome	192327	191517	810	100.0	2.276e-182
URI91H	contig_1	229209	230217	1008	renamed_GCF_000008685.2	chromosome	229216	230224	1008	100.0	1.228e-222
URI91H	contig_1	231484	230206	1278	renamed_GCF_000008685.2	chromosome	231491	230213	1278	100.0	4.58e-288
URI91H	contig_1	231613	232315	702	renamed_GCF_000008685.2	chromosome	231620	232322	702	100.0	1.161e-154
URI91H	contig_1	232330	235246	2916	renamed_GCF_000008685.2	chromosome	232337	235253	2916	100.0	0.0
URI91H	contig_1	235527	235281	246	renamed_GCF_000008685.2	chromosome	235534	235288	246	100.0	3.025e-52
URI91H	contig_1	237135	235587	1548	renamed_GCF_000008685.2	chromosome	237142	235594	1548	100.0	0.0
URI91H	contig_1	237622	237214	408	renamed_GCF_000008685.2	chromosome	237629	237221	408	100.0	2.649e-88
URI91H	contig_1	237949	237622	327	renamed_GCF_000008685.2	chromosome	237956	237629	327	100.0	8.435e-71
URI91H	contig_1	238219	237961	258	renamed_GCF_000008685.2	chromosome	238226	237968	258	100.0	9.113e-51
URI91H	contig_1	239121	238293	828	renamed_GCF_000008685.2	chromosome	239128	238300	828	100.0	9.354e-187
URI91H	contig_1	267058	267268	210	renamed_GCF_000008685.2	chromosome	267065	267275	210	100.0	4.647e-42
URI91H	contig_1	270466	269665	801	renamed_GCF_000008685.2	chromosome	270473	269672	801	100.0	6.66e-169
URI91H	contig_1	272673	270480	2193	renamed_GCF_000008685.2	chromosome	272641	270487	2193	100.0	0.0
URI91H	contig_1	283858	282691	1167	renamed_GCF_000008685.2	chromosome	283865	282698	1167	100.0	1.172e-258
URI91H	contig_1	285952	283861	2091	renamed_GCF_000008685.2	chromosome	285962	283868	2091	99.8	0.0
URI91H	contig_1	287082	285963	1119	renamed_GCF_000008685.2	chromosome	287089	285970	1119	100.0	9.957e-244
URI91H	contig_1	287870	287081	789	renamed_GCF_000008685.2	chromosome	287877	287088	789	100.0	1.783e-164
URI91H	contig_1	288166	287902	264	renamed_GCF_000008685.2	chromosome	288173	287909	264	100.0	2.025e-51
URI91H	contig_1	288939	288174	765	renamed_GCF_000008685.2	chromosome	288946	288181	765	100.0	2.478e-165
URI91H	contig_1	297038	296420	618	renamed_GCF_000008685.2	chromosome	297045	296427	618	100.0	5.47e-132
URI91H	contig_1	297462	297030	432	renamed_GCF_000008685.2	chromosome	297469	297037	432	100.0	1.974e-95
URI91H	contig_1	298769	297458	1311	renamed_GCF_000008685.2	chromosome	298776	297465	1311	100.0	6.981e-289
URI91H	contig_1	299708	298787	921	renamed_GCF_000008685.2	chromosome	299715	298794	921	100.0	4.644e-193
URI91H	contig_1	319110	318270	840	renamed_GCF_000008685.2	chromosome	319116	318276	840	99.6	1.977e-180
URI91H	contig_1	319630	319099	531	renamed_GCF_000008685.2	chromosome	319636	319105	531	100.0	1.699e-113
URI91H	contig_1	320252	319673	579	renamed_GCF_000008685.2	chromosome	320249	319679	579	99.4	6.936e-123
URI91H	contig_1	320302	321346	1044	renamed_GCF_000008685.2	chromosome	320308	321352	1044	100.0	3.013e-227
URI91H	contig_1	321345	322032	687	renamed_GCF_000008685.2	chromosome	321351	322038	687	100.0	1.336e-150
URI91H	contig_1	322840	322033	807	renamed_GCF_000008685.2	chromosome	322846	322039	807	99.6	2.064e-174
URI91H	contig_1	338351	339977	1626	renamed_GCF_000008685.2	chromosome	338357	339983	1626	100.0	0.0
URI91H	contig_1	340334	341255	921	renamed_GCF_000008685.2	chromosome	340340	341261	921	100.0	2.92e-198
URI91H	contig_1	341267	342317	1050	renamed_GCF_000008685.2	chromosome	341273	342323	1050	100.0	1.489e-227
URI91H	contig_1	353434	351334	2100	renamed_GCF_000008685.2	chromosome	353437	351340	2100	100.0	0.0
URI91H	contig_1	354630	353433	1197	renamed_GCF_000008685.2	chromosome	354636	353439	1197	100.0	5.312e-264
URI91H	contig_1	355292	354641	651	renamed_GCF_000008685.2	chromosome	355298	354647	651	100.0	1.769e-141
URI91H	contig_1	355484	356903	1419	renamed_GCF_000008685.2	chromosome	355490	356909	1419	100.0	1.415e-316
URI91H	contig_1	357000	358434	1434	renamed_GCF_000008685.2	chromosome	357006	358440	1434	100.0	9.657e-315
URI91H	contig_1	358451	359192	741	renamed_GCF_000008685.2	chromosome	358457	359198	741	100.0	9.218e-164
URI91H	contig_1	359489	359210	279	renamed_GCF_000008685.2	chromosome	359495	359216	279	100.0	2.841e-58
URI91H	contig_1	361072	359506	1566	renamed_GCF_000008685.2	chromosome	361078	359512	1566	100.0	0.0
URI91H	contig_1	361193	362315	1122	renamed_GCF_000008685.2	chromosome	361187	362321	1122	100.0	1.01e-252
URI91H	contig_1	364111	362311	1800	renamed_GCF_000008685.2	chromosome	364117	362317	1800	100.0	0.0
URI91H	contig_1	374145	373560	585	renamed_GCF_000008685.2	chromosome	374151	373566	585	100.0	4.312e-129
URI91H	contig_1	374270	375647	1377	renamed_GCF_000008685.2	chromosome	374276	375653	1377	100.0	1.277e-310
URI91H	contig_1	375654	375933	279	renamed_GCF_000008685.2	chromosome	375660	375939	279	100.0	3.143e-57
URI91H	contig_1	377013	375954	1059	renamed_GCF_000008685.2	chromosome	377019	375960	1059	100.0	5.328e-232
URI91H	contig_1	379324	377032	2292	renamed_GCF_000008685.2	chromosome	379258	377038	2292	99.8	0.0
URI91H	contig_1	380552	379334	1218	renamed_GCF_000008685.2	chromosome	380558	379340	1218	100.0	1.741e-271
URI91H	contig_1	406170	405681	489	renamed_GCF_000008685.2	chromosome	406176	405687	489	100.0	1.238e-101
URI91H	contig_1	406855	406174	681	renamed_GCF_000008685.2	chromosome	406861	406180	681	100.0	2.702e-150
URI91H	contig_1	407286	406854	432	renamed_GCF_000008685.2	chromosome	407292	406860	432	100.0	3.534e-89
URI91H	contig_1	407892	407337	555	renamed_GCF_000008685.2	chromosome	407898	407343	555	100.0	5.734e-121
URI91H	contig_1	417095	417707	612	renamed_GCF_000008685.2	chromosome	417101	417713	612	100.0	4.975e-132
URI91H	contig_1	417717	418329	612	renamed_GCF_000008685.2	chromosome	417723	418335	612	100.0	3.097e-137
URI91H	contig_1	419500	418381	1119	renamed_GCF_000008685.2	chromosome	419506	418387	1119	100.0	8.015e-255
URI91H	contig_1	421374	419496	1878	renamed_GCF_000008685.2	chromosome	421380	419502	1878	100.0	0.0
URI91H	contig_1	421547	422177	630	renamed_GCF_000008685.2	chromosome	421553	422183	630	100.0	5.705e-142
URI91H	contig_1	454468	452035	2433	renamed_GCF_000008685.2	chromosome	454472	452039	2433	100.0	0.0
URI91H	contig_1	456384	454479	1905	renamed_GCF_000008685.2	chromosome	456388	454483	1905	100.0	0.0
URI91H	contig_1	456571	458032	1461	renamed_GCF_000008685.2	chromosome	456575	458036	1461	100.0	0.0
URI91H	contig_1	458272	459430	1158	renamed_GCF_000008685.2	chromosome	458276	459434	1158	100.0	2.482e-257
URI91H	contig_1	459520	459820	300	renamed_GCF_000008685.2	chromosome	459524	459824	300	100.0	7.304e-60
URI91H	contig_1	459911	460067	156	renamed_GCF_000008685.2	chromosome	459915	460071	156	100.0	2.965e-30
URI91H	contig_1	460047	460407	360	renamed_GCF_000008685.2	chromosome	460051	460411	360	100.0	4.812e-74
URI91H	contig_1	462040	462769	729	renamed_GCF_000008685.2	chromosome	462044	462773	729	100.0	2.248e-160
URI91H	contig_1	462814	463882	1068	renamed_GCF_000008685.2	chromosome	462818	463886	1068	100.0	4.491e-244
URI91H	contig_1	486069	486765	696	renamed_GCF_000008685.2	chromosome	486073	486769	696	100.0	2.835e-152
URI91H	contig_1	486712	487534	822	renamed_GCF_000008685.2	chromosome	486746	487538	822	100.0	1.872e-169
URI91H	contig_1	487530	488220	690	renamed_GCF_000008685.2	chromosome	487534	488224	690	100.0	9.609e-155
URI91H	contig_1	488221	488968	747	renamed_GCF_000008685.2	chromosome	488225	488972	747	100.0	3.778e-166
URI91H	contig_1	497890	498187	297	renamed_GCF_000008685.2	chromosome	497894	498191	297	100.0	5.69e-62
URI91H	contig_1	498208	499042	834	renamed_GCF_000008685.2	chromosome	498212	499046	834	100.0	1.895e-188
URI91H	contig_1	499051	499330	279	renamed_GCF_000008685.2	chromosome	499055	499334	279	100.0	1.411e-57
URI91H	contig_1	499336	499699	363	renamed_GCF_000008685.2	chromosome	499340	499703	363	100.0	3.407e-78
URI91H	contig_1	499702	500584	882	renamed_GCF_000008685.2	chromosome	499706	500588	882	100.0	1.248e-192
URI91H	contig_1	500588	501005	417	renamed_GCF_000008685.2	chromosome	500592	501009	417	100.0	2.778e-89
URI91H	contig_1	513135	512388	747	renamed_GCF_000008685.2	chromosome	513139	512392	747	100.0	7.284e-159
URI91H	contig_1	513221	514523	1302	renamed_GCF_000008685.2	chromosome	513225	514527	1302	100.0	1.62e-286
URI91H	contig_1	514519	515779	1260	renamed_GCF_000008685.2	chromosome	514523	515783	1260	100.0	5.48e-283
URI91H	contig_1	534292	535147	855	renamed_GCF_000008685.2	chromosome	534300	535155	855	100.0	8.967e-192
URI91H	contig_1	535592	535169	423	renamed_GCF_000008685.2	chromosome	535600	535177	423	100.0	5.606e-91
URI91H	contig_1	535695	537519	1824	renamed_GCF_000008685.2	chromosome	535703	537527	1824	100.0	0.0
URI91H	contig_1	537511	538300	789	renamed_GCF_000008685.2	chromosome	537543	538308	789	99.6	2.994e-167
URI91H	contig_1	539267	538319	948	renamed_GCF_000008685.2	chromosome	539275	538327	948	100.0	1.008e-214
URI91H	contig_1	561934	561553	381	renamed_GCF_000008685.2	chromosome	561943	561562	381	100.0	2.258e-77
URI91H	contig_1	562175	564158	1983	renamed_GCF_000008685.2	chromosome	562184	564167	1983	100.0	0.0
URI91H	contig_1	565960	567814	1854	renamed_GCF_000008685.2	chromosome	565954	567823	1854	99.8	0.0
URI91H	contig_1	577385	577928	543	renamed_GCF_000008685.2	chromosome	577394	577937	543	100.0	3.121e-117
URI91H	contig_1	577940	578252	312	renamed_GCF_000008685.2	chromosome	577949	578261	312	100.0	5.387e-65
URI91H	contig_1	578267	580412	2145	renamed_GCF_000008685.2	chromosome	578276	580421	2145	100.0	0.0
URI91H	contig_1	580476	581634	1158	renamed_GCF_000008685.2	chromosome	580485	581643	1158	100.0	7.971e-253
URI91H	contig_1	581635	583408	1773	renamed_GCF_000008685.2	chromosome	581644	583417	1773	100.0	0.0
URI91H	contig_1	583448	583823	375	renamed_GCF_000008685.2	chromosome	583457	583832	375	100.0	8.349e-79
URI91H	contig_1	596521	598582	2061	renamed_GCF_000008685.2	chromosome	596530	598591	2061	100.0	0.0
URI91H	contig_1	599367	598578	789	renamed_GCF_000008685.2	chromosome	599376	598587	789	100.0	1.07e-178
URI91H	contig_1	599485	600835	1350	renamed_GCF_000008685.2	chromosome	599494	600844	1350	100.0	3.989e-293
URI91H	contig_1	601000	602335	1335	renamed_GCF_000008685.2	chromosome	601009	602344	1335	100.0	3.161e-293
URI91H	contig_1	616381	615754	627	renamed_GCF_000008685.2	chromosome	616390	615763	627	100.0	5.736e-133
URI91H	contig_1	618550	616402	2148	renamed_GCF_000008685.2	chromosome	618559	616411	2148	100.0	0.0
URI91H	contig_1	618818	621026	2208	renamed_GCF_000008685.2	chromosome	618827	621035	2208	100.0	0.0
URI91H	contig_1	621944	621035	909	renamed_GCF_000008685.2	chromosome	621953	621044	909	100.0	1.521e-203
URI91H	contig_1	621995	623438	1443	renamed_GCF_000008685.2	chromosome	622004	623447	1443	100.0	0.0
URI91H	contig_1	623441	624998	1557	renamed_GCF_000008685.2	chromosome	623450	625007	1557	100.0	0.0
URI91H	contig_1	650377	649159	1218	renamed_GCF_000008685.2	chromosome	650387	649169	1218	100.0	2.758e-266
URI91H	contig_1	653780	650402	3378	renamed_GCF_000008685.2	chromosome	653790	650412	3378	100.0	0.0
URI91H	contig_1	653876	654839	963	renamed_GCF_000008685.2	chromosome	653886	654849	963	100.0	5.23e-216
URI91H	contig_1	654798	656892	2094	renamed_GCF_000008685.2	chromosome	654862	656902	2094	99.8	0.0
URI91H	contig_1	675023	676367	1344	renamed_GCF_000008685.2	chromosome	675034	676378	1344	100.0	3.635e-293
URI91H	contig_1	676460	677849	1389	renamed_GCF_000008685.2	chromosome	676471	677860	1389	100.0	1.442e-302
URI91H	contig_1	678927	677880	1047	renamed_GCF_000008685.2	chromosome	678938	677891	1047	100.0	5.633e-238
URI91H	contig_1	679739	678947	792	renamed_GCF_000008685.2	chromosome	679750	678958	792	100.0	1.55e-166
URI91H	contig_1	680552	679742	810	renamed_GCF_000008685.2	chromosome	680557	679753	810	99.6	5.278e-173
URI91H	contig_1	681595	680551	1044	renamed_GCF_000008685.2	chromosome	681606	680562	1044	100.0	8.539e-233
URI91H	contig_1	692617	693517	900	renamed_GCF_000008685.2	chromosome	692628	693528	900	100.0	8.957e-191
URI91H	contig_1	693542	694685	1143	renamed_GCF_000008685.2	chromosome	693553	694696	1143	100.0	3.979e-258
URI91H	contig_1	695512	694681	831	renamed_GCF_000008685.2	chromosome	695523	694692	831	100.0	5.839e-184
URI91H	contig_1	695619	696753	1134	renamed_GCF_000008685.2	chromosome	695630	696764	1134	100.0	1.419e-259
URI91H	contig_1	697426	696739	687	renamed_GCF_000008685.2	chromosome	697437	696750	687	100.0	2.97e-150
URI91H	contig_1	697574	698321	747	renamed_GCF_000008685.2	chromosome	697585	698332	747	100.0	1.547e-167
URI91H	contig_1	699954	698388	1566	renamed_GCF_000008685.2	chromosome	699965	698399	1566	100.0	0.0
URI91H	contig_1	700913	700040	873	renamed_GCF_000008685.2	chromosome	700924	700051	873	100.0	5.874e-191
URI91H	contig_1	701017	701374	357	renamed_GCF_000008685.2	chromosome	701028	701385	357	100.0	2.301e-81
URI91H	contig_1	701383	701794	411	renamed_GCF_000008685.2	chromosome	701394	701805	411	100.0	2.78e-88
URI91H	contig_1	712196	711680	516	renamed_GCF_000008685.2	chromosome	712207	711691	516	100.0	1.621e-111
URI91H	contig_1	713239	712192	1047	renamed_GCF_000008685.2	chromosome	713250	712203	1047	100.0	1.709e-225
URI91H	contig_1	714096	713232	864	renamed_GCF_000008685.2	chromosome	714107	713243	864	100.0	1.134e-190
URI91H	contig_1	714755	714092	663	renamed_GCF_000008685.2	chromosome	714766	714103	663	100.0	1.333e-146
URI91H	contig_1	728654	729608	954	renamed_GCF_000008685.2	chromosome	728665	729619	954	100.0	1.334e-212
URI91H	contig_1	729601	730495	894	renamed_GCF_000008685.2	chromosome	729612	730506	894	100.0	2.531e-195
URI91H	contig_1	731088	730620	468	renamed_GCF_000008685.2	chromosome	731099	730631	468	100.0	1.969e-101
URI91H	contig_1	731172	731709	537	renamed_GCF_000008685.2	chromosome	731183	731720	537	100.0	1.936e-121
URI91H	contig_1	731782	733792	2010	renamed_GCF_000008685.2	chromosome	731793	733803	2010	100.0	0.0
URI91H	contig_1	734069	735278	1209	renamed_GCF_000008685.2	chromosome	734080	735289	1209	100.0	8.188e-270
URI91H	contig_1	753212	754058	846	renamed_GCF_000008685.2	chromosome	753291	754068	846	100.0	1.342e-168
URI91H	contig_1	754057	754540	483	renamed_GCF_000008685.2	chromosome	754067	754550	483	100.0	1.405e-107
URI91H	contig_1	754539	756339	1800	renamed_GCF_000008685.2	chromosome	754636	756349	1800	100.0	0.0
URI91H	contig_1	756343	757660	1317	renamed_GCF_000008685.2	chromosome	756353	757670	1317	100.0	1.293e-291
URI91H	contig_1	783238	782965	273	renamed_GCF_000008685.2	chromosome	783248	782975	273	100.0	3.858e-54
URI91H	contig_1	783379	785011	1632	renamed_GCF_000008685.2	chromosome	783389	785021	1632	100.0	0.0
URI91H	contig_1	785046	786744	1698	renamed_GCF_000008685.2	chromosome	785056	786754	1698	100.0	0.0
URI91H	contig_1	786849	788952	2103	renamed_GCF_000008685.2	chromosome	786859	788962	2103	100.0	0.0
URI91H	contig_1	789292	789928	636	renamed_GCF_000008685.2	chromosome	789302	789938	636	100.0	6.275e-142
URI91H	contig_1	790797	789936	861	renamed_GCF_000008685.2	chromosome	790807	789946	861	100.0	1.57e-186
URI91H	contig_1	811501	810460	1041	renamed_GCF_000008685.2	chromosome	811510	810469	1041	100.0	2.778e-236
URI91H	contig_1	812379	811497	882	renamed_GCF_000008685.2	chromosome	812388	811506	882	100.0	2.526e-193
URI91H	contig_1	813230	812429	801	renamed_GCF_000008685.2	chromosome	813239	812438	801	100.0	9.279e-174
URI91H	contig_1	813706	813376	330	renamed_GCF_000008685.2	chromosome	813706	813385	330	97.2	1.608e-64
URI91H	contig_1	820606	821188	582	renamed_GCF_000008685.2	chromosome	820606	821188	582	100.0	9.143e-129
URI91H	contig_1	821184	822369	1185	renamed_GCF_000008685.2	chromosome	821184	822369	1185	100.0	1.177e-261
URI91H	contig_1	822343	822694	351	renamed_GCF_000008685.2	chromosome	822343	822694	351	100.0	6.889e-77
URI91H	contig_1	822809	823103	294	renamed_GCF_000008685.2	chromosome	822809	823103	294	100.0	1.207e-61
URI91H	contig_1	823262	823811	549	renamed_GCF_000008685.2	chromosome	823262	823811	549	100.0	1.698e-116
URI91H	contig_1	823815	824382	567	renamed_GCF_000008685.2	chromosome	823815	824382	567	100.0	1.275e-122
URI91H	contig_1	824381	825704	1323	renamed_GCF_000008685.2	chromosome	824381	825704	1323	100.0	8.966e-297
URI91H	contig_1	825700	827620	1920	renamed_GCF_000008685.2	chromosome	825700	827620	1920	100.0	0.0
URI91H	contig_1	827630	829112	1482	renamed_GCF_000008685.2	chromosome	827630	829112	1482	100.0	0.0
URI91H	contig_1	829217	830321	1104	renamed_GCF_000008685.2	chromosome	829217	830321	1104	100.0	4.529e-250
URI91H	contig_1	847092	847455	363	renamed_GCF_000008685.2	chromosome	847125	847488	363	100.0	2.269e-74
URI91H	contig_1	847457	848306	849	renamed_GCF_000008685.2	chromosome	847490	848339	849	100.0	6.426e-186
URI91H	contig_1	848504	848771	267	renamed_GCF_000008685.2	chromosome	848537	848804	267	100.0	3.495e-54
URI91H	contig_1	848785	850954	2169	renamed_GCF_000008685.2	chromosome	848836	850987	2169	99.8	0.0
URI91H	contig_1	850960	852481	1521	renamed_GCF_000008685.2	chromosome	850993	852514	1521	100.0	0.0
URI91H	contig_1	852455	853745	1290	renamed_GCF_000008685.2	chromosome	852488	853778	1290	100.0	6.634e-286
URI91H	contig_1	865883	866426	543	renamed_GCF_000008685.2	chromosome	865915	866458	543	100.0	2.343e-120
URI91H	contig_1	866461	866662	201	renamed_GCF_000008685.2	chromosome	866493	866694	201	100.0	2.206e-40
URI91H	contig_1	866648	867569	921	renamed_GCF_000008685.2	chromosome	866680	867601	921	100.0	3.086e-206
URI91H	contig_1	868082	867710	372	renamed_GCF_000008685.2	chromosome	868114	867742	372	100.0	7.954e-79
URI91H	contig_1	886415	884195	2220	renamed_GCF_000008685.2	chromosome	886447	884227	2220	100.0	0.0
URI91H	contig_1	888147	886437	1710	renamed_GCF_000008685.2	chromosome	888179	886469	1710	100.0	0.0
URI91H	contig_1	890289	893142	2853	renamed_GCF_000008685.2	chromosome	890321	893174	2853	100.0	0.0
URI91H	contig_1	893096	896537	3441	renamed_GCF_000008685.2	chromosome	893128	896569	3441	100.0	0.0
URI91H	contig_1	897095	896546	549	renamed_GCF_000008685.2	chromosome	897127	896578	549	100.0	1.159e-120
URI91H	contig_2	21350	20861	489	renamed_GCF_000008685.2	lp54	32260	32749	489	100.0	3.125e-108
URI91H	contig_2	21831	21408	423	renamed_GCF_000008685.2	lp54	31779	32202	423	100.0	5.086e-92
URI91H	contig_2	22901	21830	1071	renamed_GCF_000008685.2	lp54	30709	31780	1071	100.0	2.191e-235
URI91H	contig_2	23517	22977	540	renamed_GCF_000008685.2	lp54	30093	30633	540	100.0	4.969e-120
URI91H	contig_2	32514	31974	540	renamed_GCF_000008685.2	lp54	21086	21626	540	100.0	8.011e-115
URI91H	contig_2	32883	32688	195	renamed_GCF_000008685.2	lp54	20717	20912	195	100.0	2.214e-39
URI91H	contig_2	34876	33523	1353	renamed_GCF_000008685.2	lp54	18724	20077	1353	100.0	1.524e-304
URI91H	contig_2	35473	34879	594	renamed_GCF_000008685.2	lp54	18127	18721	594	100.0	1.47e-125
URI91H	contig_2	36341	36905	564	renamed_GCF_000008685.2	lp54	17259	16695	564	100.0	1.065e-115
URI91H	contig_2	37024	37600	576	renamed_GCF_000008685.2	lp54	16576	16000	576	100.0	1.337e-123
URI91H	contig_3	7665	10926	3261	renamed_GCF_000008685.2	lp56	43696	40435	3261	100.0	0.0
URI91H	contig_3	21425	20387	1038	renamed_GCF_000008685.2	lp56	29936	30974	1038	100.0	2.28e-229
URI91H	contig_3	21855	22632	777	renamed_GCF_000008685.2	lp56	29506	28729	777	100.0	6.363e-174
URI91H	contig_3	23063	22637	426	renamed_GCF_000008685.2	lp56	28298	28724	426	100.0	8.877e-95
URI91H	contig_3	24441	23115	1326	renamed_GCF_000008685.2	lp56	26920	28246	1326	100.0	3.211e-300
URI91H	contig_3	25472	24935	537	renamed_GCF_000008685.2	lp56	25889	26426	537	100.0	1.544e-115
URI91H	contig_3	40065	39636	429	renamed_GCF_000008685.2	cp32-3	7827	8256	429	100.0	5.601e-92
URI91H	contig_3	42124	41734	390	renamed_GCF_000008685.2	cp32-1	5767	6157	390	100.0	3.229e-83
URI91H	contig_4	1070	773	297	renamed_GCF_000008685.2	lp38	34668	34371	297	100.0	2.824e-61
URI91H	contig_4	1993	1306	687	renamed_GCF_000008685.2	lp38	35591	34904	687	100.0	9.164e-155
URI91H	contig_4	2650	2035	615	renamed_GCF_000008685.2	lp38	36248	35633	615	100.0	2.836e-130
URI91H	contig_5	423	1422	999	renamed_GCF_000008685.2	lp36	34079	33080	999	100.0	2.04e-215
URI91H	contig_5	1680	2676	996	renamed_GCF_000008685.2	lp36	32822	31826	996	100.0	2.481e-221
URI91H	contig_5	2917	3784	867	renamed_GCF_000008685.2	lp36	31585	30718	867	100.0	3.181e-188
URI91H	contig_5	4039	5026	987	renamed_GCF_000008685.2	lp36	30463	29476	987	100.0	5.255e-220
URI91H	contig_5	6214	7120	906	renamed_GCF_000008685.2	lp36	28288	27382	906	100.0	5.634e-197
URI91H	contig_5	7699	7918	219	renamed_GCF_000008685.2	lp36	26803	26584	219	100.0	9.792e-44
URI91H	contig_5	28137	27852	285	renamed_GCF_000008685.2	lp36	6365	6650	285	100.0	1.151e-60
URI91H	contig_5	28462	29215	753	renamed_GCF_000008685.2	lp36	6040	5287	753	100.0	7.287e-160
URI91H	contig_6	12019	13120	1101	renamed_GCF_000008685.2	lp28-1	15451	14350	1101	100.0	2.133e-249
URI91H	contig_6	13141	13702	561	renamed_GCF_000008685.2	lp28-1	14329	13768	561	100.0	4.308e-125
URI91H	contig_6	13677	14442	765	renamed_GCF_000008685.2	lp28-1	13793	13028	765	100.0	1.871e-168
URI91H	contig_6	14478	15030	552	renamed_GCF_000008685.2	lp28-1	12992	12440	552	100.0	6.015e-120
URI91H	contig_7	8800	9337	537	renamed_GCF_000008685.2	lp25	15545	15041	537	99.4	7.638e-115
URI91H	contig_8	412	976	564	renamed_GCF_000008685.2	cp32-6	2009	2573	564	100.0	2.235e-124
URI91H	contig_8	979	1747	768	renamed_GCF_000008685.2	cp32-6	2576	3344	768	100.0	1.48e-171
URI91H	contig_8	2372	3332	960	renamed_GCF_000008685.2	cp32-6	3969	4929	960	100.0	6.008e-214
URI91H	contig_9	275	968	693	renamed_GCF_000008685.2	cp32-1	1305	1998	693	100.0	2.582e-144
URI91H	contig_9	980	1538	558	renamed_GCF_000008685.2	cp32-1	2010	2568	558	100.0	1.105e-122
URI91H	contig_9	1544	2309	765	renamed_GCF_000008685.2	cp32-1	2574	3339	765	100.0	3.139e-171
URI91H	contig_9	2932	3892	960	renamed_GCF_000008685.2	cp32-1	3962	4922	960	100.0	6.593e-213
URI91H	contig_9	3911	4367	456	renamed_GCF_000008685.2	cp32-1	4941	5397	456	100.0	1.075e-97
URI91H	contig_9	10889	11435	546	renamed_GCF_000008685.2	cp32-8	11919	12465	546	100.0	7.28e-117
URI91H	contig_9	11464	11797	333	renamed_GCF_000008685.2	cp32-3	12494	12827	333	100.0	8.424e-72
URI91H	contig_9	11793	12669	876	renamed_GCF_000008685.2	cp32-8	12823	13699	876	100.0	1.247e-191
URI91H	contig_9	12678	13284	606	renamed_GCF_000008685.2	cp32-8	13708	14314	606	100.0	5.47e-130
URI91H	contig_9	13293	14109	816	renamed_GCF_000008685.2	cp32-8	14323	15139	816	100.0	1.636e-178
URI91H	contig_9	14184	14388	204	renamed_GCF_000008685.2	cp32-3	15211	15415	204	100.0	2.578e-39
URI91H	contig_10	13598	14414	816	renamed_GCF_000008685.2	cp32-1	14323	15139	816	100.0	1.636e-178
URI91H	contig_10	14489	14693	204	renamed_GCF_000008685.2	cp32-8	15214	15418	204	100.0	2.578e-39
URI91H	contig_10	15033	15369	336	renamed_GCF_000008685.2	cp32-6	15774	16110	336	100.0	5.348e-69
URI91H	contig_10	23856	24282	426	renamed_GCF_000008685.2	cp32-1	24608	25034	426	100.0	1.627e-96
URI91H	contig_10	25064	24287	777	renamed_GCF_000008685.2	cp32-1	25816	25039	777	100.0	2.863e-174
URI91H	contig_10	25494	26016	522	renamed_GCF_000008685.2	cp32-1	26234	26768	522	100.0	1.338e-114
URI91H	contig_10	26043	27180	1137	renamed_GCF_000008685.2	cp32-8	26930	28067	1137	100.0	3.741e-249
URI91H	contig_10	28082	28649	567	renamed_GCF_000008685.2	cp32-1	28834	29401	567	100.0	2.836e-122
URI91H	contig_11	19376	18497	879	renamed_GCF_000008685.2	cp32-7	12831	13710	879	99.3	7.082e-190
URI91H	contig_11	19705	19372	333	renamed_GCF_000008685.2	cp32-7	12502	12835	333	100.0	1.876e-71
URI91H	contig_11	20280	19734	546	renamed_GCF_000008685.2	cp32-7	11927	12473	546	100.0	8.009e-116
URI91H	contig_11	21891	20304	1587	renamed_GCF_000008685.2	cp32-7	10961	11903	1587	99.6	9.214e-207
URI91H	contig_11	23214	21903	1311	renamed_GCF_000008685.2	cp32-7	8969	10304	1311	81.0	8.725e-234
URI91H	contig_12	6445	5989	456	renamed_GCF_000008685.2	cp32-7	4940	5396	456	100.0	1.075e-97
URI91H	contig_12	7424	6464	960	renamed_GCF_000008685.2	cp32-7	3961	4921	960	100.0	6.593e-213
URI91H	contig_12	17528	17102	426	renamed_GCF_000008685.2	cp32-6	24618	25044	426	100.0	8.056e-96
URI91H	contig_12	18906	17580	1326	renamed_GCF_000008685.2	cp32-7	23134	24460	1326	99.7	3.211e-300
URI91H	contig_12	25986	25632	354	renamed_GCF_000008685.2	cp32-8	16086	16440	354	100.0	1.459e-77
URI91H	contig_12	26858	26654	204	renamed_GCF_000008685.2	cp32-9	15311	15515	204	100.0	2.578e-39
URI91H	contig_12	27749	26933	816	renamed_GCF_000008685.2	cp32-7	14330	15146	816	100.0	1.636e-178
URI91H	contig_12	28364	27758	606	renamed_GCF_000008685.2	cp32-4	13661	14267	606	100.0	5.47e-130
URI91H	contig_13	9744	9315	429	renamed_GCF_000008685.2	cp32-4	7837	8266	429	100.0	5.601e-92
URI91H	contig_13	11418	10851	567	renamed_GCF_000008685.2	cp32-9	6169	6736	567	99.4	4.74e-125
URI91H	contig_13	11804	11414	390	renamed_GCF_000008685.2	cp32-8	5767	6157	390	100.0	3.229e-83
URI91H	contig_13	27892	27325	567	renamed_GCF_000008685.2	cp32-9	20274	20841	567	100.0	1.456e-129
URI91H	contig_13	29003	27902	1101	renamed_GCF_000008685.2	cp32-9	19163	20264	1101	100.0	3.592e-252
URI91H	contig_14	237	804	567	renamed_GCF_000008685.2	cp32-4	6163	6730	567	100.0	1.054e-124
URI91H	contig_14	14140	14707	567	renamed_GCF_000008685.2	cp32-4	20066	20633	567	100.0	2.944e-130
URI91H	contig_14	14682	15438	756	renamed_GCF_000008685.2	cp32-4	20608	21364	756	100.0	8.022e-168
URI91H	contig_14	15488	16034	546	renamed_GCF_000008685.2	cp32-4	21414	21960	546	100.0	3.273e-117
URI91H	contig_14	16904	18230	1326	renamed_GCF_000008685.2	cp32-4	22830	24156	1326	100.0	6.506e-301
URI91H	contig_14	18283	18709	426	renamed_GCF_000008685.2	cp32-4	24209	24635	426	100.0	8.056e-96
URI91H	contig_14	19509	18714	795	renamed_GCF_000008685.2	cp32-4	25435	24640	795	100.0	5.809e-178
URI91H	contig_14	20078	20894	816	renamed_GCF_000008685.2	cp32-4	26004	26820	816	100.0	2.075e-184
URI91H	contig_14	20926	21601	675	renamed_GCF_000008685.2	cp32-4	26852	27527	675	100.0	3.937e-145
URI91H	contig_14	21749	22277	528	renamed_GCF_000008685.2	cp32-4	27675	28203	528	100.0	1.105e-117
URI91H	contig_14	22457	23024	567	renamed_GCF_000008685.2	cp32-4	28383	28950	567	100.0	1.275e-122
URI91H	contig_14	23020	24373	1353	renamed_GCF_000008685.2	cp32-4	28946	30299	1353	100.0	2.818e-306
URI91H	contig_14	24438	25662	1224	renamed_GCF_000008685.2	cp32-4	65	1289	1224	100.0	4.655e-270
URI91H	contig_15	1763	1409	354	renamed_GCF_000008685.2	cp32-3	16083	16437	354	100.0	1.459e-77
URI91H	contig_15	2091	1755	336	renamed_GCF_000008685.2	cp32-3	15755	16091	336	100.0	5.348e-69
URI91H	contig_15	2428	2080	348	renamed_GCF_000008685.2	lp56	18919	19267	348	100.0	3.962e-74
URI91H	contig_15	2635	2431	204	renamed_GCF_000008685.2	cp32-4	15166	15370	204	100.0	2.578e-39
URI91H	contig_15	4138	3532	606	renamed_GCF_000008685.2	cp32-3	13708	14314	606	100.0	5.47e-130
URI91H	contig_15	19834	19195	639	renamed_GCF_000008685.2	cp32-3	28235	28874	639	100.0	1.943e-138
URI91H	contig_15	20660	20150	510	renamed_GCF_000008685.2	cp32-3	27409	27919	510	100.0	3.969e-109
URI91H	contig_16	1181	827	354	renamed_GCF_000008685.2	cp32-6	16102	16456	354	100.0	1.459e-77
URI91H	contig_16	1846	1498	348	renamed_GCF_000008685.2	cp32-6	15437	15785	348	100.0	8.822e-74
URI91H	contig_16	2053	1849	204	renamed_GCF_000008685.2	cp32-6	15230	15434	204	100.0	2.578e-39
URI91H	contig_16	4441	3565	876	renamed_GCF_000008685.2	cp32-6	12842	13718	876	100.0	5.609e-192
URI91H	contig_16	5354	4799	555	renamed_GCF_000008685.2	cp32-6	11929	12484	555	100.0	3.12e-119
URI91H	contig_16	12335	11879	456	renamed_GCF_000008685.2	cp32-6	4948	5404	456	100.0	1.075e-97
URI91H	contig_16	13314	12354	960	renamed_GCF_000008685.2	lp56	7432	8392	960	100.0	6.008e-214
URI91H	contig_16	13911	13335	576	renamed_GCF_000008685.2	cp32-6	3372	3948	576	100.0	4.521e-127
URI91H	contig_19	16000	15445	555	renamed_GCF_000008685.2	lp28-4	11923	12478	555	100.0	3.559e-126
URI91H	contig_20	10634	11267	633	renamed_GCF_000008685.2	cp26	16902	17535	633	100.0	1.275e-133
URI91H	contig_20	14518	13162	1356	renamed_GCF_000008685.2	cp26	20786	19430	1356	100.0	1.798e-294
URI91H	contig_20	15556	15070	486	renamed_GCF_000008685.2	cp26	21833	21338	486	100.0	3.279e-107
URI91H	contig_20	16986	18231	1245	renamed_GCF_000008685.2	cp26	23254	24499	1245	100.0	1.056e-281
URI91H	contig_20	18556	20185	1629	renamed_GCF_000008685.2	cp26	24824	26453	1629	100.0	0.0
URI91H	contig_21	6627	7311	684	renamed_GCF_000008685.2	lp17	5055	5739	684	100.0	2.578e-151
URI91H	contig_1	104	668	564	renamed_GCF_000008685.2	chromosome	104	677	564	100.0	4.108e-126
URI91H	contig_1	10572	11412	840	renamed_GCF_000008685.2	chromosome	10580	11420	840	100.0	7.775e-191
URI91H	contig_1	12737	14720	1983	renamed_GCF_000008685.2	chromosome	12745	14728	1983	100.0	0.0
URI91H	contig_1	15986	16796	810	renamed_GCF_000008685.2	chromosome	15994	16804	810	100.0	1.068e-173
URI91H	contig_1	22093	21049	1044	renamed_GCF_000008685.2	chromosome	22101	21057	1044	100.0	6.693e-227
URI91H	contig_1	22731	22137	594	renamed_GCF_000008685.2	chromosome	22739	22145	594	100.0	3.27e-125
URI91H	contig_1	24688	23956	732	renamed_GCF_000008685.2	chromosome	24696	23964	732	100.0	2.844e-158
URI91H	contig_1	26390	27440	1050	renamed_GCF_000008685.2	chromosome	26398	27448	1050	100.0	7.794e-235
URI91H	contig_1	28482	27846	636	renamed_GCF_000008685.2	chromosome	28490	27854	636	100.0	8.334e-139
URI91H	contig_1	87351	86916	435	renamed_GCF_000008685.2	chromosome	87360	86925	435	100.0	2.772e-92
URI91H	contig_1	91106	89801	1305	renamed_GCF_000008685.2	chromosome	91115	89810	1305	100.0	2.863e-289
URI91H	contig_1	103762	103006	756	renamed_GCF_000008685.2	chromosome	103771	103015	756	100.0	4.353e-166
URI91H	contig_1	105837	105408	429	renamed_GCF_000008685.2	chromosome	105846	105417	429	100.0	3.057e-90
URI91H	contig_1	111033	109665	1368	renamed_GCF_000008685.2	chromosome	111042	109674	1368	100.0	1.976e-295
URI91H	contig_1	111558	111036	522	renamed_GCF_000008685.2	chromosome	111567	111045	522	100.0	1.783e-111
URI91H	contig_1	112329	111879	450	renamed_GCF_000008685.2	chromosome	112338	111888	450	100.0	4.387e-98
URI91H	contig_1	114594	112899	1695	renamed_GCF_000008685.2	chromosome	114603	112908	1695	100.0	0.0
URI91H	contig_1	116797	115495	1302	renamed_GCF_000008685.2	chromosome	116806	115504	1302	100.0	1.776e-285
URI91H	contig_16	4770	4437	333	renamed_GCF_000008685.2	cp32-4	12447	12780	333	100.0	8.424e-72
URI91H	contig_16	17218	15994	1224	renamed_GCF_000008685.2	cp32-6	65	1289	1224	100.0	2.096e-270
URI91H	contig_16	19376	20045	669	renamed_GCF_000008685.2	cp32-6	27745	27076	669	100.0	4.521e-151
URI91H	contig_17	1089	1971	882	renamed_GCF_000008685.2	lp28-2	1046	1928	882	100.0	1.741e-197
URI91H	contig_17	5420	5993	573	renamed_GCF_000008685.2	lp28-2	5377	5950	573	100.0	1.602e-129
URI91H	contig_17	6779	7331	552	renamed_GCF_000008685.2	lp28-2	6736	7288	552	100.0	2.704e-120
URI91H	contig_17	11534	11105	429	renamed_GCF_000008685.2	lp28-2	11491	11062	429	100.0	3.057e-90
URI91H	contig_17	19662	18879	783	renamed_GCF_000008685.2	lp28-2	19619	18836	783	100.0	1.354e-183
URI91H	contig_17	22702	22315	387	renamed_GCF_000008685.2	lp28-2	22659	22272	387	100.0	4.63e-87
URI91H	contig_17	23768	23075	693	renamed_GCF_000008685.2	lp28-2	23725	23032	693	100.0	4.125e-156
URI91H	contig_17	24151	23764	387	renamed_GCF_000008685.2	lp28-2	24108	23721	387	100.0	1.013e-78
URI91H	contig_17	24531	25998	1467	renamed_GCF_000008685.2	lp28-2	24488	25955	1467	100.0	0.0
URI91H	contig_17	26699	27128	429	renamed_GCF_000008685.2	lp28-2	26569	27085	429	100.0	3.799e-96
URI91H	contig_18	15773	16340	567	renamed_GCF_000008685.2	lp28-3	17407	17974	567	100.0	1.938e-126
URI91H	contig_18	19835	20585	750	renamed_GCF_000008685.2	lp28-3	21469	22219	750	100.0	6.33e-161
URI91H	contig_18	21043	21319	276	renamed_GCF_000008685.2	lp28-3	22677	22953	276	100.0	6.026e-58
URI91H	contig_18	25811	25343	468	renamed_GCF_000008685.2	lp28-3	27445	26977	468	99.3	1.339e-105
URI91H	contig_18	27403	27976	573	renamed_GCF_000008685.2	lp28-3	28197	27624	573	100.0	5.735e-124
URI91H	contig_19	12572	11393	1179	renamed_GCF_000008685.2	lp28-4	15351	16530	1179	100.0	4.972e-253
URI91H	contig_19	15470	14717	753	renamed_GCF_000008685.2	lp28-4	12453	13206	753	100.0	4.561e-165
URI91H	contig_19	17109	15996	1113	renamed_GCF_000008685.2	lp28-4	10814	11927	1113	100.0	3.951e-253
URI91H	contig_19	20687	19385	1302	renamed_GCF_000008685.2	lp28-4	7182	8538	1302	96.0	2.563e-281
URI91H	contig_19	22742	22523	219	renamed_GCF_000008685.2	lp28-4	5127	5346	219	100.0	1.443e-47
URI91H	contig_20	10399	8863	1536	renamed_GCF_000008685.2	cp26	16667	15131	1536	100.0	0.0
URI91H	contig_20	13053	11697	1356	renamed_GCF_000008685.2	cp26	19321	17965	1356	100.0	1.971e-293
URI91H	contig_20	15096	14589	507	renamed_GCF_000008685.2	cp26	21364	20857	507	100.0	3.123e-111
URI91H	contig_20	15629	16325	696	renamed_GCF_000008685.2	cp26	21897	22593	696	100.0	1.401e-151
URI91H	contig_20	16886	16334	552	renamed_GCF_000008685.2	cp26	23154	22602	552	100.0	6.015e-120
URI91H	contig_21	2981	3338	357	renamed_GCF_000008685.2	lp17	1409	1766	357	100.0	1.532e-77
URI91H	contig_21	5169	5391	222	renamed_GCF_000008685.2	lp17	3651	3819	222	100.0	6.565e-33
URI91H	contig_21	8024	7445	579	renamed_GCF_000008685.2	lp17	6452	5873	579	100.0	2.345e-126
URI91H	contig_21	9356	9683	327	renamed_GCF_000008685.2	lp17	7784	8111	327	100.0	1.029e-68
URI91H	contig_21	11459	11162	297	renamed_GCF_000008685.2	lp17	9980	9590	297	100.0	9.385e-65
URI91H	contig_22	7832	7367	465	renamed_GCF_000008685.2	lp21	15348	15813	465	100.0	1.704e-102
URI91H	contig_1	1787	758	1029	renamed_GCF_000008685.2	chromosome	1796	767	1029	100.0	4.829e-228
URI91H	contig_1	32081	31541	540	renamed_GCF_000008685.2	chromosome	32089	31549	540	100.0	3.274e-116
URI91H	contig_1	35828	34028	1800	renamed_GCF_000008685.2	chromosome	35836	34036	1800	100.0	0.0
URI91H	contig_1	39817	40669	852	renamed_GCF_000008685.2	chromosome	39825	40677	852	100.0	1.031e-189
URI91H	contig_1	42475	41434	1041	renamed_GCF_000008685.2	chromosome	42483	41442	1041	100.0	8.938e-232
URI91H	contig_1	45346	42898	2448	renamed_GCF_000008685.2	chromosome	45354	42906	2448	100.0	0.0
URI91H	contig_1	46371	46002	369	renamed_GCF_000008685.2	chromosome	46379	46010	369	100.0	3.085e-80
URI91H	contig_1	47896	48598	702	renamed_GCF_000008685.2	chromosome	47916	48606	702	100.0	4.54e-148
URI91H	contig_1	49251	48594	657	renamed_GCF_000008685.2	chromosome	49259	48602	657	100.0	2.137e-140
URI91H	contig_1	49332	50004	672	renamed_GCF_000008685.2	chromosome	49340	50012	672	100.0	9.591e-152
URI91H	contig_1	60031	59092	939	renamed_GCF_000008685.2	chromosome	60039	59100	939	100.0	4.091e-206
URI91H	contig_1	61249	60559	690	renamed_GCF_000008685.2	chromosome	61257	60567	690	100.0	1.401e-150
URI91H	contig_1	63138	64020	882	renamed_GCF_000008685.2	chromosome	63146	64028	882	100.0	1.369e-191
URI91H	contig_1	65282	65744	462	renamed_GCF_000008685.2	chromosome	65290	65752	462	100.0	3.193e-95
URI91H	contig_1	67239	69561	2322	renamed_GCF_000008685.2	chromosome	67247	69569	2322	100.0	0.0
URI91H	contig_1	70164	71211	1047	renamed_GCF_000008685.2	chromosome	70141	71219	1047	100.0	1.295e-228
URI91H	contig_1	72638	73484	846	renamed_GCF_000008685.2	chromosome	72646	73492	846	100.0	5.813e-178
URI91H	contig_1	76441	77692	1251	renamed_GCF_000008685.2	chromosome	76450	77701	1251	100.0	1.724e-268
URI91H	contig_1	79343	78992	351	renamed_GCF_000008685.2	chromosome	79322	79001	351	100.0	3.732e-67
URI91H	contig_1	112760	112340	420	renamed_GCF_000008685.2	chromosome	112769	112349	420	100.0	6.488e-89
URI91H	contig_1	114797	115499	702	renamed_GCF_000008685.2	chromosome	114806	115508	702	100.0	2.35e-155
URI91H	contig_1	118920	118365	555	renamed_GCF_000008685.2	chromosome	118929	118374	555	100.0	1.543e-118
URI91H	contig_1	120580	119797	783	renamed_GCF_000008685.2	chromosome	120589	119806	783	100.0	5.024e-169
URI91H	contig_1	133833	132462	1371	renamed_GCF_000008685.2	chromosome	133842	132471	1371	100.0	2.422e-302
URI91H	contig_1	137757	135864	1893	renamed_GCF_000008685.2	chromosome	137766	135873	1893	100.0	0.0
URI91H	contig_1	138736	138424	312	renamed_GCF_000008685.2	chromosome	138745	138433	312	100.0	1.981e-67
URI91H	contig_1	142925	141971	954	renamed_GCF_000008685.2	chromosome	142932	141978	954	100.0	1.517e-202
URI91H	contig_1	165880	164893	987	renamed_GCF_000008685.2	chromosome	165887	164900	987	100.0	2.687e-210
URI91H	contig_1	167752	165907	1845	renamed_GCF_000008685.2	chromosome	167759	165914	1845	100.0	0.0
URI91H	contig_1	169392	167871	1521	renamed_GCF_000008685.2	chromosome	169399	167878	1521	100.0	0.0
URI91H	contig_1	169531	170701	1170	renamed_GCF_000008685.2	chromosome	169562	170708	1170	99.7	6.062e-258
URI91H	contig_1	181398	179532	1866	renamed_GCF_000008685.2	chromosome	181405	179539	1866	100.0	0.0
URI91H	contig_1	182795	181400	1395	renamed_GCF_000008685.2	chromosome	182802	181407	1395	100.0	4.219e-300
URI91H	contig_1	182878	183373	495	renamed_GCF_000008685.2	chromosome	182885	183380	495	100.0	9.271e-106
URI91H	contig_1	186546	186939	393	renamed_GCF_000008685.2	chromosome	186553	186946	393	100.0	5.626e-86
URI91H	contig_1	206521	208099	1578	renamed_GCF_000008685.2	chromosome	206528	208106	1578	100.0	0.0
URI91H	contig_1	208613	208076	537	renamed_GCF_000008685.2	chromosome	208581	208083	537	99.3	7.373e-107
URI91H	contig_1	211293	212061	768	renamed_GCF_000008685.2	chromosome	211300	212068	768	100.0	8.822e-169
URI91H	contig_1	215419	217252	1833	renamed_GCF_000008685.2	chromosome	215426	217259	1833	100.0	0.0
URI91H	contig_1	217273	218305	1032	renamed_GCF_000008685.2	chromosome	217277	218312	1032	100.0	9.666e-221
URI91H	contig_1	219071	218417	654	renamed_GCF_000008685.2	chromosome	219078	218424	654	100.0	1.052e-147
URI91H	contig_1	219627	219048	579	renamed_GCF_000008685.2	chromosome	219634	219055	579	100.0	8.388e-121
URI91H	contig_1	252230	251204	1026	renamed_GCF_000008685.2	chromosome	252237	251211	1026	100.0	5.545e-226
URI91H	contig_1	252426	253032	606	renamed_GCF_000008685.2	chromosome	252433	253039	606	100.0	4.115e-133
URI91H	contig_1	253151	254924	1773	renamed_GCF_000008685.2	chromosome	253158	254931	1773	100.0	0.0
URI91H	contig_1	254937	255642	705	renamed_GCF_000008685.2	chromosome	254944	255649	705	100.0	7.263e-152
URI91H	contig_1	273640	272626	1014	renamed_GCF_000008685.2	chromosome	273647	272633	1014	100.0	5.532e-224
URI91H	contig_1	273846	275229	1383	renamed_GCF_000008685.2	chromosome	273856	275236	1383	99.7	2.662e-303
URI91H	contig_1	276489	275235	1254	renamed_GCF_000008685.2	chromosome	276496	275242	1254	100.0	4.99e-283
URI91H	contig_1	276550	277057	507	renamed_GCF_000008685.2	chromosome	276671	277064	507	100.0	6.298e-87
URI91H	contig_1	278552	277082	1470	renamed_GCF_000008685.2	chromosome	278559	277089	1470	100.0	8.9e-322
URI91H	contig_1	279051	278529	522	renamed_GCF_000008685.2	chromosome	279058	278536	522	100.0	3.966e-111
URI91H	contig_1	305654	305105	549	renamed_GCF_000008685.2	chromosome	305661	305112	549	100.0	9.24e-115
URI91H	contig_1	306611	305663	948	renamed_GCF_000008685.2	chromosome	306615	305670	948	100.0	3.249e-210
URI91H	contig_1	307310	306617	693	renamed_GCF_000008685.2	chromosome	307317	306624	693	100.0	2.971e-151
URI91H	contig_1	308510	307310	1200	renamed_GCF_000008685.2	chromosome	308517	307317	1200	100.0	3.302e-261
URI91H	contig_1	309773	308531	1242	renamed_GCF_000008685.2	chromosome	309780	308538	1242	100.0	1.368e-269
URI91H	contig_1	310516	309772	744	renamed_GCF_000008685.2	chromosome	310523	309779	744	100.0	5.245e-162
URI91H	contig_1	311646	310551	1095	renamed_GCF_000008685.2	chromosome	311617	310558	1095	99.7	2.491e-229
URI91H	contig_1	312708	311652	1056	renamed_GCF_000008685.2	chromosome	312715	311659	1056	100.0	1.239e-230
URI91H	contig_1	314117	312725	1392	renamed_GCF_000008685.2	chromosome	314123	312728	1392	100.0	1.047e-306
URI91H	contig_1	314421	314139	282	renamed_GCF_000008685.2	chromosome	314427	314145	282	100.0	2.699e-59
URI91H	contig_1	368878	370021	1143	renamed_GCF_000008685.2	chromosome	368884	370027	1143	100.0	3.212e-243
URI91H	contig_1	370020	371007	987	renamed_GCF_000008685.2	chromosome	370026	371013	987	100.0	7.343e-225
URI91H	contig_1	371027	373040	2013	renamed_GCF_000008685.2	chromosome	371033	373046	2013	100.0	0.0
URI91H	contig_1	373133	373514	381	renamed_GCF_000008685.2	chromosome	373139	373520	381	100.0	1.683e-80
URI91H	contig_1	385442	386156	714	renamed_GCF_000008685.2	chromosome	385448	386162	714	100.0	3.427e-153
URI91H	contig_1	386152	387331	1179	renamed_GCF_000008685.2	chromosome	386158	387337	1179	100.0	1.981e-263
URI91H	contig_1	387327	387801	474	renamed_GCF_000008685.2	chromosome	387333	387807	474	100.0	1.339e-106
URI91H	contig_1	388474	387811	663	renamed_GCF_000008685.2	chromosome	388480	387817	663	100.0	4.965e-149
URI91H	contig_1	388920	388500	420	renamed_GCF_000008685.2	chromosome	388926	388506	420	100.0	9.787e-93
URI91H	contig_1	390335	388970	1365	renamed_GCF_000008685.2	chromosome	390341	388976	1365	99.5	7.255e-289
URI91H	contig_1	413106	414309	1203	renamed_GCF_000008685.2	chromosome	413112	414315	1203	100.0	6.394e-263
URI91H	contig_1	415787	414320	1467	renamed_GCF_000008685.2	chromosome	415793	414326	1467	100.0	0.0
URI91H	contig_1	416517	415839	678	renamed_GCF_000008685.2	chromosome	416478	415845	678	99.5	1.008e-143
URI91H	contig_1	416682	417099	417	renamed_GCF_000008685.2	chromosome	416688	417105	417	100.0	1.248e-89
URI91H	contig_1	426731	427946	1215	renamed_GCF_000008685.2	chromosome	426735	427950	1215	100.0	1.711e-262
URI91H	contig_1	427982	428618	636	renamed_GCF_000008685.2	chromosome	427986	428622	636	100.0	3.41e-140
URI91H	contig_1	428641	429670	1029	renamed_GCF_000008685.2	chromosome	428645	429674	1029	100.0	3.872e-239
URI91H	contig_1	430612	429688	924	renamed_GCF_000008685.2	chromosome	430616	429692	924	100.0	4.275e-203
URI91H	contig_1	435099	430614	4485	renamed_GCF_000008685.2	chromosome	435103	430618	4485	100.0	0.0
URI91H	contig_1	442548	441708	840	renamed_GCF_000008685.2	chromosome	442552	441712	840	100.0	1.361e-184
URI91H	contig_1	474608	475598	990	renamed_GCF_000008685.2	chromosome	474612	475602	990	100.0	3.939e-215
URI91H	contig_1	475601	476207	606	renamed_GCF_000008685.2	chromosome	475605	476211	606	100.0	1.006e-131
URI91H	contig_1	478070	476258	1812	renamed_GCF_000008685.2	chromosome	478005	476262	1812	100.0	0.0
URI91H	contig_1	488978	489491	513	renamed_GCF_000008685.2	chromosome	488982	489495	513	100.0	1.545e-111
URI91H	contig_1	489487	489715	228	renamed_GCF_000008685.2	chromosome	489539	489719	228	100.0	1.455e-33
URI91H	contig_1	489728	490550	822	renamed_GCF_000008685.2	chromosome	489732	490554	822	100.0	2.749e-182
URI91H	contig_1	490639	491923	1284	renamed_GCF_000008685.2	chromosome	490643	491927	1284	100.0	9.564e-281
URI91H	contig_1	492583	493948	1365	renamed_GCF_000008685.2	chromosome	492587	493952	1365	100.0	1.721e-296
URI91H	contig_1	494538	494145	393	renamed_GCF_000008685.2	chromosome	494539	494149	393	100.0	4.545e-80
URI91H	contig_1	504794	505100	306	renamed_GCF_000008685.2	chromosome	504798	505104	306	100.0	1.468e-61
URI91H	contig_1	505099	505537	438	renamed_GCF_000008685.2	chromosome	505103	505541	438	100.0	1.186e-93
URI91H	contig_1	505549	506854	1305	renamed_GCF_000008685.2	chromosome	505553	506858	1305	100.0	4.133e-285
URI91H	contig_1	506866	506980	114	renamed_GCF_000008685.2	chromosome	506864	506984	114	100.0	7.638e-22
URI91H	contig_1	516484	522985	6501	renamed_GCF_000008685.2	chromosome	516492	522993	6501	100.0	0.0
URI91H	contig_1	524545	526246	1701	renamed_GCF_000008685.2	chromosome	524553	526254	1701	100.0	0.0
URI91H	contig_1	553129	553780	651	renamed_GCF_000008685.2	chromosome	553138	553789	651	100.0	1.464e-143
URI91H	contig_1	553982	555203	1221	renamed_GCF_000008685.2	chromosome	553991	555212	1221	100.0	5.34e-268
URI91H	contig_1	567800	568268	468	renamed_GCF_000008685.2	chromosome	567809	568277	468	100.0	1.969e-101
URI91H	contig_1	568260	569130	870	renamed_GCF_000008685.2	chromosome	568269	569139	870	100.0	1.737e-195
URI91H	contig_1	569268	569529	261	renamed_GCF_000008685.2	chromosome	569277	569538	261	100.0	9.575e-51
URI91H	contig_1	569549	571271	1722	renamed_GCF_000008685.2	chromosome	569558	571280	1722	100.0	0.0
URI91H	contig_1	571273	571843	570	renamed_GCF_000008685.2	chromosome	571282	571852	570	100.0	1.471e-121
URI91H	contig_1	573731	571880	1851	renamed_GCF_000008685.2	chromosome	573740	571889	1851	100.0	0.0
URI91H	contig_1	611184	609933	1251	renamed_GCF_000008685.2	chromosome	611193	609942	1251	100.0	7.081e-270
URI91H	contig_1	611299	612013	714	renamed_GCF_000008685.2	chromosome	611308	612022	714	100.0	1.949e-159
URI91H	contig_1	612038	613976	1938	renamed_GCF_000008685.2	chromosome	612047	613985	1938	100.0	0.0
URI91H	contig_1	615762	614004	1758	renamed_GCF_000008685.2	chromosome	615771	614013	1758	100.0	0.0
URI91H	contig_1	630759	631977	1218	renamed_GCF_000008685.2	chromosome	630795	631986	1218	99.7	8.847e-262
URI91H	contig_1	631981	632473	492	renamed_GCF_000008685.2	chromosome	631990	632482	492	100.0	1.786e-106
URI91H	contig_1	632475	634455	1980	renamed_GCF_000008685.2	chromosome	632484	634464	1980	100.0	0.0
URI91H	contig_1	634571	636002	1431	renamed_GCF_000008685.2	chromosome	634580	636011	1431	100.0	1.295e-319
URI91H	contig_1	636582	637947	1365	renamed_GCF_000008685.2	chromosome	636592	637957	1365	100.0	3.184e-298
URI91H	contig_1	637952	638546	594	renamed_GCF_000008685.2	chromosome	637971	638556	594	100.0	1.47e-125
URI91H	contig_1	668507	664997	3510	renamed_GCF_000008685.2	chromosome	668517	665007	3510	100.0	0.0
URI91H	contig_1	673201	671755	1446	renamed_GCF_000008685.2	chromosome	673167	671766	1446	100.0	1.676e-310
URI91H	contig_1	673330	674767	1437	renamed_GCF_000008685.2	chromosome	673341	674778	1437	100.0	0.0
URI91H	contig_1	714997	716608	1611	renamed_GCF_000008685.2	chromosome	715008	716619	1611	100.0	0.0
URI91H	contig_1	716608	717760	1152	renamed_GCF_000008685.2	chromosome	716619	717771	1152	100.0	1.261e-246
URI91H	contig_1	717731	718658	927	renamed_GCF_000008685.2	chromosome	717742	718669	927	100.0	3.519e-197
URI91H	contig_1	718815	721077	2262	renamed_GCF_000008685.2	chromosome	718826	721088	2262	100.0	0.0
URI91H	contig_1	721107	723009	1902	renamed_GCF_000008685.2	chromosome	721118	723020	1902	100.0	0.0
URI91H	contig_1	724119	723051	1068	renamed_GCF_000008685.2	chromosome	724130	723062	1068	100.0	3.402e-247
URI91H	contig_1	724212	725436	1224	renamed_GCF_000008685.2	chromosome	724223	725447	1224	100.0	3.222e-274
URI91H	contig_1	725419	726484	1065	renamed_GCF_000008685.2	chromosome	725430	726495	1065	100.0	4.042e-236
URI91H	contig_1	726446	727742	1296	renamed_GCF_000008685.2	chromosome	726457	727753	1296	100.0	7.283e-286
URI91H	contig_1	727725	728664	939	renamed_GCF_000008685.2	chromosome	727736	728675	939	100.0	1.678e-207
URI91H	contig_1	737697	738417	720	renamed_GCF_000008685.2	chromosome	737708	738428	720	100.0	9.639e-160
URI91H	contig_1	738394	738760	366	renamed_GCF_000008685.2	chromosome	738405	738771	366	100.0	9.695e-76
URI91H	contig_1	739132	739672	540	renamed_GCF_000008685.2	chromosome	739143	739683	540	100.0	2.458e-119
URI91H	contig_1	739673	740165	492	renamed_GCF_000008685.2	chromosome	739684	740176	492	100.0	4.374e-105
URI91H	contig_1	740228	740411	183	renamed_GCF_000008685.2	chromosome	740239	740422	183	100.0	1.805e-39
URI91H	contig_1	740434	740677	243	renamed_GCF_000008685.2	chromosome	740445	740688	243	100.0	1.755e-49
URI91H	contig_1	777754	778744	990	renamed_GCF_000008685.2	chromosome	777764	778754	990	100.0	1.559e-225
URI91H	contig_1	778747	781375	2628	renamed_GCF_000008685.2	chromosome	778757	781385	2628	100.0	0.0
URI91H	contig_1	782819	782141	678	renamed_GCF_000008685.2	chromosome	782829	782151	678	100.0	4.744e-152
URI91H	contig_1	798038	797108	930	renamed_GCF_000008685.2	chromosome	798048	797118	930	100.0	3.063e-199
URI91H	contig_1	799006	798046	960	renamed_GCF_000008685.2	chromosome	799016	798056	960	100.0	6.008e-214
URI91H	contig_1	800265	799197	1068	renamed_GCF_000008685.2	chromosome	800275	799207	1068	100.0	8.292e-246
URI91H	contig_1	800465	801062	597	renamed_GCF_000008685.2	chromosome	800475	801072	597	100.0	2.836e-127
URI91H	contig_1	801000	801768	768	renamed_GCF_000008685.2	chromosome	801118	801778	768	99.5	4.938e-141
URI91H	contig_1	802789	801931	858	renamed_GCF_000008685.2	chromosome	802798	801940	858	100.0	3.462e-177
URI91H	contig_1	803158	802828	330	renamed_GCF_000008685.2	chromosome	803167	802837	330	100.0	2.178e-69
URI91H	contig_1	814697	813689	1008	renamed_GCF_000008685.2	chromosome	814697	813689	1008	100.0	5.214e-215
URI91H	contig_1	815302	814867	435	renamed_GCF_000008685.2	chromosome	815302	814867	435	100.0	4.611e-95
URI91H	contig_1	816299	815501	798	renamed_GCF_000008685.2	chromosome	816299	815501	798	100.0	1.968e-173
URI91H	contig_1	817202	816311	891	renamed_GCF_000008685.2	chromosome	817160	816311	891	99.6	1.029e-187
URI91H	contig_1	817395	817956	561	renamed_GCF_000008685.2	chromosome	817395	817956	561	100.0	3.237e-128
URI91H	contig_1	818017	818548	531	renamed_GCF_000008685.2	chromosome	818017	818548	531	100.0	1.403e-115
URI91H	contig_1	876396	879249	2853	renamed_GCF_000008685.2	chromosome	876491	879281	2853	99.8	0.0
URI91H	contig_1	879282	880218	936	renamed_GCF_000008685.2	chromosome	879314	880250	936	100.0	3.242e-208
URI91H	contig_1	881059	880234	825	renamed_GCF_000008685.2	chromosome	881091	880266	825	100.0	2.882e-182
URI91H	contig_1	884181	881052	3129	renamed_GCF_000008685.2	chromosome	884213	881084	3129	100.0	0.0
URI91H	contig_1	901801	903226	1425	renamed_GCF_000008685.2	chromosome	901833	903258	1425	100.0	1.211e-310
URI91H	contig_1	904868	903896	972	renamed_GCF_000008685.2	chromosome	904900	903928	972	100.0	2.334e-209
URI91H	contig_1	908374	909559	1185	renamed_GCF_000008685.2	chromosome	908406	909591	1185	100.0	8.142e-266
URI91H	contig_2	905	107	798	renamed_GCF_000008685.2	lp54	52705	53503	798	100.0	3.008e-177
URI91H	contig_2	1905	1131	774	renamed_GCF_000008685.2	lp54	51705	52479	774	100.0	9.219e-161
URI91H	contig_2	2434	3325	891	renamed_GCF_000008685.2	lp54	51176	50285	891	100.0	3.698e-199
URI91H	contig_2	13498	13738	240	renamed_GCF_000008685.2	lp54	40112	39872	240	100.0	3.722e-49
URI91H	contig_2	14205	15450	1245	renamed_GCF_000008685.2	lp54	39405	38160	1245	100.0	4.898e-273
URI91H	contig_2	24227	23852	375	renamed_GCF_000008685.2	lp54	29383	29758	375	100.0	1.685e-79
URI91H	contig_2	24676	24223	453	renamed_GCF_000008685.2	lp54	28934	29387	453	100.0	2.51e-96
URI91H	contig_2	25597	24679	918	renamed_GCF_000008685.2	lp54	28013	28931	918	99.6	1.041e-200
URI91H	contig_2	26221	25612	609	renamed_GCF_000008685.2	lp54	27389	27998	609	100.0	2.346e-131
URI91H	contig_2	45335	45155	180	renamed_GCF_000008685.2	lp54	8265	8445	180	100.0	1.452e-33
URI91H	contig_2	46392	45357	1035	renamed_GCF_000008685.2	lp54	7208	8243	1035	100.0	8.138e-232
URI91H	contig_2	47080	46453	627	renamed_GCF_000008685.2	lp54	6520	7147	627	100.0	4.747e-135
URI91H	contig_2	47955	47082	873	renamed_GCF_000008685.2	lp54	5645	6518	873	100.0	2.408e-192
URI91H	contig_3	14973	14226	747	renamed_GCF_000008685.2	lp56	36388	37135	747	100.0	3.778e-166
URI91H	contig_3	15543	14976	567	renamed_GCF_000008685.2	lp56	35818	36385	567	100.0	4.74e-125
URI91H	contig_3	33539	32723	816	renamed_GCF_000008685.2	lp56	17822	18638	816	98.8	8.08e-178
URI91H	contig_3	34154	33548	606	renamed_GCF_000008685.2	lp56	17207	17813	606	100.0	5.47e-130
URI91H	contig_3	35368	35035	333	renamed_GCF_000008685.2	cp32-6	12513	12846	333	100.0	8.424e-72
URI91H	contig_3	42495	42111	384	renamed_GCF_000008685.2	lp56	8866	9250	384	100.0	2.931e-83
URI91H	contig_3	42950	42494	456	renamed_GCF_000008685.2	lp56	8411	8867	456	100.0	1.075e-97
URI91H	contig_3	44526	43950	576	renamed_GCF_000008685.2	lp56	6835	7411	576	100.0	4.521e-127
URI91H	contig_3	45022	45559	537	renamed_GCF_000008685.2	lp56	6339	5802	537	100.0	1.599e-123
URI91H	contig_3	45531	46293	762	renamed_GCF_000008685.2	lp56	5830	5068	762	100.0	1.784e-168
URI91H	contig_3	46375	47113	738	renamed_GCF_000008685.2	lp56	4986	4248	738	100.0	1.779e-164
URI91H	contig_3	47739	47253	486	renamed_GCF_000008685.2	lp56	3622	4108	486	100.0	4.376e-104
URI91H	contig_3	48618	47865	753	renamed_GCF_000008685.2	lp56	2743	3496	753	100.0	1.868e-166
URI91H	contig_4	11605	10882	723	renamed_GCF_000008685.2	lp38	32497	33220	723	100.0	6.027e-157
URI91H	contig_4	12880	11962	918	renamed_GCF_000008685.2	lp38	31219	32140	918	99.6	1.1e-208
URI91H	contig_4	27583	26773	810	renamed_GCF_000008685.2	lp38	16519	17329	810	100.0	3.013e-179
URI91H	contig_4	30661	31657	996	renamed_GCF_000008685.2	lp38	13440	12444	996	100.0	8.455e-225
URI91H	contig_4	31649	32240	591	renamed_GCF_000008685.2	lp38	12452	11861	591	100.0	1.604e-132
URI91H	contig_4	32212	32950	738	renamed_GCF_000008685.2	lp38	11889	11151	738	100.0	8.004e-165
URI91H	contig_5	12209	12035	174	renamed_GCF_000008685.2	lp36	22293	22467	174	100.0	8.56e-38
URI91H	contig_5	12591	12369	222	renamed_GCF_000008685.2	lp36	21911	22133	222	100.0	1.866e-45
URI91H	contig_5	14114	13049	1065	renamed_GCF_000008685.2	lp36	20388	21453	1065	100.0	2.633e-232
URI91H	contig_6	24855	25371	516	renamed_GCF_000008685.2	lp28-1	2619	2097	516	100.0	2.617e-106
URI91H	contig_6	27002	26003	999	renamed_GCF_000008685.2	lp28-1	466	1465	999	100.0	6.954e-219
URI91H	contig_7	9902	10976	1074	renamed_GCF_000008685.2	lp25	14530	13402	1074	99.7	2.22e-244
URI91H	contig_7	10985	11549	564	renamed_GCF_000008685.2	lp25	13393	12829	564	100.0	4.519e-125
URI91H	contig_7	11524	12283	759	renamed_GCF_000008685.2	lp25	12854	12095	759	100.0	2.255e-165
URI91H	contig_7	12299	12881	582	renamed_GCF_000008685.2	lp25	12079	11497	582	100.0	4.521e-128
URI91H	contig_7	13669	14179	510	renamed_GCF_000008685.2	lp25	10694	10199	510	99.3	8.021e-110
URI91H	contig_7	14191	14812	621	renamed_GCF_000008685.2	lp25	10187	9566	621	100.0	1.329e-139
URI91H	contig_8	9273	10224	951	renamed_GCF_000008685.2	lp56	14441	15392	951	99.6	1.057e-214
URI91H	contig_8	10825	11158	333	renamed_GCF_000008685.2	cp32-1	12494	12827	333	100.0	8.424e-72
URI91H	contig_8	19845	20595	750	renamed_GCF_000008685.2	cp32-7	20765	21515	750	100.0	2.593e-162
URI91H	contig_8	20634	21156	522	renamed_GCF_000008685.2	cp32-7	21521	22076	522	100.0	1.473e-113
URI91H	contig_8	21167	21740	573	renamed_GCF_000008685.2	cp32-7	22087	22660	573	100.0	7.629e-121
URI91H	contig_9	7693	7930	237	renamed_GCF_000008685.2	cp32-8	8723	8960	237	100.0	7.893e-49
URI91H	contig_9	7937	9212	1275	renamed_GCF_000008685.2	cp32-1	8967	10242	1275	100.0	1.201e-276
URI91H	contig_9	9234	9918	684	renamed_GCF_000008685.2	cp32-6	10274	10958	684	100.0	3.113e-149
URI91H	contig_9	9921	10872	951	renamed_GCF_000008685.2	cp32-8	10951	11902	951	100.0	4.333e-216
URI91H	contig_9	18060	19158	1098	renamed_GCF_000008685.2	cp32-8	19090	20188	1098	100.0	2.035e-249
URI91H	contig_9	19167	19734	567	renamed_GCF_000008685.2	cp32-8	20197	20764	567	100.0	6.547e-130
URI91H	contig_9	19709	20450	741	renamed_GCF_000008685.2	cp32-8	20739	21480	741	100.0	2.251e-162
URI91H	contig_9	20509	21070	561	renamed_GCF_000008685.2	cp9	1891	2452	561	61.2	4.087e-75
URI91H	contig_9	21082	21661	579	renamed_GCF_000008685.2	cp32-8	22112	22691	579	100.0	3.43e-122
URI91H	contig_9	22335	23661	1326	renamed_GCF_000008685.2	cp32-8	23365	24691	1326	100.0	1.445e-300
URI91H	contig_9	23713	24139	426	renamed_GCF_000008685.2	cp32-7	24512	24938	426	100.0	8.056e-96
URI91H	contig_10	3237	4197	960	renamed_GCF_000008685.2	cp32-8	3962	4922	960	100.0	6.593e-213
URI91H	contig_10	4216	4672	456	renamed_GCF_000008685.2	cp32-8	4941	5397	456	100.0	1.075e-97
URI91H	contig_10	5042	5432	390	renamed_GCF_000008685.2	cp32-3	5767	6157	390	100.0	3.229e-83
URI91H	contig_10	5428	5995	567	renamed_GCF_000008685.2	cp32-8	6153	6720	567	100.0	9.584e-126
URI91H	contig_10	5975	7088	1113	renamed_GCF_000008685.2	cp32-3	6700	7813	1113	100.0	6.876e-247
URI91H	contig_10	20013	20754	741	renamed_GCF_000008685.2	cp32-1	20765	21506	741	100.0	1.112e-161
URI91H	contig_10	20808	21366	558	renamed_GCF_000008685.2	cp32-1	21560	22118	558	100.0	2.975e-120
URI91H	contig_10	21378	22011	633	renamed_GCF_000008685.2	cp32-1	22130	22763	633	100.0	1.275e-133
URI91H	contig_10	22478	23804	1326	renamed_GCF_000008685.2	cp32-1	23230	24556	1326	100.0	7.132e-300
URI91H	contig_11	13175	12077	1098	renamed_GCF_000008685.2	cp32-7	19116	20214	1098	96.7	8.634e-242
URI91H	contig_11	30174	29616	558	renamed_GCF_000008685.2	cp32-7	2009	2567	558	100.0	1.105e-122
URI91H	contig_12	1122	438	684	renamed_GCF_000008685.2	cp32-1	10264	10948	684	100.0	3.113e-149
URI91H	contig_12	8812	8047	765	renamed_GCF_000008685.2	cp32-8	2574	3339	765	100.0	3.139e-171
URI91H	contig_12	9376	8818	558	renamed_GCF_000008685.2	cp32-8	2010	2568	558	100.0	1.105e-122
URI91H	contig_12	10081	9388	693	renamed_GCF_000008685.2	cp32-8	1305	1998	693	100.0	2.582e-144
URI91H	contig_12	11321	10097	1224	renamed_GCF_000008685.2	cp32-1	65	1289	1224	100.0	2.096e-270
URI91H	contig_12	12739	11386	1353	renamed_GCF_000008685.2	cp32-8	29532	30885	1353	100.0	6.259e-306
URI91H	contig_12	13302	12735	567	renamed_GCF_000008685.2	cp32-8	28969	29536	567	100.0	2.836e-122
URI91H	contig_13	4827	3951	876	renamed_GCF_000008685.2	cp32-9	12921	13797	876	100.0	2.77e-191
URI91H	contig_13	5156	4823	333	renamed_GCF_000008685.2	cp32-9	12592	12925	333	100.0	1.876e-71
URI91H	contig_13	12630	12174	456	renamed_GCF_000008685.2	cp32-9	4957	5413	456	100.0	4.83e-98
URI91H	contig_13	15002	14234	768	renamed_GCF_000008685.2	cp32-9	2582	3350	768	100.0	6.66e-172
URI91H	contig_13	15572	15005	567	renamed_GCF_000008685.2	cp32-9	2012	2579	567	100.0	4.74e-125
URI91H	contig_13	16276	15583	693	renamed_GCF_000008685.2	cp32-9	1308	2001	693	100.0	5.226e-145
URI91H	contig_13	17519	16292	1227	renamed_GCF_000008685.2	cp32-9	65	1292	1227	99.5	2.407e-269
URI91H	contig_13	18937	17584	1353	renamed_GCF_000008685.2	cp32-9	29298	30651	1353	100.0	6.259e-306
URI91H	contig_13	20210	19691	519	renamed_GCF_000008685.2	cp32-9	28025	28544	519	99.4	3.122e-113
URI91H	contig_13	21438	20406	1032	renamed_GCF_000008685.2	cp32-9	26797	27829	1032	100.0	2.498e-227
URI91H	contig_13	22026	21465	561	renamed_GCF_000008685.2	cp32-9	26209	26770	561	100.0	4.739e-124
URI91H	contig_13	23664	23238	426	renamed_GCF_000008685.2	cp32-9	24571	24997	426	100.0	1.627e-96
URI91H	contig_14	7735	8341	606	renamed_GCF_000008685.2	cp32-1	13708	14314	606	100.0	5.47e-130
URI91H	contig_14	8350	9166	816	renamed_GCF_000008685.2	cp32-4	14276	15092	816	100.0	1.49e-179
URI91H	contig_14	9447	9795	348	renamed_GCF_000008685.2	cp32-3	15418	15766	348	100.0	3.962e-74
URI91H	contig_14	26385	26949	564	renamed_GCF_000008685.2	cp32-4	2012	2576	564	100.0	2.235e-124
URI91H	contig_14	26952	27720	768	renamed_GCF_000008685.2	cp32-4	2579	3347	768	100.0	3.291e-171
URI91H	contig_14	27748	28324	576	renamed_GCF_000008685.2	cp32-4	3375	3951	576	99.4	2.236e-126
URI91H	contig_14	28345	29305	960	renamed_GCF_000008685.2	cp32-4	3972	4932	960	100.0	6.008e-214
URI91H	contig_15	11693	11126	567	renamed_GCF_000008685.2	cp32-3	6153	6720	567	100.0	9.584e-126
URI91H	contig_15	12905	12449	456	renamed_GCF_000008685.2	cp32-3	4941	5397	456	100.0	1.075e-97
URI91H	contig_15	21362	20771	591	renamed_GCF_000008685.2	cp32-3	26707	27298	591	100.0	2.345e-128
URI91H	contig_15	21793	22570	777	renamed_GCF_000008685.2	cp32-3	26276	25499	777	100.0	3.144e-173
URI91H	contig_15	23001	22575	426	renamed_GCF_000008685.2	cp32-3	25068	25494	426	100.0	3.62e-96
URI91H	contig_15	24379	23053	1326	renamed_GCF_000008685.2	cp32-3	23690	25016	1326	100.0	1.445e-300
URI91H	contig_15	25477	24886	591	renamed_GCF_000008685.2	cp32-3	22592	23183	591	100.0	1.16e-127
URI91H	contig_16	10573	9460	1113	renamed_GCF_000008685.2	cp32-6	6710	7823	1113	100.0	1.393e-247
URI91H	contig_16	11123	10553	570	renamed_GCF_000008685.2	cp32-6	6160	6730	570	100.0	2.235e-125
URI91H	contig_16	11509	11119	390	renamed_GCF_000008685.2	cp32-6	5774	6164	390	100.0	1.451e-83
URI91H	contig_16	11880	11496	384	renamed_GCF_000008685.2	cp32-6	5403	5787	384	100.0	2.931e-83
URI91H	contig_16	20865	20106	759	renamed_GCF_000008685.2	cp32-6	26256	27015	759	100.0	2.986e-162
URI91H	contig_16	21301	22072	771	renamed_GCF_000008685.2	cp32-6	25820	25049	771	100.0	3.141e-172
URI91H	contig_16	23881	22555	1326	renamed_GCF_000008685.2	cp32-6	23240	24566	1326	100.0	1.445e-300
URI91H	contig_16	25020	24351	669	renamed_GCF_000008685.2	cp32-6	22101	22770	669	100.0	2.138e-142
URI91H	contig_16	25602	25023	579	renamed_GCF_000008685.2	cp32-6	21519	22098	579	100.0	5.735e-125
URI91H	contig_17	15474	14928	546	renamed_GCF_000008685.2	lp28-2	15431	14885	546	100.0	8.811e-115
URI91H	contig_17	16525	15499	1026	renamed_GCF_000008685.2	lp28-2	16482	15456	1026	100.0	1.723e-230
URI91H	contig_17	17727	16536	1191	renamed_GCF_000008685.2	lp28-2	17684	16493	1191	100.0	6.781e-269
URI91H	contig_17	18062	17723	339	renamed_GCF_000008685.2	lp28-2	18019	17680	339	100.0	5.085e-70
URI91H	contig_17	27155	27983	828	renamed_GCF_000008685.2	lp28-2	27112	27940	828	100.0	3.316e-181
URI91H	contig_17	28073	28874	801	renamed_GCF_000008685.2	lp28-2	28030	28831	801	100.0	3.29e-168
URI91H	contig_17	29661	28896	765	renamed_GCF_000008685.2	lp28-2	29618	28853	765	100.0	1.703e-169
URI91H	contig_18	1337	626	711	renamed_GCF_000008685.2	lp28-3	2970	2259	711	100.0	1.615e-152
URI91H	contig_18	6094	2257	3837	renamed_GCF_000008685.2	lp28-3	7728	3891	3837	100.0	0.0
URI91H	contig_19	6361	7153	792	renamed_GCF_000008685.2	lp28-4	21562	20770	792	100.0	1.631e-174
URI91H	contig_19	8740	9406	666	renamed_GCF_000008685.2	lp28-4	19183	18517	666	100.0	3.109e-146
URI91H	contig_19	25334	24518	816	renamed_GCF_000008685.2	lp28-4	2535	3351	816	100.0	8.08e-178
URI91H	contig_20	408	1446	1038	renamed_GCF_000008685.2	cp26	6676	7714	1038	100.0	8.529e-232
URI91H	contig_20	1567	2497	930	renamed_GCF_000008685.2	cp26	7835	8765	930	100.0	7.897e-206
URI91H	contig_20	3006	3768	762	renamed_GCF_000008685.2	cp26	9274	10036	762	100.0	1.063e-165
URI91H	contig_20	24998	26096	1098	renamed_GCF_000008685.2	cp26	4768	5866	1098	100.0	2.035e-249
URI91H	contig_21	1183	709	474	renamed_GCF_000008685.2	lp17	329	803	474	100.0	1.788e-103
URI91H	contig_21	14910	15651	741	renamed_GCF_000008685.2	lp17	13338	14079	741	100.0	7.64e-166
URI91H	contig_21	15641	15911	270	renamed_GCF_000008685.2	lp17	14069	14339	270	100.0	1.489e-55
URI91H	contig_22	271	859	588	renamed_GCF_000008685.2	lp21	14647	15235	588	100.0	4.973e-128
URI91H	contig_1	98807	100196	1389	renamed_GCF_000008685.2	chromosome	98816	100205	1389	100.0	9.726e-316
URI91H	contig_1	100218	100740	522	renamed_GCF_000008685.2	chromosome	100227	100749	522	100.0	2.976e-114
URI91H	contig_1	101330	100736	594	renamed_GCF_000008685.2	chromosome	101339	100745	594	100.0	6.255e-135
URI91H	contig_1	102940	101515	1425	renamed_GCF_000008685.2	chromosome	102949	101524	1425	100.0	1.009e-312
URI91H	contig_1	121814	121091	723	renamed_GCF_000008685.2	chromosome	121823	121100	723	100.0	1.695e-162
URI91H	contig_1	122482	121870	612	renamed_GCF_000008685.2	chromosome	122491	121879	612	100.0	3.269e-128
URI91H	contig_1	124137	122481	1656	renamed_GCF_000008685.2	chromosome	124146	122490	1656	100.0	0.0
URI91H	contig_1	124805	124139	666	renamed_GCF_000008685.2	chromosome	124814	124148	666	100.0	8.347e-144
URI91H	contig_1	125538	124788	750	renamed_GCF_000008685.2	chromosome	125547	124797	750	100.0	1.281e-161
URI91H	contig_1	126292	125524	768	renamed_GCF_000008685.2	chromosome	126301	125533	768	100.0	3.291e-171
URI91H	contig_1	156393	153693	2700	renamed_GCF_000008685.2	chromosome	156400	153700	2700	100.0	0.0
URI91H	contig_1	156454	157591	1137	renamed_GCF_000008685.2	chromosome	156461	157598	1137	100.0	1.164e-253
URI91H	contig_1	157619	158054	435	renamed_GCF_000008685.2	chromosome	157626	158061	435	100.0	6.167e-92
URI91H	contig_1	158050	158467	417	renamed_GCF_000008685.2	chromosome	158075	158474	417	100.0	2.72e-81
URI91H	contig_1	171090	170712	378	renamed_GCF_000008685.2	chromosome	171097	170719	378	100.0	1.603e-80
URI91H	contig_1	171243	171477	234	renamed_GCF_000008685.2	chromosome	171262	171484	234	98.6	1.134e-44
URI91H	contig_1	173573	171524	2049	renamed_GCF_000008685.2	chromosome	173535	171531	2049	99.8	0.0
URI91H	contig_1	174109	173521	588	renamed_GCF_000008685.2	chromosome	174116	173528	588	100.0	1.529e-132
URI91H	contig_1	175077	174090	987	renamed_GCF_000008685.2	chromosome	174970	174097	987	100.0	1.551e-190
URI91H	contig_1	193456	192316	1140	renamed_GCF_000008685.2	chromosome	193463	192323	1140	100.0	4.164e-257
URI91H	contig_1	194868	195729	861	renamed_GCF_000008685.2	chromosome	194875	195736	861	99.6	3.179e-187
URI91H	contig_1	195685	197689	2004	renamed_GCF_000008685.2	chromosome	195692	197696	2004	100.0	0.0
URI91H	contig_1	224778	223956	822	renamed_GCF_000008685.2	chromosome	224785	223963	822	100.0	3.638e-179
URI91H	contig_1	226603	224818	1785	renamed_GCF_000008685.2	chromosome	226610	224825	1785	100.0	0.0
URI91H	contig_1	227820	226602	1218	renamed_GCF_000008685.2	chromosome	227827	226609	1218	100.0	6.126e-266
URI91H	contig_1	228514	227806	708	renamed_GCF_000008685.2	chromosome	228521	227813	708	100.0	8.763e-159
URI91H	contig_1	240243	239136	1107	renamed_GCF_000008685.2	chromosome	240250	239143	1107	100.0	3.718e-244
URI91H	contig_1	242282	240275	2007	renamed_GCF_000008685.2	chromosome	242289	240282	2007	100.0	0.0
URI91H	contig_1	242430	243996	1566	renamed_GCF_000008685.2	chromosome	242437	244003	1566	100.0	0.0
URI91H	contig_1	244706	243935	771	renamed_GCF_000008685.2	chromosome	244713	243942	771	100.0	4.161e-169
URI91H	contig_1	255638	256253	615	renamed_GCF_000008685.2	chromosome	255645	256260	615	100.0	1.16e-131
URI91H	contig_1	256455	258978	2523	renamed_GCF_000008685.2	chromosome	256462	258985	2523	100.0	0.0
URI91H	contig_1	263705	261284	2421	renamed_GCF_000008685.2	chromosome	263712	261291	2421	100.0	0.0
URI91H	contig_1	263980	266107	2127	renamed_GCF_000008685.2	chromosome	263987	266114	2127	100.0	0.0
URI91H	contig_1	266099	267044	945	renamed_GCF_000008685.2	chromosome	266106	267051	945	100.0	6.277e-211
URI91H	contig_1	289576	288949	627	renamed_GCF_000008685.2	chromosome	289583	288956	627	100.0	2.836e-132
URI91H	contig_1	289910	289568	342	renamed_GCF_000008685.2	chromosome	289917	289575	342	100.0	1.077e-70
URI91H	contig_1	291014	289955	1059	renamed_GCF_000008685.2	chromosome	291021	289962	1059	100.0	3.164e-229
URI91H	contig_1	291588	291051	537	renamed_GCF_000008685.2	chromosome	291595	291058	537	100.0	7.638e-115
URI91H	contig_1	292419	291636	783	renamed_GCF_000008685.2	chromosome	292426	291643	783	100.0	1.874e-171
URI91H	contig_1	293201	292418	783	renamed_GCF_000008685.2	chromosome	293208	292425	783	100.0	6.057e-167
URI91H	contig_1	293422	293197	225	renamed_GCF_000008685.2	chromosome	293429	293204	225	100.0	8.8e-46
URI91H	contig_1	294773	293444	1329	renamed_GCF_000008685.2	chromosome	294780	293451	1329	100.0	2.397e-295
URI91H	contig_1	295221	294777	444	renamed_GCF_000008685.2	chromosome	295228	294784	444	100.0	1.185e-94
URI91H	contig_1	296413	295234	1179	renamed_GCF_000008685.2	chromosome	296420	295241	1179	100.0	1.072e-261
URI91H	contig_1	323773	322840	933	renamed_GCF_000008685.2	chromosome	323779	322846	933	100.0	1.839e-205
URI91H	contig_1	325230	323769	1461	renamed_GCF_000008685.2	chromosome	325236	323775	1461	100.0	0.0
URI91H	contig_1	326282	325229	1053	renamed_GCF_000008685.2	chromosome	326288	325235	1053	100.0	4.032e-234
URI91H	contig_1	327721	326692	1029	renamed_GCF_000008685.2	chromosome	327757	326698	1029	99.7	7.409e-232
URI91H	contig_1	328025	329159	1134	renamed_GCF_000008685.2	chromosome	328031	329165	1134	100.0	5.485e-253
URI91H	contig_1	329255	329615	360	renamed_GCF_000008685.2	chromosome	329261	329621	360	100.0	1.609e-77
URI91H	contig_1	330746	329636	1110	renamed_GCF_000008685.2	chromosome	330752	329642	1110	100.0	1.105e-249
URI91H	contig_1	333592	330796	2796	renamed_GCF_000008685.2	chromosome	333598	330802	2796	100.0	0.0
URI91H	contig_1	334509	333612	897	renamed_GCF_000008685.2	chromosome	334515	333618	897	100.0	1.666e-200
URI91H	contig_1	334930	336502	1572	renamed_GCF_000008685.2	chromosome	334936	336508	1572	100.0	0.0
URI91H	contig_1	381886	380548	1338	renamed_GCF_000008685.2	chromosome	381892	380554	1338	100.0	1.408e-311
URI91H	contig_1	383376	381903	1473	renamed_GCF_000008685.2	chromosome	383382	381909	1473	100.0	0.0
URI91H	contig_1	384156	383388	768	renamed_GCF_000008685.2	chromosome	384162	383394	768	100.0	1.961e-168
URI91H	contig_1	384280	385420	1140	renamed_GCF_000008685.2	chromosome	384286	385426	1140	100.0	7.242e-251
URI91H	contig_1	396500	395474	1026	renamed_GCF_000008685.2	chromosome	396506	395480	1026	100.0	3.003e-224
URI91H	contig_1	397071	396597	474	renamed_GCF_000008685.2	chromosome	397077	396603	474	100.0	4.822e-101
URI91H	contig_1	397470	397095	375	renamed_GCF_000008685.2	chromosome	397476	397101	375	100.0	1.385e-81
URI91H	contig_1	401671	397537	4134	renamed_GCF_000008685.2	chromosome	401677	397543	4134	100.0	0.0
URI91H	contig_1	405611	405236	375	renamed_GCF_000008685.2	chromosome	405617	405242	375	100.0	5.555e-75
URI91H	contig_1	423051	423831	780	renamed_GCF_000008685.2	chromosome	423054	423834	780	100.0	3.296e-173
URI91H	contig_1	424442	423818	624	renamed_GCF_000008685.2	chromosome	424442	423821	624	100.0	2.036e-135
URI91H	contig_1	424689	425547	858	renamed_GCF_000008685.2	chromosome	424693	425551	858	100.0	1.579e-194
URI91H	contig_1	425579	426707	1128	renamed_GCF_000008685.2	chromosome	425583	426711	1128	100.0	1.044e-244
URI91H	contig_1	447850	448168	318	renamed_GCF_000008685.2	chromosome	447854	448172	318	100.0	8.883e-69
URI91H	contig_1	448587	448197	390	renamed_GCF_000008685.2	chromosome	448591	448201	390	100.0	7.926e-82
URI91H	contig_1	448700	449306	606	renamed_GCF_000008685.2	chromosome	448707	449310	606	100.0	1.106e-130
URI91H	contig_1	449414	450167	753	renamed_GCF_000008685.2	chromosome	449418	450171	753	100.0	3.278e-160
URI91H	contig_1	451917	451134	783	renamed_GCF_000008685.2	chromosome	451921	451138	783	100.0	1.017e-169
URI91H	contig_1	464048	465128	1080	renamed_GCF_000008685.2	chromosome	464052	465132	1080	100.0	9.122e-247
URI91H	contig_1	467274	465513	1761	renamed_GCF_000008685.2	chromosome	467278	465517	1761	100.0	0.0
URI91H	contig_1	469383	467277	2106	renamed_GCF_000008685.2	chromosome	469387	467281	2106	100.0	0.0
URI91H	contig_1	469661	469385	276	renamed_GCF_000008685.2	chromosome	469665	469389	276	100.0	1.644e-55
URI91H	contig_1	479704	481015	1311	renamed_GCF_000008685.2	chromosome	479708	481019	1311	100.0	7.438e-297
URI91H	contig_1	482053	481339	714	renamed_GCF_000008685.2	chromosome	482057	481343	714	100.0	3.944e-160
URI91H	contig_1	482595	484278	1683	renamed_GCF_000008685.2	chromosome	482599	484282	1683	100.0	0.0
URI91H	contig_1	484282	484582	300	renamed_GCF_000008685.2	chromosome	484286	484586	300	100.0	5.976e-62
URI91H	contig_1	484752	485262	510	renamed_GCF_000008685.2	chromosome	484756	485266	510	100.0	1.216e-113
URI91H	contig_1	485545	486073	528	renamed_GCF_000008685.2	chromosome	485549	486077	528	100.0	1.004e-118
URI91H	contig_1	501007	501208	201	renamed_GCF_000008685.2	chromosome	501014	501212	201	98.4	1.098e-39
URI91H	contig_1	501210	501465	255	renamed_GCF_000008685.2	chromosome	501214	501469	255	100.0	1.745e-51
URI91H	contig_1	501492	501861	369	renamed_GCF_000008685.2	chromosome	501496	501865	369	100.0	9.223e-77
URI91H	contig_1	501875	502181	306	renamed_GCF_000008685.2	chromosome	501879	502185	306	100.0	2.959e-62
URI91H	contig_1	506997	507375	378	renamed_GCF_000008685.2	chromosome	507001	507379	378	100.0	8.763e-79
URI91H	contig_1	507401	507794	393	renamed_GCF_000008685.2	chromosome	507405	507798	393	100.0	3.073e-84
URI91H	contig_1	507809	508844	1035	renamed_GCF_000008685.2	chromosome	507813	508848	1035	100.0	4.156e-222
URI91H	contig_1	508865	509237	372	renamed_GCF_000008685.2	chromosome	508869	509241	372	100.0	8.775e-78
URI91H	contig_1	509309	510842	1533	renamed_GCF_000008685.2	chromosome	509313	510846	1533	100.0	0.0
URI91H	contig_1	510831	511620	789	renamed_GCF_000008685.2	chromosome	510835	511624	789	100.0	3.149e-175
URI91H	contig_1	542254	543016	762	renamed_GCF_000008685.2	chromosome	542262	543024	762	100.0	5.516e-173
URI91H	contig_1	543040	543808	768	renamed_GCF_000008685.2	chromosome	543048	543816	768	100.0	8.433e-178
URI91H	contig_1	555206	556571	1365	renamed_GCF_000008685.2	chromosome	555215	556580	1365	100.0	6.28e-308
URI91H	contig_1	557414	556553	861	renamed_GCF_000008685.2	chromosome	557423	556562	861	100.0	5.864e-189
URI91H	contig_1	558015	557397	618	renamed_GCF_000008685.2	chromosome	558024	557406	618	100.0	1.216e-131
URI91H	contig_1	560723	557996	2727	renamed_GCF_000008685.2	chromosome	560732	558005	2727	100.0	0.0
URI91H	contig_1	561118	560719	399	renamed_GCF_000008685.2	chromosome	561127	560728	399	100.0	7.535e-84
URI91H	contig_1	561545	561107	438	renamed_GCF_000008685.2	chromosome	561554	561116	438	100.0	1.44e-91
URI91H	contig_1	584871	584181	690	renamed_GCF_000008685.2	chromosome	584880	584190	690	100.0	9.609e-155
URI91H	contig_1	585082	586147	1065	renamed_GCF_000008685.2	chromosome	585079	586156	1065	99.7	1.659e-237
URI91H	contig_1	587021	587873	852	renamed_GCF_000008685.2	chromosome	587030	587882	852	100.0	3.506e-193
URI91H	contig_1	588056	589658	1602	renamed_GCF_000008685.2	chromosome	588065	589667	1602	100.0	0.0
URI91H	contig_1	590199	589674	525	renamed_GCF_000008685.2	chromosome	590208	589683	525	100.0	5.037e-109
URI91H	contig_1	590338	590926	588	renamed_GCF_000008685.2	chromosome	590347	590935	588	100.0	4.112e-130
URI91H	contig_1	591178	592348	1170	renamed_GCF_000008685.2	chromosome	591187	592357	1170	100.0	9.606e-253
URI91H	contig_1	592478	595922	3444	renamed_GCF_000008685.2	chromosome	592445	595931	3444	100.0	0.0
URI91H	contig_1	595933	596512	579	renamed_GCF_000008685.2	chromosome	595942	596521	579	100.0	3.772e-121
URI91H	contig_1	624997	626251	1254	renamed_GCF_000008685.2	chromosome	625006	626260	1254	100.0	1.925e-276
URI91H	contig_1	626276	627029	753	renamed_GCF_000008685.2	chromosome	626285	627038	753	100.0	9.23e-166
URI91H	contig_1	628939	627082	1857	renamed_GCF_000008685.2	chromosome	628948	627091	1857	100.0	0.0
URI91H	contig_1	630689	629186	1503	renamed_GCF_000008685.2	chromosome	630698	629195	1503	100.0	0.0
URI91H	contig_1	644640	643284	1356	renamed_GCF_000008685.2	chromosome	644650	643294	1356	100.0	1.597e-304
URI91H	contig_1	644761	645130	369	renamed_GCF_000008685.2	chromosome	644771	645140	369	100.0	1.529e-79
URI91H	contig_1	645591	645126	465	renamed_GCF_000008685.2	chromosome	645601	645136	465	100.0	4.176e-101
URI91H	contig_1	645708	646671	963	renamed_GCF_000008685.2	chromosome	645718	646681	963	100.0	1.162e-215
URI91H	contig_1	648316	646648	1668	renamed_GCF_000008685.2	chromosome	648254	646658	1668	100.0	0.0
URI91H	contig_1	648542	649097	555	renamed_GCF_000008685.2	chromosome	648552	649107	555	100.0	3.12e-119
URI91H	contig_1	682513	681673	840	renamed_GCF_000008685.2	chromosome	682524	681684	840	100.0	1.641e-182
URI91H	contig_1	682667	683366	699	renamed_GCF_000008685.2	chromosome	682678	683377	699	100.0	1.337e-152
URI91H	contig_1	683411	684956	1545	renamed_GCF_000008685.2	chromosome	683422	684967	1545	100.0	0.0
URI91H	contig_1	685969	684985	984	renamed_GCF_000008685.2	chromosome	685980	684996	984	100.0	1.708e-223
URI91H	contig_1	686496	685965	531	renamed_GCF_000008685.2	chromosome	686507	685976	531	100.0	1.053e-118
URI91H	contig_1	688478	690116	1638	renamed_GCF_000008685.2	chromosome	688489	690127	1638	100.0	0.0
URI91H	contig_1	690181	690478	297	renamed_GCF_000008685.2	chromosome	690192	690489	297	100.0	1.037e-63
URI91H	contig_1	690491	690788	297	renamed_GCF_000008685.2	chromosome	690481	690799	297	98.9	6.955e-60
URI91H	contig_1	690873	692634	1761	renamed_GCF_000008685.2	chromosome	690884	692645	1761	100.0	0.0
URI91H	contig_1	701813	702263	450	renamed_GCF_000008685.2	chromosome	701824	702274	450	100.0	9.762e-98
URI91H	contig_1	702955	702271	684	renamed_GCF_000008685.2	chromosome	702951	702282	684	100.0	4.537e-145
URI91H	contig_1	702997	703957	960	renamed_GCF_000008685.2	chromosome	703008	703968	960	100.0	6.008e-214
URI91H	contig_1	703919	704948	1029	renamed_GCF_000008685.2	chromosome	703960	704959	1029	99.6	3.451e-223
URI91H	contig_1	704937	705489	552	renamed_GCF_000008685.2	chromosome	704948	705500	552	100.0	2.458e-121
URI91H	contig_1	705568	706594	1026	renamed_GCF_000008685.2	chromosome	705579	706605	1026	100.0	2.737e-225
URI91H	contig_1	706661	709256	2595	renamed_GCF_000008685.2	chromosome	706672	709267	2595	100.0	0.0
URI91H	contig_1	709262	710663	1401	renamed_GCF_000008685.2	chromosome	709273	710674	1401	100.0	3.758e-311
URI91H	contig_1	710674	711160	486	renamed_GCF_000008685.2	chromosome	710685	711171	486	100.0	5.304e-102
URI91H	contig_1	711199	711640	441	renamed_GCF_000008685.2	chromosome	711210	711651	441	100.0	1.245e-93
URI91H	contig_1	735340	736675	1335	renamed_GCF_000008685.2	chromosome	735351	736686	1335	100.0	6.003e-286
URI91H	contig_1	736687	736948	261	renamed_GCF_000008685.2	chromosome	736698	736959	261	100.0	3.165e-54
URI91H	contig_1	736948	737197	249	renamed_GCF_000008685.2	chromosome	736959	737208	249	100.0	2.148e-48
URI91H	contig_1	737200	737701	501	renamed_GCF_000008685.2	chromosome	737211	737712	501	100.0	9.268e-107
URI91H	contig_1	745290	746322	1032	renamed_GCF_000008685.2	chromosome	745301	746333	1032	100.0	2.498e-227
URI91H	contig_1	748112	750008	1896	renamed_GCF_000008685.2	chromosome	748122	750018	1896	100.0	0.0
URI91H	contig_1	750020	750779	759	renamed_GCF_000008685.2	chromosome	750030	750789	759	100.0	2.255e-165
URI91H	contig_1	751180	752149	969	renamed_GCF_000008685.2	chromosome	751190	752159	969	100.0	4.772e-218
URI91H	contig_1	752159	753209	1050	renamed_GCF_000008685.2	chromosome	752169	753219	1050	100.0	6.109e-229
URI91H	contig_1	791777	790796	981	renamed_GCF_000008685.2	chromosome	791787	790806	981	100.0	5.759e-218
URI91H	contig_1	792242	791783	459	renamed_GCF_000008685.2	chromosome	792252	791793	459	100.0	5.068e-98
URI91H	contig_1	792340	793615	1275	renamed_GCF_000008685.2	chromosome	792350	793625	1275	100.0	1.279e-284
URI91H	contig_1	794845	793831	1014	renamed_GCF_000008685.2	chromosome	794855	793841	1014	100.0	1.719e-228
URI91H	contig_1	806914	805765	1149	renamed_GCF_000008685.2	chromosome	806923	805774	1149	100.0	1.098e-247
URI91H	contig_1	807957	806910	1047	renamed_GCF_000008685.2	chromosome	807966	806919	1047	100.0	5.315e-230
URI91H	contig_1	808455	807966	489	renamed_GCF_000008685.2	chromosome	808464	807975	489	100.0	6.125e-101
URI91H	contig_1	809543	808451	1092	renamed_GCF_000008685.2	chromosome	809552	808460	1092	100.0	7.863e-242
URI91H	contig_1	810486	809691	795	renamed_GCF_000008685.2	chromosome	810495	809700	795	100.0	1.877e-173
URI91H	contig_1	853741	854809	1068	renamed_GCF_000008685.2	chromosome	853774	854842	1068	100.0	1.362e-231
URI91H	contig_1	854835	855963	1128	renamed_GCF_000008685.2	chromosome	854868	855996	1128	100.0	2.385e-261
URI91H	contig_1	855955	857476	1521	renamed_GCF_000008685.2	chromosome	855988	857509	1521	100.0	0.0
URI91H	contig_1	857472	858882	1410	renamed_GCF_000008685.2	chromosome	857505	858915	1410	100.0	1.384e-306
URI91H	contig_1	860078	858905	1173	renamed_GCF_000008685.2	chromosome	860111	858938	1173	100.0	1.287e-258
URI91H	contig_1	860406	861741	1335	renamed_GCF_000008685.2	chromosome	860439	861774	1335	100.0	8.434e-291
URI91H	contig_1	862666	863614	948	renamed_GCF_000008685.2	chromosome	862698	863646	948	100.0	4.292e-207
URI91H	contig_1	863603	865010	1407	renamed_GCF_000008685.2	chromosome	863635	865042	1407	100.0	1.287e-315
URI91H	contig_1	865020	865887	867	renamed_GCF_000008685.2	chromosome	865052	865919	867	100.0	6.442e-189
URI91H	contig_1	897663	897063	600	renamed_GCF_000008685.2	chromosome	897695	897095	600	100.0	6.881e-135
URI91H	contig_1	899288	897671	1617	renamed_GCF_000008685.2	chromosome	899320	897703	1617	100.0	0.0
URI91H	contig_1	899466	900699	1233	renamed_GCF_000008685.2	chromosome	899498	900731	1233	100.0	1.522e-275
URI91H	contig_1	900766	901750	984	renamed_GCF_000008685.2	chromosome	900798	901782	984	100.0	5.014e-220
URI91H	contig_2	17343	17076	267	renamed_GCF_000008685.2	lp54	36255	36534	267	98.8	1.568e-54
URI91H	contig_2	17657	17381	276	renamed_GCF_000008685.2	lp54	35953	36229	276	100.0	3.31e-56
URI91H	contig_2	18623	17777	846	renamed_GCF_000008685.2	lp54	34987	35833	846	100.0	5.585e-187
URI91H	contig_2	19226	18662	564	renamed_GCF_000008685.2	lp54	34384	34948	564	100.0	7.276e-120
URI91H	contig_2	20869	20650	219	renamed_GCF_000008685.2	lp54	32741	32960	219	100.0	7.958e-46
URI91H	contig_2	38231	37799	432	renamed_GCF_000008685.2	lp54	15369	15801	432	100.0	1.792e-96
URI91H	contig_2	39263	38717	546	renamed_GCF_000008685.2	lp54	14337	14883	546	100.0	1.338e-118
URI91H	contig_2	40046	39293	753	renamed_GCF_000008685.2	lp54	13554	14307	753	100.0	4.561e-165
URI91H	contig_2	48287	47951	336	renamed_GCF_000008685.2	lp54	5313	5649	336	100.0	1.784e-72
URI91H	contig_2	48460	48934	474	renamed_GCF_000008685.2	lp54	5140	4666	474	100.0	5.31e-100
URI91H	contig_2	49344	50598	1254	renamed_GCF_000008685.2	lp54	4256	3002	1254	100.0	3.245e-279
URI91H	contig_2	50707	51556	849	renamed_GCF_000008685.2	lp54	2893	2044	849	100.0	5.332e-188
URI91H	contig_2	52140	51630	510	renamed_GCF_000008685.2	lp54	1460	1970	510	100.0	8.829e-109
URI91H	contig_3	26844	26088	756	renamed_GCF_000008685.2	lp56	24517	25273	756	100.0	1.063e-164
URI91H	contig_3	27386	26819	567	renamed_GCF_000008685.2	lp56	23975	24542	567	100.0	1.456e-129
URI91H	contig_3	28493	27395	1098	renamed_GCF_000008685.2	lp56	22868	23966	1098	100.0	9.161e-250
URI91H	contig_3	28882	29830	948	renamed_GCF_000008685.2	lp56	22479	21531	948	100.0	7.628e-218
URI91H	contig_3	35952	35397	555	renamed_GCF_000008685.2	lp56	15409	15964	555	100.0	3.12e-119
URI91H	contig_3	37607	36923	684	renamed_GCF_000008685.2	lp56	13754	14438	684	100.0	3.113e-149
URI91H	contig_3	38925	37629	1296	renamed_GCF_000008685.2	lp56	12436	13732	1296	100.0	4.732e-282
URI91H	contig_3	39169	38932	237	renamed_GCF_000008685.2	cp32-4	8733	8970	237	100.0	1.76e-48
URI91H	contig_3	39621	39165	456	renamed_GCF_000008685.2	cp32-4	8281	8737	456	100.0	1.971e-99
URI91H	contig_4	32996	33584	588	renamed_GCF_000008685.2	lp38	11105	10517	588	100.0	1.006e-128
URI91H	contig_4	34963	35239	276	renamed_GCF_000008685.2	lp38	9155	8876	276	98.9	6.666e-57
URI91H	contig_4	38027	37253	774	renamed_GCF_000008685.2	lp38	6088	6862	774	100.0	2.049e-160
URI91H	contig_4	39510	38619	891	renamed_GCF_000008685.2	lp38	4575	5496	891	99.6	4.218e-189
URI91H	contig_5	8144	8690	546	renamed_GCF_000008685.2	lp36	26358	25812	546	100.0	8.009e-116
URI91H	contig_5	9400	8845	555	renamed_GCF_000008685.2	lp36	25102	25657	555	100.0	3.12e-119
URI91H	contig_5	10436	10259	177	renamed_GCF_000008685.2	lp36	24066	24243	177	100.0	7.659e-32
URI91H	contig_5	20176	20926	750	renamed_GCF_000008685.2	lp36	14326	13576	750	100.0	1.062e-163
URI91H	contig_5	21901	21265	636	renamed_GCF_000008685.2	lp36	12601	13237	636	100.0	3.41e-140
URI91H	contig_5	24202	22555	1647	renamed_GCF_000008685.2	lp36	10300	11947	1647	100.0	0.0
URI91H	contig_5	25130	24503	627	renamed_GCF_000008685.2	lp36	9372	9999	627	100.0	1.942e-136
URI91H	contig_5	25643	26339	696	renamed_GCF_000008685.2	lp36	8859	8163	696	100.0	1.275e-152
URI91H	contig_6	16479	16773	294	renamed_GCF_000008685.2	lp28-1	10895	10697	294	100.0	9.155e-41
URI91H	contig_6	18699	18441	258	renamed_GCF_000008685.2	lp28-1	8771	9029	258	100.0	1.351e-54
URI91H	contig_7	168	546	378	renamed_GCF_000008685.2	lp21	252	618	378	91.1	1.743e-71
URI91H	contig_7	1696	2428	732	renamed_GCF_000008685.2	lp25	22677	21945	732	100.0	5.239e-160
URI91H	contig_8	4563	5130	567	renamed_GCF_000008685.2	lp56	9623	10190	567	98.9	5.214e-124
URI91H	contig_10	580	1273	693	renamed_GCF_000008685.2	cp32-3	1305	1998	693	100.0	2.582e-144
URI91H	contig_10	10226	11177	951	renamed_GCF_000008685.2	cp32-1	10951	11902	951	100.0	4.333e-216
URI91H	contig_10	11194	11740	546	renamed_GCF_000008685.2	cp32-3	11919	12465	546	100.0	7.28e-117
URI91H	contig_11	5392	4300	1092	renamed_GCF_000008685.2	cp32-7	26892	27984	1092	65.8	3.036e-147
URI91H	contig_11	6151	5443	708	renamed_GCF_000008685.2	cp32-7	26151	26841	708	83.9	2.557e-121
URI91H	contig_11	23458	23221	237	renamed_GCF_000008685.2	cp32-7	8725	8962	237	97.4	1.95e-47
URI91H	contig_11	25481	24368	1113	renamed_GCF_000008685.2	cp32-7	6702	7815	1113	100.0	3.095e-247
URI91H	contig_12	30153	29607	546	renamed_GCF_000008685.2	cp32-1	11919	12465	546	100.0	7.28e-117
URI91H	contig_13	6708	5757	951	renamed_GCF_000008685.2	cp32-9	11040	11991	951	99.6	2.14e-215
URI91H	contig_13	8604	7329	1275	renamed_GCF_000008685.2	cp32-9	8985	10260	1275	99.5	6.494e-275
URI91H	contig_13	8848	8611	237	renamed_GCF_000008685.2	lp56	12192	12429	237	100.0	1.76e-48
URI91H	contig_14	784	1897	1113	renamed_GCF_000008685.2	cp32-4	6710	7823	1113	100.0	1.393e-247
URI91H	contig_14	10112	10466	354	renamed_GCF_000008685.2	cp32-4	16038	16392	354	100.0	6.554e-78
URI91H	contig_14	10570	11071	501	renamed_GCF_000008685.2	cp32-4	16496	16997	501	100.0	5.048e-105
URI91H	contig_14	11176	11599	423	renamed_GCF_000008685.2	cp32-4	17102	17525	423	100.0	4.616e-93
URI91H	contig_14	12657	11646	1011	renamed_GCF_000008685.2	cp32-4	18583	17572	1011	100.0	1.362e-230
URI91H	contig_14	13033	14131	1098	renamed_GCF_000008685.2	cp32-4	18959	20057	1098	100.0	8.352e-251
URI91H	contig_15	5023	4147	876	renamed_GCF_000008685.2	cp32-3	12823	13699	876	100.0	5.609e-192
URI91H	contig_15	6895	5944	951	renamed_GCF_000008685.2	cp32-3	10951	11902	951	100.0	4.333e-216
URI91H	contig_15	13884	12924	960	renamed_GCF_000008685.2	cp32-3	3962	4922	960	100.0	6.593e-213
URI91H	contig_15	15836	15278	558	renamed_GCF_000008685.2	cp32-3	2010	2568	558	100.0	1.105e-122
URI91H	contig_15	17781	16557	1224	renamed_GCF_000008685.2	cp32-8	65	1289	1224	100.0	2.096e-270
URI91H	contig_16	15978	15285	693	renamed_GCF_000008685.2	cp32-6	1305	1998	693	100.0	1.162e-144
URI91H	contig_16	18636	17283	1353	renamed_GCF_000008685.2	cp32-6	28485	29838	1353	100.0	6.259e-306
URI91H	contig_16	19199	18632	567	renamed_GCF_000008685.2	cp32-6	27922	28489	567	100.0	2.836e-122
URI91H	contig_17	158	1052	894	renamed_GCF_000008685.2	lp28-2	115	1009	894	100.0	3.048e-193
URI91H	contig_17	5953	6721	768	renamed_GCF_000008685.2	lp28-2	5910	6678	768	100.0	2.365e-166
URI91H	contig_17	18870	18072	798	renamed_GCF_000008685.2	lp28-2	18827	18029	798	100.0	7.719e-184
URI91H	contig_17	22347	19662	2685	renamed_GCF_000008685.2	lp28-2	22259	19619	2685	99.8	0.0
URI91H	contig_17	23076	22701	375	renamed_GCF_000008685.2	lp28-2	23033	22658	375	100.0	2.05e-77
URI91H	contig_17	26022	26433	411	renamed_GCF_000008685.2	lp28-2	25979	26390	411	100.0	2.076e-91
URI91H	contig_18	14884	15781	897	renamed_GCF_000008685.2	lp28-3	16518	17415	897	100.0	1.518e-201
URI91H	contig_18	16312	17068	756	renamed_GCF_000008685.2	lp28-3	17946	18702	756	100.0	8.81e-167
URI91H	contig_18	17163	17793	630	renamed_GCF_000008685.2	lp28-3	18797	19427	630	100.0	1.007e-135
URI91H	contig_18	24710	23798	912	renamed_GCF_000008685.2	lp28-3	26371	25432	912	100.0	5.639e-198
URI91H	contig_19	14659	14086	573	renamed_GCF_000008685.2	lp28-4	13264	13837	573	100.0	2.579e-124
URI91H	contig_21	9838	10951	1113	renamed_GCF_000008685.2	lp17	8266	9379	1113	100.0	6.27e-248
URI91H	contig_21	13218	12555	663	renamed_GCF_000008685.2	lp17	11646	10983	663	100.0	1.005e-149
URI91H	contig_22	6295	5302	993	renamed_GCF_000008685.2	lp21	16885	17878	993	100.0	1.858e-215
URI91H	contig_22	20004	19215	789	renamed_GCF_000008685.2	lp21	2867	3656	789	100.0	1.29e-176
URI91H	contig_22	21353	20243	1110	renamed_GCF_000008685.2	lp21	1485	2628	1110	100.0	3.133e-255
URI91H	contig_23	191	743	552	renamed_GCF_000008685.2	lp56	855	1407	552	100.0	4.97e-122