QUERY_ID	QUERY_NAME	QUERY_START	QUERY_END	QUERY_LENGTH	REF_ID	REF_NAME	REF_START	REF_END	REF_LENGTH	IDENTITY	EVALUE
GCF_040790755.1_ASM4079075v1_genomic	NZ_CP161091.1	18335	17822	513	renamed_GCF_000008685.2	chromosome	18304	17791	513	99.4	1.872e-109
GCF_040790755.1_ASM4079075v1_genomic	NZ_CP161091.1	22612	22018	594	renamed_GCF_000008685.2	chromosome	22739	22145	594	99.4	7.271e-125
GCF_040790755.1_ASM4079075v1_genomic	NZ_CP161091.1	25496	24569	927	renamed_GCF_000008685.2	chromosome	25623	24696	927	99.0	6.495e-199
GCF_040790755.1_ASM4079075v1_genomic	NZ_CP161091.1	26271	27321	1050	renamed_GCF_000008685.2	chromosome	26398	27448	1050	98.8	1.9e-233
GCF_040790755.1_ASM4079075v1_genomic	NZ_CP161091.1	28363	27727	636	renamed_GCF_000008685.2	chromosome	28490	27854	636	98.5	2.037e-137
GCF_040790755.1_ASM4079075v1_genomic	NZ_CP161091.1	29415	30888	1473	renamed_GCF_000008685.2	chromosome	29542	31015	1473	98.9	0.0
GCF_040790755.1_ASM4079075v1_genomic	NZ_CP161091.1	31962	31422	540	renamed_GCF_000008685.2	chromosome	32089	31549	540	99.4	1.619e-115
GCF_040790755.1_ASM4079075v1_genomic	NZ_CP161091.1	35709	33909	1800	renamed_GCF_000008685.2	chromosome	35836	34036	1800	99.6	0.0
GCF_040790755.1_ASM4079075v1_genomic	NZ_CP161091.1	39698	40550	852	renamed_GCF_000008685.2	chromosome	39825	40677	852	99.2	2.515e-188
GCF_040790755.1_ASM4079075v1_genomic	NZ_CP161091.1	42356	41315	1041	renamed_GCF_000008685.2	chromosome	42483	41442	1041	99.1	1.075e-229
GCF_040790755.1_ASM4079075v1_genomic	NZ_CP161091.1	42754	42352	402	renamed_GCF_000008685.2	chromosome	42881	42479	402	100.0	2.405e-88
GCF_040790755.1_ASM4079075v1_genomic	NZ_CP161091.1	45318	45864	546	renamed_GCF_000008685.2	chromosome	45445	45991	546	98.8	3.601e-116
GCF_040790755.1_ASM4079075v1_genomic	NZ_CP161091.1	46252	45883	369	renamed_GCF_000008685.2	chromosome	46379	46010	369	99.1	1.529e-79
GCF_040790755.1_ASM4079075v1_genomic	NZ_CP161091.1	47777	48479	702	renamed_GCF_000008685.2	chromosome	47916	48606	702	98.6	2.464e-146
GCF_040790755.1_ASM4079075v1_genomic	NZ_CP161091.1	49213	49885	672	renamed_GCF_000008685.2	chromosome	49340	50012	672	100.0	9.591e-152
GCF_040790755.1_ASM4079075v1_genomic	NZ_CP161091.1	51124	50362	762	renamed_GCF_000008685.2	chromosome	51251	50489	762	100.0	1.168e-164
GCF_040790755.1_ASM4079075v1_genomic	NZ_CP161091.1	53334	52326	1008	renamed_GCF_000008685.2	chromosome	53461	52453	1008	100.0	6.65e-221
GCF_040790755.1_ASM4079075v1_genomic	NZ_CP161091.1	76321	77572	1251	renamed_GCF_000008685.2	chromosome	76450	77701	1251	100.0	1.724e-268
GCF_040790755.1_ASM4079075v1_genomic	NZ_CP161091.1	79217	78866	351	renamed_GCF_000008685.2	chromosome	79322	79001	351	100.0	3.732e-67
GCF_040790755.1_ASM4079075v1_genomic	NZ_CP161091.1	93285	92739	546	renamed_GCF_000008685.2	chromosome	93423	92877	546	97.2	1.619e-116
GCF_040790755.1_ASM4079075v1_genomic	NZ_CP161091.1	94467	94080	387	renamed_GCF_000008685.2	chromosome	94605	94218	387	100.0	1.031e-86
GCF_040790755.1_ASM4079075v1_genomic	NZ_CP161091.1	97728	96804	924	renamed_GCF_000008685.2	chromosome	97866	96942	924	100.0	7.888e-205
GCF_040790755.1_ASM4079075v1_genomic	NZ_CP161091.1	98677	100066	1389	renamed_GCF_000008685.2	chromosome	98816	100205	1389	99.5	2.368e-314
GCF_040790755.1_ASM4079075v1_genomic	NZ_CP161091.1	101200	100606	594	renamed_GCF_000008685.2	chromosome	101339	100745	594	99.4	3.093e-134
GCF_040790755.1_ASM4079075v1_genomic	NZ_CP161091.1	114465	112770	1695	renamed_GCF_000008685.2	chromosome	114603	112908	1695	100.0	0.0
GCF_040790755.1_ASM4079075v1_genomic	NZ_CP161091.1	116668	115366	1302	renamed_GCF_000008685.2	chromosome	116806	115504	1302	98.1	2.563e-281
GCF_040790755.1_ASM4079075v1_genomic	NZ_CP161091.1	118232	117539	693	renamed_GCF_000008685.2	chromosome	118370	117677	693	98.2	6.012e-152
GCF_040790755.1_ASM4079075v1_genomic	NZ_CP161091.1	179400	178773	627	renamed_GCF_000008685.2	chromosome	179543	178916	627	98.5	1.402e-131
GCF_040790755.1_ASM4079075v1_genomic	NZ_CP161091.1	189716	189155	561	renamed_GCF_000008685.2	chromosome	189859	189298	561	100.0	1.275e-121
GCF_040790755.1_ASM4079075v1_genomic	NZ_CP161091.1	190588	191329	741	renamed_GCF_000008685.2	chromosome	190718	191459	741	98.7	8.782e-156
GCF_040790755.1_ASM4079075v1_genomic	NZ_CP161091.1	193333	192193	1140	renamed_GCF_000008685.2	chromosome	193463	192323	1140	99.4	2.055e-256
GCF_040790755.1_ASM4079075v1_genomic	NZ_CP161091.1	195562	197566	2004	renamed_GCF_000008685.2	chromosome	195692	197696	2004	99.7	0.0
GCF_040790755.1_ASM4079075v1_genomic	NZ_CP161091.1	211184	211952	768	renamed_GCF_000008685.2	chromosome	211300	212068	768	99.6	4.359e-168
GCF_040790755.1_ASM4079075v1_genomic	NZ_CP161091.1	214824	216657	1833	renamed_GCF_000008685.2	chromosome	215426	217259	1833	99.0	0.0
GCF_040790755.1_ASM4079075v1_genomic	NZ_CP161091.1	218476	217822	654	renamed_GCF_000008685.2	chromosome	219078	218424	654	99.0	5.201e-147
GCF_040790755.1_ASM4079075v1_genomic	NZ_CP161091.1	219197	220037	840	renamed_GCF_000008685.2	chromosome	219799	220639	840	100.0	1.641e-182
GCF_040790755.1_ASM4079075v1_genomic	NZ_CP161091.1	221031	222576	1545	renamed_GCF_000008685.2	chromosome	221741	223178	1545	99.3	3.161e-311
GCF_040790755.1_ASM4079075v1_genomic	NZ_CP161091.1	291809	291026	783	renamed_GCF_000008685.2	chromosome	292426	291643	783	100.0	1.874e-171
GCF_040790755.1_ASM4079075v1_genomic	NZ_CP161091.1	292812	292587	225	renamed_GCF_000008685.2	chromosome	293429	293204	225	100.0	8.8e-46
GCF_040790755.1_ASM4079075v1_genomic	NZ_CP161091.1	294611	294167	444	renamed_GCF_000008685.2	chromosome	295228	294784	444	100.0	1.185e-94
GCF_040790755.1_ASM4079075v1_genomic	NZ_CP161091.1	296852	296420	432	renamed_GCF_000008685.2	chromosome	297469	297037	432	98.6	4.841e-94
GCF_040790755.1_ASM4079075v1_genomic	NZ_CP161091.1	307899	306699	1200	renamed_GCF_000008685.2	chromosome	308517	307317	1200	99.7	1.629e-260
GCF_040790755.1_ASM4079075v1_genomic	NZ_CP161091.1	309905	309161	744	renamed_GCF_000008685.2	chromosome	310523	309779	744	100.0	5.245e-162
GCF_040790755.1_ASM4079075v1_genomic	NZ_CP161091.1	312097	311041	1056	renamed_GCF_000008685.2	chromosome	312715	311659	1056	100.0	1.239e-230
GCF_040790755.1_ASM4079075v1_genomic	NZ_CP161091.1	313810	313528	282	renamed_GCF_000008685.2	chromosome	314427	314145	282	100.0	2.699e-59
GCF_040790755.1_ASM4079075v1_genomic	NZ_CP161091.1	314697	313806	891	renamed_GCF_000008685.2	chromosome	315314	314423	891	99.6	2.2e-196
GCF_040790755.1_ASM4079075v1_genomic	NZ_CP161091.1	316599	315522	1077	renamed_GCF_000008685.2	chromosome	317216	316139	1077	99.7	9.003e-238
GCF_040790755.1_ASM4079075v1_genomic	NZ_CP161091.1	327414	328551	1137	renamed_GCF_000008685.2	chromosome	328031	329165	1137	99.2	1.536e-250
GCF_040790755.1_ASM4079075v1_genomic	NZ_CP161091.1	330138	329028	1110	renamed_GCF_000008685.2	chromosome	330752	329642	1110	99.1	5.455e-249
GCF_040790755.1_ASM4079075v1_genomic	NZ_CP161091.1	333910	333013	897	renamed_GCF_000008685.2	chromosome	334515	333618	897	99.6	8.226e-200
GCF_040790755.1_ASM4079075v1_genomic	NZ_CP161091.1	337740	339366	1626	renamed_GCF_000008685.2	chromosome	338357	339983	1626	99.6	0.0
GCF_040790755.1_ASM4079075v1_genomic	NZ_CP161091.1	352823	350723	2100	renamed_GCF_000008685.2	chromosome	353437	351340	2100	98.4	0.0
GCF_040790755.1_ASM4079075v1_genomic	NZ_CP161091.1	354684	354033	651	renamed_GCF_000008685.2	chromosome	355298	354647	651	100.0	1.769e-141
GCF_040790755.1_ASM4079075v1_genomic	NZ_CP161091.1	356392	357826	1434	renamed_GCF_000008685.2	chromosome	357006	358440	1434	97.0	2.007e-306
GCF_040790755.1_ASM4079075v1_genomic	NZ_CP161091.1	358881	358602	279	renamed_GCF_000008685.2	chromosome	359495	359216	279	100.0	2.841e-58
GCF_040790755.1_ASM4079075v1_genomic	NZ_CP161091.1	360464	358898	1566	renamed_GCF_000008685.2	chromosome	361078	359512	1566	99.2	0.0
GCF_040790755.1_ASM4079075v1_genomic	NZ_CP161091.1	360585	361707	1122	renamed_GCF_000008685.2	chromosome	361187	362321	1122	98.9	6.579e-249
GCF_040790755.1_ASM4079075v1_genomic	NZ_CP161091.1	372525	372906	381	renamed_GCF_000008685.2	chromosome	373139	373520	381	100.0	1.683e-80
GCF_040790755.1_ASM4079075v1_genomic	NZ_CP161091.1	373537	372952	585	renamed_GCF_000008685.2	chromosome	374151	373566	585	98.4	1.16e-126
GCF_040790755.1_ASM4079075v1_genomic	NZ_CP161091.1	373662	375039	1377	renamed_GCF_000008685.2	chromosome	374276	375653	1377	99.3	1.534e-308
GCF_040790755.1_ASM4079075v1_genomic	NZ_CP161091.1	375046	375325	279	renamed_GCF_000008685.2	chromosome	375660	375939	279	98.9	1.561e-56
GCF_040790755.1_ASM4079075v1_genomic	NZ_CP161091.1	376405	375346	1059	renamed_GCF_000008685.2	chromosome	377019	375960	1059	98.0	1.713e-227
GCF_040790755.1_ASM4079075v1_genomic	NZ_CP161091.1	378716	376424	2292	renamed_GCF_000008685.2	chromosome	379258	377038	2292	98.5	0.0
GCF_040790755.1_ASM4079075v1_genomic	NZ_CP161091.1	379944	378726	1218	renamed_GCF_000008685.2	chromosome	380558	379340	1218	99.5	4.24e-270
GCF_040790755.1_ASM4079075v1_genomic	NZ_CP161091.1	381278	379940	1338	renamed_GCF_000008685.2	chromosome	381892	380554	1338	100.0	1.408e-311
GCF_040790755.1_ASM4079075v1_genomic	NZ_CP161091.1	382768	381295	1473	renamed_GCF_000008685.2	chromosome	383382	381909	1473	99.7	0.0
GCF_040790755.1_ASM4079075v1_genomic	NZ_CP161091.1	383548	382780	768	renamed_GCF_000008685.2	chromosome	384162	383394	768	99.6	9.689e-168
GCF_040790755.1_ASM4079075v1_genomic	NZ_CP161091.1	394552	393490	1062	renamed_GCF_000008685.2	chromosome	395166	394104	1062	99.7	9.401e-235
GCF_040790755.1_ASM4079075v1_genomic	NZ_CP161091.1	395894	394868	1026	renamed_GCF_000008685.2	chromosome	396506	395480	1026	99.7	3.294e-223
GCF_040790755.1_ASM4079075v1_genomic	NZ_CP161091.1	396465	395991	474	renamed_GCF_000008685.2	chromosome	397077	396603	474	99.3	4.822e-101
GCF_040790755.1_ASM4079075v1_genomic	NZ_CP161091.1	396864	396489	375	renamed_GCF_000008685.2	chromosome	397476	397101	375	100.0	1.385e-81
GCF_040790755.1_ASM4079075v1_genomic	NZ_CP161091.1	401065	396931	4134	renamed_GCF_000008685.2	chromosome	401677	397543	4134	99.8	0.0
GCF_040790755.1_ASM4079075v1_genomic	NZ_CP161091.1	405005	404630	375	renamed_GCF_000008685.2	chromosome	405617	405242	375	99.1	2.753e-74
GCF_040790755.1_ASM4079075v1_genomic	NZ_CP161091.1	405564	405075	489	renamed_GCF_000008685.2	chromosome	406176	405687	489	100.0	1.238e-101
GCF_040790755.1_ASM4079075v1_genomic	NZ_CP161091.1	406249	405568	681	renamed_GCF_000008685.2	chromosome	406861	406180	681	100.0	2.702e-150
GCF_040790755.1_ASM4079075v1_genomic	NZ_CP161091.1	406680	406248	432	renamed_GCF_000008685.2	chromosome	407292	406860	432	100.0	3.534e-89
GCF_040790755.1_ASM4079075v1_genomic	NZ_CP161091.1	416488	417100	612	renamed_GCF_000008685.2	chromosome	417101	417713	612	100.0	4.975e-132
GCF_040790755.1_ASM4079075v1_genomic	NZ_CP161091.1	417110	417722	612	renamed_GCF_000008685.2	chromosome	417723	418335	612	99.0	7.572e-136
GCF_040790755.1_ASM4079075v1_genomic	NZ_CP161091.1	418893	417774	1119	renamed_GCF_000008685.2	chromosome	419506	418387	1119	99.7	3.957e-254
GCF_040790755.1_ASM4079075v1_genomic	NZ_CP161091.1	420770	418889	1881	renamed_GCF_000008685.2	chromosome	421380	419502	1881	99.2	0.0
GCF_040790755.1_ASM4079075v1_genomic	NZ_CP161091.1	420944	421574	630	renamed_GCF_000008685.2	chromosome	421553	422183	630	98.5	3.409e-139
GCF_040790755.1_ASM4079075v1_genomic	NZ_CP161091.1	422448	423228	780	renamed_GCF_000008685.2	chromosome	423054	423834	780	100.0	3.296e-173
GCF_040790755.1_ASM4079075v1_genomic	NZ_CP161091.1	423839	423215	624	renamed_GCF_000008685.2	chromosome	424442	423821	624	99.5	4.527e-135
GCF_040790755.1_ASM4079075v1_genomic	NZ_CP161091.1	424086	424944	858	renamed_GCF_000008685.2	chromosome	424693	425551	858	100.0	1.579e-194
GCF_040790755.1_ASM4079075v1_genomic	NZ_CP161091.1	458912	459212	300	renamed_GCF_000008685.2	chromosome	459524	459824	300	95.9	4.432e-57
GCF_040790755.1_ASM4079075v1_genomic	NZ_CP161091.1	470607	469347	1260	renamed_GCF_000008685.2	chromosome	471220	469960	1260	99.0	6.777e-272
GCF_040790755.1_ASM4079075v1_genomic	NZ_CP161091.1	471143	470609	534	renamed_GCF_000008685.2	chromosome	471756	471222	534	99.4	1.961e-112
GCF_040790755.1_ASM4079075v1_genomic	NZ_CP161091.1	471862	471157	705	renamed_GCF_000008685.2	chromosome	472358	471770	705	99.4	1.099e-121
GCF_040790755.1_ASM4079075v1_genomic	NZ_CP161091.1	471952	472795	843	renamed_GCF_000008685.2	chromosome	472565	473408	843	98.9	2.632e-186
GCF_040790755.1_ASM4079075v1_genomic	NZ_CP161091.1	473943	472791	1152	renamed_GCF_000008685.2	chromosome	474556	473404	1152	99.7	3.808e-260
GCF_040790755.1_ASM4079075v1_genomic	NZ_CP161091.1	473999	474989	990	renamed_GCF_000008685.2	chromosome	474612	475602	990	98.4	5.2e-212
GCF_040790755.1_ASM4079075v1_genomic	NZ_CP161091.1	474992	475598	606	renamed_GCF_000008685.2	chromosome	475605	476211	606	99.5	2.237e-131
GCF_040790755.1_ASM4079075v1_genomic	NZ_CP161091.1	477460	475648	1812	renamed_GCF_000008685.2	chromosome	478005	476262	1812	100.0	0.0
GCF_040790755.1_ASM4079075v1_genomic	NZ_CP161091.1	497277	497574	297	renamed_GCF_000008685.2	chromosome	497894	498191	297	100.0	5.69e-62
GCF_040790755.1_ASM4079075v1_genomic	NZ_CP161091.1	502138	502324	186	renamed_GCF_000008685.2	chromosome	502755	502941	186	100.0	7.664e-41
GCF_040790755.1_ASM4079075v1_genomic	NZ_CP161091.1	502333	502732	399	renamed_GCF_000008685.2	chromosome	502950	503349	399	99.2	3.385e-84
GCF_040790755.1_ASM4079075v1_genomic	NZ_CP161091.1	502748	503291	543	renamed_GCF_000008685.2	chromosome	503365	503908	543	100.0	7.636e-116
GCF_040790755.1_ASM4079075v1_genomic	NZ_CP161091.1	503308	503668	360	renamed_GCF_000008685.2	chromosome	503925	504285	360	100.0	4.361e-75
GCF_040790755.1_ASM4079075v1_genomic	NZ_CP161091.1	503680	504178	498	renamed_GCF_000008685.2	chromosome	504297	504795	498	100.0	1.785e-107
GCF_040790755.1_ASM4079075v1_genomic	NZ_CP161091.1	504181	504487	306	renamed_GCF_000008685.2	chromosome	504798	505104	306	99.0	3.271e-61
GCF_040790755.1_ASM4079075v1_genomic	NZ_CP161091.1	504486	504924	438	renamed_GCF_000008685.2	chromosome	505103	505541	438	100.0	1.186e-93
GCF_040790755.1_ASM4079075v1_genomic	NZ_CP161091.1	504936	506241	1305	renamed_GCF_000008685.2	chromosome	505553	506858	1305	99.7	2.039e-284
GCF_040790755.1_ASM4079075v1_genomic	NZ_CP161091.1	506253	506367	114	renamed_GCF_000008685.2	chromosome	506864	506984	114	100.0	7.638e-22
GCF_040790755.1_ASM4079075v1_genomic	NZ_CP161091.1	533676	534531	855	renamed_GCF_000008685.2	chromosome	534300	535155	855	100.0	8.967e-192
GCF_040790755.1_ASM4079075v1_genomic	NZ_CP161091.1	543961	546763	2802	renamed_GCF_000008685.2	chromosome	544585	547387	2802	98.7	0.0
GCF_040790755.1_ASM4079075v1_genomic	NZ_CP161091.1	547866	547221	645	renamed_GCF_000008685.2	chromosome	548490	547845	645	100.0	1.056e-137
GCF_040790755.1_ASM4079075v1_genomic	NZ_CP161091.1	548261	547862	399	renamed_GCF_000008685.2	chromosome	548885	548486	399	99.2	3.385e-84
GCF_040790755.1_ASM4079075v1_genomic	NZ_CP161091.1	548994	548295	699	renamed_GCF_000008685.2	chromosome	549618	548919	699	100.0	1.058e-146
GCF_040790755.1_ASM4079075v1_genomic	NZ_CP161091.1	551099	549017	2082	renamed_GCF_000008685.2	chromosome	551723	549641	2082	99.7	0.0
GCF_040790755.1_ASM4079075v1_genomic	NZ_CP161091.1	552520	553171	651	renamed_GCF_000008685.2	chromosome	553138	553789	651	99.5	7.238e-143
GCF_040790755.1_ASM4079075v1_genomic	NZ_CP161091.1	553373	554594	1221	renamed_GCF_000008685.2	chromosome	553991	555212	1221	99.7	2.636e-267
GCF_040790755.1_ASM4079075v1_genomic	NZ_CP161091.1	576636	577179	543	renamed_GCF_000008685.2	chromosome	577394	577937	543	99.4	3.433e-116
GCF_040790755.1_ASM4079075v1_genomic	NZ_CP161091.1	604013	602969	1044	renamed_GCF_000008685.2	chromosome	604769	603725	1044	99.7	1.577e-234
GCF_040790755.1_ASM4079075v1_genomic	NZ_CP161091.1	606227	604022	2205	renamed_GCF_000008685.2	chromosome	606983	604778	2205	99.5	0.0
GCF_040790755.1_ASM4079075v1_genomic	NZ_CP161091.1	606380	607178	798	renamed_GCF_000008685.2	chromosome	607137	607935	798	99.6	4.801e-172
GCF_040790755.1_ASM4079075v1_genomic	NZ_CP161091.1	609149	608303	846	renamed_GCF_000008685.2	chromosome	609906	609060	846	100.0	3.324e-184
GCF_040790755.1_ASM4079075v1_genomic	NZ_CP161091.1	610436	609185	1251	renamed_GCF_000008685.2	chromosome	611193	609942	1251	99.2	1.724e-268
GCF_040790755.1_ASM4079075v1_genomic	NZ_CP161091.1	610551	611265	714	renamed_GCF_000008685.2	chromosome	611308	612022	714	99.5	4.333e-159
GCF_040790755.1_ASM4079075v1_genomic	NZ_CP161091.1	611290	613228	1938	renamed_GCF_000008685.2	chromosome	612047	613985	1938	99.5	0.0
GCF_040790755.1_ASM4079075v1_genomic	NZ_CP161091.1	615014	613256	1758	renamed_GCF_000008685.2	chromosome	615771	614013	1758	99.6	0.0
GCF_040790755.1_ASM4079075v1_genomic	NZ_CP161091.1	630011	631229	1218	renamed_GCF_000008685.2	chromosome	630795	631986	1218	99.4	4.366e-261
GCF_040790755.1_ASM4079075v1_genomic	NZ_CP161091.1	644011	644380	369	renamed_GCF_000008685.2	chromosome	644771	645140	369	100.0	1.529e-79
GCF_040790755.1_ASM4079075v1_genomic	NZ_CP161091.1	644841	644376	465	renamed_GCF_000008685.2	chromosome	645601	645136	465	99.3	2.067e-100
GCF_040790755.1_ASM4079075v1_genomic	NZ_CP161091.1	644958	645921	963	renamed_GCF_000008685.2	chromosome	645718	646681	963	99.6	1.275e-214
GCF_040790755.1_ASM4079075v1_genomic	NZ_CP161091.1	647566	645898	1668	renamed_GCF_000008685.2	chromosome	648254	646658	1668	99.6	0.0
GCF_040790755.1_ASM4079075v1_genomic	NZ_CP161091.1	647792	648347	555	renamed_GCF_000008685.2	chromosome	648552	649107	555	99.4	3.12e-119
GCF_040790755.1_ASM4079075v1_genomic	NZ_CP161091.1	649627	648409	1218	renamed_GCF_000008685.2	chromosome	650387	649169	1218	99.2	6.716e-265
GCF_040790755.1_ASM4079075v1_genomic	NZ_CP161091.1	653030	649652	3378	renamed_GCF_000008685.2	chromosome	653790	650412	3378	99.1	0.0
GCF_040790755.1_ASM4079075v1_genomic	NZ_CP161091.1	653126	654089	963	renamed_GCF_000008685.2	chromosome	653886	654849	963	99.6	2.583e-215
GCF_040790755.1_ASM4079075v1_genomic	NZ_CP161091.1	654048	656142	2094	renamed_GCF_000008685.2	chromosome	654862	656902	2094	98.3	0.0
GCF_040790755.1_ASM4079075v1_genomic	NZ_CP161091.1	685749	685218	531	renamed_GCF_000008685.2	chromosome	686507	685976	531	100.0	1.053e-118
GCF_040790755.1_ASM4079075v1_genomic	NZ_CP161091.1	770789	770387	402	renamed_GCF_000008685.2	chromosome	771563	771161	402	100.0	3.917e-83
GCF_040790755.1_ASM4079075v1_genomic	NZ_CP161091.1	773555	770795	2760	renamed_GCF_000008685.2	chromosome	774368	771569	2760	98.2	0.0
GCF_040790755.1_ASM4079075v1_genomic	NZ_CP161091.1	773863	774649	786	renamed_GCF_000008685.2	chromosome	774676	775462	786	100.0	1.17e-168
GCF_040790755.1_ASM4079075v1_genomic	NZ_CP161091.1	775866	774852	1014	renamed_GCF_000008685.2	chromosome	776679	775665	1014	99.7	8.011e-220
GCF_040790755.1_ASM4079075v1_genomic	NZ_CP161091.1	775971	776760	789	renamed_GCF_000008685.2	chromosome	776784	777573	789	98.4	5.027e-170
GCF_040790755.1_ASM4079075v1_genomic	NZ_CP161091.1	776951	777941	990	renamed_GCF_000008685.2	chromosome	777764	778754	990	99.6	1.559e-225
GCF_040790755.1_ASM4079075v1_genomic	NZ_CP161091.1	777944	780572	2628	renamed_GCF_000008685.2	chromosome	778757	781385	2628	99.6	0.0
GCF_040790755.1_ASM4079075v1_genomic	NZ_CP161091.1	782016	781338	678	renamed_GCF_000008685.2	chromosome	782829	782151	678	98.6	2.577e-150
GCF_040790755.1_ASM4079075v1_genomic	NZ_CP161091.1	819826	820408	582	renamed_GCF_000008685.2	chromosome	820606	821188	582	100.0	9.143e-129
GCF_040790755.1_ASM4079075v1_genomic	NZ_CP161091.1	830783	830174	609	renamed_GCF_000008685.2	chromosome	831563	830954	609	99.5	8.728e-134
GCF_040790755.1_ASM4079075v1_genomic	NZ_CP161091.1	835280	837746	2466	renamed_GCF_000008685.2	chromosome	836060	838526	2466	99.6	0.0
GCF_040790755.1_ASM4079075v1_genomic	NZ_CP161091.1	837766	838300	534	renamed_GCF_000008685.2	chromosome	838546	839080	534	99.4	7.282e-115
GCF_040790755.1_ASM4079075v1_genomic	NZ_CP161091.1	838463	841052	2589	renamed_GCF_000008685.2	chromosome	839243	841832	2589	99.6	0.0
GCF_040790755.1_ASM4079075v1_genomic	NZ_CP161091.1	841053	841671	618	renamed_GCF_000008685.2	chromosome	841833	842451	618	100.0	1.393e-138
GCF_040790755.1_ASM4079075v1_genomic	NZ_CP161091.1	841771	842209	438	renamed_GCF_000008685.2	chromosome	842500	842989	438	99.3	1.307e-92
GCF_040790755.1_ASM4079075v1_genomic	NZ_CP161091.1	842222	843671	1449	renamed_GCF_000008685.2	chromosome	843002	844451	1449	99.7	3.805e-319
GCF_040790755.1_ASM4079075v1_genomic	NZ_CP161091.1	843673	846259	2586	renamed_GCF_000008685.2	chromosome	844453	847102	2586	96.9	0.0
GCF_040790755.1_ASM4079075v1_genomic	NZ_CP161091.1	859268	858095	1173	renamed_GCF_000008685.2	chromosome	860111	858938	1173	99.4	3.135e-257
GCF_040790755.1_ASM4079075v1_genomic	NZ_CP161091.1	885618	883398	2220	renamed_GCF_000008685.2	chromosome	886447	884227	2220	99.5	0.0
GCF_040790755.1_ASM4079075v1_genomic	NZ_CP161091.1	887353	885640	1713	renamed_GCF_000008685.2	chromosome	888179	886469	1713	98.9	0.0
GCF_040790755.1_ASM4079075v1_genomic	NZ_CP161091.1	889495	892348	2853	renamed_GCF_000008685.2	chromosome	890321	893174	2853	99.6	0.0
GCF_040790755.1_ASM4079075v1_genomic	NZ_CP161091.1	892302	895743	3441	renamed_GCF_000008685.2	chromosome	893128	896569	3441	98.3	0.0
GCF_040790755.1_ASM4079075v1_genomic	NZ_CP161091.1	896301	895752	549	renamed_GCF_000008685.2	chromosome	897127	896578	549	100.0	1.159e-120
GCF_040790755.1_ASM4079075v1_genomic	NZ_CP161091.1	896869	896269	600	renamed_GCF_000008685.2	chromosome	897695	897095	600	99.4	6.881e-135
GCF_040790755.1_ASM4079075v1_genomic	NZ_CP161091.1	898494	896877	1617	renamed_GCF_000008685.2	chromosome	899320	897703	1617	98.6	0.0
GCF_040790755.1_ASM4079075v1_genomic	NZ_CP161091.1	898672	899905	1233	renamed_GCF_000008685.2	chromosome	899498	900731	1233	98.5	2.199e-271
GCF_040790755.1_ASM4079075v1_genomic	NZ_CP161102.1	19337	17981	1356	renamed_GCF_000008685.2	cp26	19321	17965	1356	99.7	1.971e-293
GCF_040790755.1_ASM4079075v1_genomic	NZ_CP161096.1	2013	2580	567	renamed_GCF_000008685.2	lp56	35818	36385	567	98.4	1.159e-123
GCF_040790755.1_ASM4079075v1_genomic	NZ_CP161096.1	4953	5409	456	renamed_GCF_000008685.2	cp32-1	4941	5397	456	97.3	2.901e-95
GCF_040790755.1_ASM4079075v1_genomic	NZ_CP161096.1	5408	5792	384	renamed_GCF_000008685.2	cp32-9	5412	5796	384	100.0	2.931e-83
GCF_040790755.1_ASM4079075v1_genomic	NZ_CP161096.1	6164	6731	567	renamed_GCF_000008685.2	cp32-9	6169	6736	567	97.8	5.734e-123
GCF_040790755.1_ASM4079075v1_genomic	NZ_CP161096.1	6711	7824	1113	renamed_GCF_000008685.2	cp32-4	6710	7823	1113	97.8	2.423e-241
GCF_040790755.1_ASM4079075v1_genomic	NZ_CP161097.1	15230	15434	204	renamed_GCF_000008685.2	cp32-1	15214	15418	204	100.0	2.578e-39
GCF_040790755.1_ASM4079075v1_genomic	NZ_CP161097.1	15437	15785	348	renamed_GCF_000008685.2	cp32-8	15421	15769	348	98.2	4.373e-73
GCF_040790755.1_ASM4079075v1_genomic	NZ_CP161097.1	15774	16110	336	renamed_GCF_000008685.2	lp56	19256	19592	336	100.0	5.348e-69
GCF_040790755.1_ASM4079075v1_genomic	NZ_CP161097.1	16102	16456	354	renamed_GCF_000008685.2	cp32-1	16086	16440	354	99.1	1.459e-77
GCF_040790755.1_ASM4079075v1_genomic	NZ_CP161097.1	17076	16593	483	renamed_GCF_000008685.2	cp32-6	17075	16592	483	99.3	2.502e-101
GCF_040790755.1_ASM4079075v1_genomic	NZ_CP161095.1	19085	20183	1098	renamed_GCF_000008685.2	cp32-7	19116	20214	1098	95.8	2.104e-240
GCF_040790755.1_ASM4079075v1_genomic	NZ_CP161099.1	5774	6164	390	renamed_GCF_000008685.2	cp32-9	5783	6173	390	100.0	3.229e-83
GCF_040790755.1_ASM4079075v1_genomic	NZ_CP161099.1	6707	7820	1113	renamed_GCF_000008685.2	lp56	10170	11283	1113	98.3	4.476e-243
GCF_040790755.1_ASM4079075v1_genomic	NZ_CP161099.1	7835	8264	429	renamed_GCF_000008685.2	cp32-4	7837	8266	429	100.0	5.601e-92
GCF_040790755.1_ASM4079075v1_genomic	NZ_CP161099.1	8279	8735	456	renamed_GCF_000008685.2	cp32-6	8281	8737	456	98.0	4.83e-98
GCF_040790755.1_ASM4079075v1_genomic	NZ_CP161099.1	8731	8968	237	renamed_GCF_000008685.2	cp32-6	8733	8970	237	100.0	7.893e-49
GCF_040790755.1_ASM4079075v1_genomic	NZ_CP161099.1	8975	10250	1275	renamed_GCF_000008685.2	cp32-6	8977	10252	1275	99.7	5.924e-276
GCF_040790755.1_ASM4079075v1_genomic	NZ_CP161099.1	10272	10956	684	renamed_GCF_000008685.2	cp32-8	10264	10948	684	99.5	6.92e-149
GCF_040790755.1_ASM4079075v1_genomic	NZ_CP161099.1	25726	24949	777	renamed_GCF_000008685.2	cp32-3	26276	25499	777	99.6	6.988e-173
GCF_040790755.1_ASM4079075v1_genomic	NZ_CP161094.1	11871	12426	555	renamed_GCF_000008685.2	cp32-6	11929	12484	555	90.7	1.979e-107
GCF_040790755.1_ASM4079075v1_genomic	NZ_CP161094.1	14286	15102	816	renamed_GCF_000008685.2	lp56	17822	18638	816	85.6	1.528e-153
GCF_040790755.1_ASM4079075v1_genomic	NZ_CP161094.1	15721	16057	336	renamed_GCF_000008685.2	cp32-8	15758	16094	336	100.0	5.348e-69
GCF_040790755.1_ASM4079075v1_genomic	NZ_CP161094.1	16507	17008	501	renamed_GCF_000008685.2	cp32-4	16496	16997	501	100.0	5.048e-105
GCF_040790755.1_ASM4079075v1_genomic	NZ_CP161094.1	19151	20252	1101	renamed_GCF_000008685.2	cp32-9	19163	20264	1101	98.3	1.267e-246
GCF_040790755.1_ASM4079075v1_genomic	NZ_CP161094.1	20262	20829	567	renamed_GCF_000008685.2	cp32-9	20274	20841	567	98.9	1.602e-128
GCF_040790755.1_ASM4079075v1_genomic	NZ_CP161094.1	20804	21560	756	renamed_GCF_000008685.2	cp32-9	20816	21572	756	99.6	4.781e-165
GCF_040790755.1_ASM4079075v1_genomic	NZ_CP161094.1	21601	22162	561	renamed_GCF_000008685.2	cp32-9	21613	22174	561	100.0	6.308e-121
GCF_040790755.1_ASM4079075v1_genomic	NZ_CP161103.1	14281	13207	1074	renamed_GCF_000008685.2	lp25	14530	13402	1074	99.4	2.22e-244
GCF_040790755.1_ASM4079075v1_genomic	NZ_CP161098.1	5479	6052	573	renamed_GCF_000008685.2	lp28-2	5377	5950	573	98.4	4.31e-127
GCF_040790755.1_ASM4079075v1_genomic	NZ_CP161098.1	6012	6780	768	renamed_GCF_000008685.2	lp28-2	5910	6678	768	98.4	2.852e-164
GCF_040790755.1_ASM4079075v1_genomic	NZ_CP161098.1	6836	7388	552	renamed_GCF_000008685.2	lp28-2	6736	7288	552	98.3	6.616e-119
GCF_040790755.1_ASM4079075v1_genomic	NZ_CP161098.1	11592	11163	429	renamed_GCF_000008685.2	lp28-2	11491	11062	429	98.5	7.495e-89
GCF_040790755.1_ASM4079075v1_genomic	NZ_CP161098.1	12420	11601	819	renamed_GCF_000008685.2	lp28-2	12319	11500	819	98.5	2.879e-181
GCF_040790755.1_ASM4079075v1_genomic	NZ_CP161098.1	12853	12409	444	renamed_GCF_000008685.2	lp28-2	12752	12308	444	100.0	8.866e-98
GCF_040790755.1_ASM4079075v1_genomic	NZ_CP161098.1	13242	12849	393	renamed_GCF_000008685.2	lp28-2	13141	12748	393	100.0	6.841e-84
GCF_040790755.1_ASM4079075v1_genomic	NZ_CP161100.1	1293	1527	234	renamed_GCF_000008685.2	lp17	329	803	234	52.9	7.253e-12
GCF_040790755.1_ASM4079075v1_genomic	NZ_CP161100.1	12504	13611	1107	renamed_GCF_000008685.2	lp28-4	10814	11927	1107	98.6	1.157e-248
GCF_040790755.1_ASM4079075v1_genomic	NZ_CP161100.1	13607	14162	555	renamed_GCF_000008685.2	lp28-4	11923	12478	555	100.0	3.559e-126
GCF_040790755.1_ASM4079075v1_genomic	NZ_CP161100.1	14137	14890	753	renamed_GCF_000008685.2	lp28-4	12453	13206	753	98.8	5.501e-163
GCF_040790755.1_ASM4079075v1_genomic	NZ_CP161100.1	14948	15521	573	renamed_GCF_000008685.2	lp28-4	13264	13837	573	100.0	2.579e-124
GCF_040790755.1_ASM4079075v1_genomic	NZ_CP161100.1	17037	18216	1179	renamed_GCF_000008685.2	lp28-4	15351	16530	1179	99.2	5.451e-252
GCF_040790755.1_ASM4079075v1_genomic	NZ_CP161100.1	20861	20195	666	renamed_GCF_000008685.2	lp28-4	19183	18517	666	99.5	1.537e-145
GCF_040790755.1_ASM4079075v1_genomic	NZ_CP161101.1	13371	12444	927	renamed_GCF_000008685.2	lp36	15760	14833	927	98.7	7.534e-206
GCF_040790755.1_ASM4079075v1_genomic	NZ_CP161093.1	11339	10751	588	renamed_GCF_000008685.2	lp38	11105	10517	588	97.4	2.974e-125
GCF_040790755.1_ASM4079075v1_genomic	NZ_CP161093.1	12123	11385	738	renamed_GCF_000008685.2	lp38	11889	11151	738	98.7	9.658e-163
GCF_040790755.1_ASM4079075v1_genomic	NZ_CP161093.1	12686	12095	591	renamed_GCF_000008685.2	lp38	12452	11861	591	98.9	3.922e-131
GCF_040790755.1_ASM4079075v1_genomic	NZ_CP161093.1	13668	12678	990	renamed_GCF_000008685.2	lp38	13440	12444	990	97.5	1.473e-217
GCF_040790755.1_ASM4079075v1_genomic	NZ_CP161093.1	16746	17556	810	renamed_GCF_000008685.2	lp38	16519	17329	810	99.2	7.354e-178
GCF_040790755.1_ASM4079075v1_genomic	NZ_CP161093.1	17621	18404	783	renamed_GCF_000008685.2	lp38	17387	18170	783	99.6	7.68e-173
GCF_040790755.1_ASM4079075v1_genomic	NZ_CP161093.1	18451	19492	1041	renamed_GCF_000008685.2	lp38	18213	19254	1041	99.7	1.371e-235
GCF_040790755.1_ASM4079075v1_genomic	NZ_CP161093.1	19550	20246	696	renamed_GCF_000008685.2	lp38	19312	20008	696	100.0	6.303e-152
GCF_040790755.1_ASM4079075v1_genomic	NZ_CP161106.1	3363	4356	993	renamed_GCF_000008685.2	lp5	3339	4332	993	99.6	2.038e-214
GCF_040790755.1_ASM4079075v1_genomic	NZ_CP161092.1	8249	8429	180	renamed_GCF_000008685.2	lp54	8265	8445	180	100.0	1.452e-33
GCF_040790755.1_ASM4079075v1_genomic	NZ_CP161092.1	8425	8851	426	renamed_GCF_000008685.2	lp54	8441	8867	426	100.0	3.21e-89
GCF_040790755.1_ASM4079075v1_genomic	NZ_CP161092.1	9440	10262	822	renamed_GCF_000008685.2	lp54	9456	10278	822	99.2	6.989e-172
GCF_040790755.1_ASM4079075v1_genomic	NZ_CP161092.1	10271	11162	891	renamed_GCF_000008685.2	lp54	10287	11178	891	99.3	4.629e-188
GCF_040790755.1_ASM4079075v1_genomic	NZ_CP161092.1	12995	13580	585	renamed_GCF_000008685.2	lp54	12994	13579	585	99.4	8.719e-130
GCF_040790755.1_ASM4079075v1_genomic	NZ_CP161092.1	13555	14308	753	renamed_GCF_000008685.2	lp54	13554	14307	753	100.0	4.561e-165
GCF_040790755.1_ASM4079075v1_genomic	NZ_CP161092.1	14338	14884	546	renamed_GCF_000008685.2	lp54	14337	14883	546	100.0	1.338e-118
GCF_040790755.1_ASM4079075v1_genomic	NZ_CP161092.1	24550	25156	606	renamed_GCF_000008685.2	lp54	24497	25103	606	98.5	3.594e-126
GCF_040790755.1_ASM4079075v1_genomic	NZ_CP161092.1	40144	39904	240	renamed_GCF_000008685.2	lp54	40112	39872	240	100.0	3.722e-49
GCF_040790755.1_ASM4079075v1_genomic	NZ_CP161092.1	41077	40243	834	renamed_GCF_000008685.2	lp54	41045	40211	834	99.6	1.639e-181
GCF_040790755.1_ASM4079075v1_genomic	NZ_CP161092.1	42051	41427	624	renamed_GCF_000008685.2	lp54	42019	41395	624	100.0	3.1e-139
GCF_040790755.1_ASM4079075v1_genomic	NZ_CP161092.1	42298	42505	207	renamed_GCF_000008685.2	lp54	42266	42473	207	100.0	9.856e-42
GCF_040790755.1_ASM4079075v1_genomic	NZ_CP161092.1	43564	42655	909	renamed_GCF_000008685.2	lp54	43532	42623	909	99.6	5.38e-198
GCF_040790755.1_ASM4079075v1_genomic	NZ_CP161092.1	44577	43728	849	renamed_GCF_000008685.2	lp54	44533	43684	849	100.0	7.054e-185
GCF_040790755.1_ASM4079075v1_genomic	NZ_CP161092.1	45992	44756	1236	renamed_GCF_000008685.2	lp54	45947	44711	1236	99.2	3.647e-266
GCF_040790755.1_ASM4079075v1_genomic	NZ_CP161092.1	48401	47645	756	renamed_GCF_000008685.2	lp54	47228	46472	756	99.2	5.251e-164
GCF_040790755.1_ASM4079075v1_genomic	NZ_CP161091.1	103632	102876	756	renamed_GCF_000008685.2	chromosome	103771	103015	756	99.6	2.151e-165
GCF_040790755.1_ASM4079075v1_genomic	NZ_CP161091.1	105292	103624	1668	renamed_GCF_000008685.2	chromosome	105299	103763	1668	100.0	0.0
GCF_040790755.1_ASM4079075v1_genomic	NZ_CP161091.1	106755	105744	1011	renamed_GCF_000008685.2	chromosome	106894	105883	1011	100.0	4.14e-218
GCF_040790755.1_ASM4079075v1_genomic	NZ_CP161091.1	110903	109535	1368	renamed_GCF_000008685.2	chromosome	111042	109674	1368	100.0	1.976e-295
GCF_040790755.1_ASM4079075v1_genomic	NZ_CP161091.1	111736	111445	291	renamed_GCF_000008685.2	chromosome	111875	111584	291	100.0	1.894e-64
GCF_040790755.1_ASM4079075v1_genomic	NZ_CP161091.1	121684	120961	723	renamed_GCF_000008685.2	chromosome	121823	121100	723	99.1	4.138e-161
GCF_040790755.1_ASM4079075v1_genomic	NZ_CP161091.1	124007	122351	1656	renamed_GCF_000008685.2	chromosome	124146	122490	1656	99.2	0.0
GCF_040790755.1_ASM4079075v1_genomic	NZ_CP161091.1	125408	124658	750	renamed_GCF_000008685.2	chromosome	125547	124797	750	100.0	1.281e-161
GCF_040790755.1_ASM4079075v1_genomic	NZ_CP161091.1	127274	126176	1098	renamed_GCF_000008685.2	chromosome	127413	126315	1098	99.1	3.336e-235
GCF_040790755.1_ASM4079075v1_genomic	NZ_CP161091.1	165743	164756	987	renamed_GCF_000008685.2	chromosome	165887	164900	987	99.6	2.948e-209
GCF_040790755.1_ASM4079075v1_genomic	NZ_CP161091.1	169255	167734	1521	renamed_GCF_000008685.2	chromosome	169399	167878	1521	99.4	0.0
GCF_040790755.1_ASM4079075v1_genomic	NZ_CP161091.1	181262	179396	1866	renamed_GCF_000008685.2	chromosome	181405	179539	1866	99.3	0.0
GCF_040790755.1_ASM4079075v1_genomic	NZ_CP161091.1	182742	183237	495	renamed_GCF_000008685.2	chromosome	182885	183380	495	100.0	9.271e-106
GCF_040790755.1_ASM4079075v1_genomic	NZ_CP161091.1	186410	186803	393	renamed_GCF_000008685.2	chromosome	186553	186946	393	100.0	5.626e-86
GCF_040790755.1_ASM4079075v1_genomic	NZ_CP161091.1	187688	187034	654	renamed_GCF_000008685.2	chromosome	187831	187177	654	100.0	1.397e-144
GCF_040790755.1_ASM4079075v1_genomic	NZ_CP161091.1	188351	188090	261	renamed_GCF_000008685.2	chromosome	188494	188233	261	100.0	7.054e-54
GCF_040790755.1_ASM4079075v1_genomic	NZ_CP161091.1	200936	199850	1086	renamed_GCF_000008685.2	chromosome	201050	199964	1086	99.1	1.45e-242
GCF_040790755.1_ASM4079075v1_genomic	NZ_CP161091.1	204021	204957	936	renamed_GCF_000008685.2	chromosome	204136	205072	936	100.0	4.7e-204
GCF_040790755.1_ASM4079075v1_genomic	NZ_CP161091.1	251636	250610	1026	renamed_GCF_000008685.2	chromosome	252237	251211	1026	99.7	2.737e-225
GCF_040790755.1_ASM4079075v1_genomic	NZ_CP161091.1	252557	254330	1773	renamed_GCF_000008685.2	chromosome	253158	254931	1773	99.3	0.0
GCF_040790755.1_ASM4079075v1_genomic	NZ_CP161091.1	255044	255659	615	renamed_GCF_000008685.2	chromosome	255645	256260	615	99.5	1.16e-131
GCF_040790755.1_ASM4079075v1_genomic	NZ_CP161091.1	263385	265506	2121	renamed_GCF_000008685.2	chromosome	263987	266114	2121	99.4	0.0
GCF_040790755.1_ASM4079075v1_genomic	NZ_CP161091.1	266457	266667	210	renamed_GCF_000008685.2	chromosome	267065	267275	210	100.0	4.647e-42
GCF_040790755.1_ASM4079075v1_genomic	NZ_CP161091.1	269865	269064	801	renamed_GCF_000008685.2	chromosome	270473	269672	801	99.6	3.29e-168
GCF_040790755.1_ASM4079075v1_genomic	NZ_CP161091.1	285342	283251	2091	renamed_GCF_000008685.2	chromosome	285962	283868	2091	99.4	0.0
GCF_040790755.1_ASM4079075v1_genomic	NZ_CP161091.1	287260	286471	789	renamed_GCF_000008685.2	chromosome	287877	287088	789	100.0	1.783e-164
GCF_040790755.1_ASM4079075v1_genomic	NZ_CP161091.1	288329	287564	765	renamed_GCF_000008685.2	chromosome	288946	288181	765	100.0	2.478e-165
GCF_040790755.1_ASM4079075v1_genomic	NZ_CP161091.1	324619	323158	1461	renamed_GCF_000008685.2	chromosome	325236	323775	1461	99.7	0.0
GCF_040790755.1_ASM4079075v1_genomic	NZ_CP161091.1	340656	341706	1050	renamed_GCF_000008685.2	chromosome	341273	342323	1050	99.7	7.349e-227
GCF_040790755.1_ASM4079075v1_genomic	NZ_CP161091.1	342590	343562	972	renamed_GCF_000008685.2	chromosome	343207	344179	972	100.0	3.579e-213
GCF_040790755.1_ASM4079075v1_genomic	NZ_CP161091.1	346224	345813	411	renamed_GCF_000008685.2	chromosome	346841	346430	411	100.0	6.821e-87
GCF_040790755.1_ASM4079075v1_genomic	NZ_CP161091.1	347543	346733	810	renamed_GCF_000008685.2	chromosome	348160	347350	810	100.0	1.888e-184
GCF_040790755.1_ASM4079075v1_genomic	NZ_CP161091.1	350428	348982	1446	renamed_GCF_000008685.2	chromosome	351045	349599	1446	98.9	8.839e-318
GCF_040790755.1_ASM4079075v1_genomic	NZ_CP161091.1	364466	363515	951	renamed_GCF_000008685.2	chromosome	364972	364129	951	98.9	1.288e-186
GCF_040790755.1_ASM4079075v1_genomic	NZ_CP161091.1	369412	370399	987	renamed_GCF_000008685.2	chromosome	370026	371013	987	99.3	3.978e-223
GCF_040790755.1_ASM4079075v1_genomic	NZ_CP161091.1	370419	372432	2013	renamed_GCF_000008685.2	chromosome	371033	373046	2013	99.2	0.0
GCF_040790755.1_ASM4079075v1_genomic	NZ_CP161091.1	383672	384812	1140	renamed_GCF_000008685.2	chromosome	384286	385426	1140	100.0	7.242e-251
GCF_040790755.1_ASM4079075v1_genomic	NZ_CP161091.1	459439	459799	360	renamed_GCF_000008685.2	chromosome	460051	460411	360	99.1	5.311e-73
GCF_040790755.1_ASM4079075v1_genomic	NZ_CP161091.1	461432	462161	729	renamed_GCF_000008685.2	chromosome	462044	462773	729	99.1	5.489e-159
GCF_040790755.1_ASM4079075v1_genomic	NZ_CP161091.1	462206	463274	1068	renamed_GCF_000008685.2	chromosome	462818	463886	1068	99.7	4.927e-243
GCF_040790755.1_ASM4079075v1_genomic	NZ_CP161091.1	463440	464520	1080	renamed_GCF_000008685.2	chromosome	464052	465132	1080	99.4	1.001e-245
GCF_040790755.1_ASM4079075v1_genomic	NZ_CP161091.1	466665	464904	1761	renamed_GCF_000008685.2	chromosome	467278	465517	1761	99.4	0.0
GCF_040790755.1_ASM4079075v1_genomic	NZ_CP161091.1	468774	466668	2106	renamed_GCF_000008685.2	chromosome	469387	467281	2106	99.7	0.0
GCF_040790755.1_ASM4079075v1_genomic	NZ_CP161091.1	469052	468776	276	renamed_GCF_000008685.2	chromosome	469665	469389	276	97.8	9.032e-54
GCF_040790755.1_ASM4079075v1_genomic	NZ_CP161091.1	469358	469064	294	renamed_GCF_000008685.2	chromosome	469971	469677	294	100.0	2.2e-63
GCF_040790755.1_ASM4079075v1_genomic	NZ_CP161091.1	481440	480726	714	renamed_GCF_000008685.2	chromosome	482057	481343	714	99.5	8.769e-160
GCF_040790755.1_ASM4079075v1_genomic	NZ_CP161091.1	481982	483665	1683	renamed_GCF_000008685.2	chromosome	482599	484282	1683	99.1	0.0
GCF_040790755.1_ASM4079075v1_genomic	NZ_CP161091.1	483669	483969	300	renamed_GCF_000008685.2	chromosome	484286	484586	300	100.0	5.976e-62
GCF_040790755.1_ASM4079075v1_genomic	NZ_CP161091.1	484139	484649	510	renamed_GCF_000008685.2	chromosome	484756	485266	510	100.0	1.216e-113
GCF_040790755.1_ASM4079075v1_genomic	NZ_CP161091.1	484932	485460	528	renamed_GCF_000008685.2	chromosome	485549	486077	528	100.0	1.004e-118
GCF_040790755.1_ASM4079075v1_genomic	NZ_CP161091.1	485456	486152	696	renamed_GCF_000008685.2	chromosome	486073	486769	696	100.0	2.835e-152
GCF_040790755.1_ASM4079075v1_genomic	NZ_CP161091.1	486099	486921	822	renamed_GCF_000008685.2	chromosome	486746	487538	822	99.6	9.243e-169
GCF_040790755.1_ASM4079075v1_genomic	NZ_CP161091.1	486917	487607	690	renamed_GCF_000008685.2	chromosome	487534	488224	690	99.5	4.749e-154
GCF_040790755.1_ASM4079075v1_genomic	NZ_CP161091.1	487608	488355	747	renamed_GCF_000008685.2	chromosome	488225	488972	747	99.1	9.224e-165
GCF_040790755.1_ASM4079075v1_genomic	NZ_CP161091.1	488365	488878	513	renamed_GCF_000008685.2	chromosome	488982	489495	513	100.0	1.545e-111
GCF_040790755.1_ASM4079075v1_genomic	NZ_CP161091.1	497595	498429	834	renamed_GCF_000008685.2	chromosome	498212	499046	834	100.0	1.895e-188
GCF_040790755.1_ASM4079075v1_genomic	NZ_CP161091.1	498438	498717	279	renamed_GCF_000008685.2	chromosome	499055	499334	279	98.9	3.143e-57
GCF_040790755.1_ASM4079075v1_genomic	NZ_CP161091.1	498723	499086	363	renamed_GCF_000008685.2	chromosome	499340	499703	363	100.0	3.407e-78
GCF_040790755.1_ASM4079075v1_genomic	NZ_CP161091.1	499089	499971	882	renamed_GCF_000008685.2	chromosome	499706	500588	882	98.2	1.81e-188
GCF_040790755.1_ASM4079075v1_genomic	NZ_CP161091.1	499975	500392	417	renamed_GCF_000008685.2	chromosome	500592	501009	417	100.0	2.778e-89
GCF_040790755.1_ASM4079075v1_genomic	NZ_CP161091.1	500394	500595	201	renamed_GCF_000008685.2	chromosome	501014	501212	201	98.4	1.098e-39
GCF_040790755.1_ASM4079075v1_genomic	NZ_CP161091.1	500597	500852	255	renamed_GCF_000008685.2	chromosome	501214	501469	255	100.0	1.745e-51
GCF_040790755.1_ASM4079075v1_genomic	NZ_CP161091.1	500879	501248	369	renamed_GCF_000008685.2	chromosome	501496	501865	369	99.1	4.571e-76
GCF_040790755.1_ASM4079075v1_genomic	NZ_CP161091.1	501262	501568	306	renamed_GCF_000008685.2	chromosome	501879	502185	306	100.0	2.959e-62
GCF_040790755.1_ASM4079075v1_genomic	NZ_CP161091.1	501573	502122	549	renamed_GCF_000008685.2	chromosome	502190	502739	549	100.0	1.698e-116
GCF_040790755.1_ASM4079075v1_genomic	NZ_CP161091.1	506788	507181	393	renamed_GCF_000008685.2	chromosome	507405	507798	393	100.0	3.073e-84
GCF_040790755.1_ASM4079075v1_genomic	NZ_CP161091.1	507196	508231	1035	renamed_GCF_000008685.2	chromosome	507813	508848	1035	99.4	2.25e-220
GCF_040790755.1_ASM4079075v1_genomic	NZ_CP161091.1	508252	508624	372	renamed_GCF_000008685.2	chromosome	508869	509241	372	99.1	4.349e-77
GCF_040790755.1_ASM4079075v1_genomic	NZ_CP161091.1	508696	510229	1533	renamed_GCF_000008685.2	chromosome	509313	510846	1533	100.0	0.0
GCF_040790755.1_ASM4079075v1_genomic	NZ_CP161091.1	510218	511007	789	renamed_GCF_000008685.2	chromosome	510835	511624	789	98.8	1.876e-172
GCF_040790755.1_ASM4079075v1_genomic	NZ_CP161091.1	512522	511775	747	renamed_GCF_000008685.2	chromosome	513139	512392	747	100.0	7.284e-159
GCF_040790755.1_ASM4079075v1_genomic	NZ_CP161091.1	512608	513910	1302	renamed_GCF_000008685.2	chromosome	513225	514527	1302	99.7	7.994e-286
GCF_040790755.1_ASM4079075v1_genomic	NZ_CP161091.1	513906	515166	1260	renamed_GCF_000008685.2	chromosome	514523	515783	1260	99.2	1.335e-281
GCF_040790755.1_ASM4079075v1_genomic	NZ_CP161091.1	534976	534553	423	renamed_GCF_000008685.2	chromosome	535600	535177	423	100.0	5.606e-91
GCF_040790755.1_ASM4079075v1_genomic	NZ_CP161091.1	535079	536903	1824	renamed_GCF_000008685.2	chromosome	535703	537527	1824	99.5	0.0
GCF_040790755.1_ASM4079075v1_genomic	NZ_CP161091.1	536895	537684	789	renamed_GCF_000008685.2	chromosome	537543	538308	789	99.6	2.994e-167
GCF_040790755.1_ASM4079075v1_genomic	NZ_CP161091.1	538651	537703	948	renamed_GCF_000008685.2	chromosome	539275	538327	948	100.0	1.008e-214
GCF_040790755.1_ASM4079075v1_genomic	NZ_CP161091.1	541638	542400	762	renamed_GCF_000008685.2	chromosome	542262	543024	762	99.2	1.347e-171
GCF_040790755.1_ASM4079075v1_genomic	NZ_CP161091.1	542424	543192	768	renamed_GCF_000008685.2	chromosome	543048	543816	768	99.6	4.167e-177
GCF_040790755.1_ASM4079075v1_genomic	NZ_CP161091.1	543207	543981	774	renamed_GCF_000008685.2	chromosome	543831	544605	774	99.6	8.828e-170
GCF_040790755.1_ASM4079075v1_genomic	NZ_CP161091.1	556682	555944	738	renamed_GCF_000008685.2	chromosome	557423	556562	738	84.2	1.47e-149
GCF_040790755.1_ASM4079075v1_genomic	NZ_CP161091.1	557283	556665	618	renamed_GCF_000008685.2	chromosome	558024	557406	618	99.5	1.337e-130
GCF_040790755.1_ASM4079075v1_genomic	NZ_CP161091.1	559991	557264	2727	renamed_GCF_000008685.2	chromosome	560732	558005	2727	99.7	0.0
GCF_040790755.1_ASM4079075v1_genomic	NZ_CP161091.1	560386	559987	399	renamed_GCF_000008685.2	chromosome	561127	560728	399	95.4	5.004e-80
GCF_040790755.1_ASM4079075v1_genomic	NZ_CP161091.1	560795	560375	420	renamed_GCF_000008685.2	chromosome	561554	561116	420	93.0	2.589e-82
GCF_040790755.1_ASM4079075v1_genomic	NZ_CP161091.1	561184	560803	381	renamed_GCF_000008685.2	chromosome	561943	561562	381	99.2	5.027e-77
GCF_040790755.1_ASM4079075v1_genomic	NZ_CP161091.1	561425	563408	1983	renamed_GCF_000008685.2	chromosome	562184	564167	1983	99.6	0.0
GCF_040790755.1_ASM4079075v1_genomic	NZ_CP161091.1	565211	567065	1854	renamed_GCF_000008685.2	chromosome	565954	567823	1854	99.6	0.0
GCF_040790755.1_ASM4079075v1_genomic	NZ_CP161091.1	567051	567519	468	renamed_GCF_000008685.2	chromosome	567809	568277	468	100.0	1.969e-101
GCF_040790755.1_ASM4079075v1_genomic	NZ_CP161091.1	577191	577503	312	renamed_GCF_000008685.2	chromosome	577949	578261	312	100.0	5.387e-65
GCF_040790755.1_ASM4079075v1_genomic	NZ_CP161091.1	577518	579663	2145	renamed_GCF_000008685.2	chromosome	578276	580421	2145	99.1	0.0
GCF_040790755.1_ASM4079075v1_genomic	NZ_CP161091.1	579734	580892	1158	renamed_GCF_000008685.2	chromosome	580485	581643	1158	100.0	7.971e-253
GCF_040790755.1_ASM4079075v1_genomic	NZ_CP161091.1	580893	582666	1773	renamed_GCF_000008685.2	chromosome	581644	583417	1773	99.6	0.0
GCF_040790755.1_ASM4079075v1_genomic	NZ_CP161091.1	582706	583081	375	renamed_GCF_000008685.2	chromosome	583457	583832	375	99.1	1.859e-78
GCF_040790755.1_ASM4079075v1_genomic	NZ_CP161091.1	584129	583439	690	renamed_GCF_000008685.2	chromosome	584880	584190	690	99.1	4.749e-154
GCF_040790755.1_ASM4079075v1_genomic	NZ_CP161091.1	584340	585405	1065	renamed_GCF_000008685.2	chromosome	585079	586156	1065	97.4	4.863e-234
GCF_040790755.1_ASM4079075v1_genomic	NZ_CP161091.1	586279	587131	852	renamed_GCF_000008685.2	chromosome	587030	587882	852	99.2	8.554e-192
GCF_040790755.1_ASM4079075v1_genomic	NZ_CP161091.1	587314	588916	1602	renamed_GCF_000008685.2	chromosome	588065	589667	1602	100.0	0.0
GCF_040790755.1_ASM4079075v1_genomic	NZ_CP161091.1	589457	588932	525	renamed_GCF_000008685.2	chromosome	590208	589683	525	95.4	4.02e-103
GCF_040790755.1_ASM4079075v1_genomic	NZ_CP161091.1	589596	590184	588	renamed_GCF_000008685.2	chromosome	590347	590935	588	98.9	4.522e-129
GCF_040790755.1_ASM4079075v1_genomic	NZ_CP161091.1	590431	591601	1170	renamed_GCF_000008685.2	chromosome	591187	592357	1170	98.9	1.155e-250
GCF_040790755.1_ASM4079075v1_genomic	NZ_CP161091.1	591731	595175	3444	renamed_GCF_000008685.2	chromosome	592445	595931	3444	99.2	0.0
GCF_040790755.1_ASM4079075v1_genomic	NZ_CP161091.1	595186	595765	579	renamed_GCF_000008685.2	chromosome	595942	596521	579	99.4	1.865e-120
GCF_040790755.1_ASM4079075v1_genomic	NZ_CP161091.1	595774	597835	2061	renamed_GCF_000008685.2	chromosome	596530	598591	2061	100.0	0.0
GCF_040790755.1_ASM4079075v1_genomic	NZ_CP161091.1	598620	597831	789	renamed_GCF_000008685.2	chromosome	599376	598587	789	99.6	2.378e-178
GCF_040790755.1_ASM4079075v1_genomic	NZ_CP161091.1	598738	600088	1350	renamed_GCF_000008685.2	chromosome	599494	600844	1350	100.0	3.989e-293
GCF_040790755.1_ASM4079075v1_genomic	NZ_CP161091.1	600253	601588	1335	renamed_GCF_000008685.2	chromosome	601009	602344	1335	100.0	3.161e-293
GCF_040790755.1_ASM4079075v1_genomic	NZ_CP161091.1	601617	602973	1356	renamed_GCF_000008685.2	chromosome	602373	603729	1356	99.3	5.612e-299
GCF_040790755.1_ASM4079075v1_genomic	NZ_CP161091.1	631233	631725	492	renamed_GCF_000008685.2	chromosome	631990	632482	492	100.0	1.786e-106
GCF_040790755.1_ASM4079075v1_genomic	NZ_CP161091.1	631727	633707	1980	renamed_GCF_000008685.2	chromosome	632484	634464	1980	98.9	0.0
GCF_040790755.1_ASM4079075v1_genomic	NZ_CP161091.1	633823	635254	1431	renamed_GCF_000008685.2	chromosome	634580	636011	1431	97.2	1.213e-311
GCF_040790755.1_ASM4079075v1_genomic	NZ_CP161091.1	635832	637197	1365	renamed_GCF_000008685.2	chromosome	636592	637957	1365	98.8	4.19e-295
GCF_040790755.1_ASM4079075v1_genomic	NZ_CP161091.1	637202	637796	594	renamed_GCF_000008685.2	chromosome	637971	638556	594	100.0	1.47e-125
GCF_040790755.1_ASM4079075v1_genomic	NZ_CP161091.1	637819	639112	1293	renamed_GCF_000008685.2	chromosome	638579	639872	1293	99.7	6.951e-286
GCF_040790755.1_ASM4079075v1_genomic	NZ_CP161091.1	639080	641489	2409	renamed_GCF_000008685.2	chromosome	639858	642249	2409	99.3	0.0
GCF_040790755.1_ASM4079075v1_genomic	NZ_CP161091.1	641528	641681	153	renamed_GCF_000008685.2	chromosome	642288	642441	153	100.0	5.64e-31
GCF_040790755.1_ASM4079075v1_genomic	NZ_CP161091.1	642366	641739	627	renamed_GCF_000008685.2	chromosome	643126	642499	627	100.0	8.735e-137
GCF_040790755.1_ASM4079075v1_genomic	NZ_CP161091.1	643890	642534	1356	renamed_GCF_000008685.2	chromosome	644650	643294	1356	99.5	1.919e-302
GCF_040790755.1_ASM4079075v1_genomic	NZ_CP161091.1	658137	658863	726	renamed_GCF_000008685.2	chromosome	658897	659623	726	99.1	3.767e-154
GCF_040790755.1_ASM4079075v1_genomic	NZ_CP161091.1	660755	658883	1872	renamed_GCF_000008685.2	chromosome	661515	659643	1872	99.1	0.0
GCF_040790755.1_ASM4079075v1_genomic	NZ_CP161091.1	660845	661769	924	renamed_GCF_000008685.2	chromosome	661605	662529	924	98.6	2.789e-199
GCF_040790755.1_ASM4079075v1_genomic	NZ_CP161091.1	662157	661842	315	renamed_GCF_000008685.2	chromosome	662917	662602	315	99.0	2.806e-64
GCF_040790755.1_ASM4079075v1_genomic	NZ_CP161091.1	664250	662417	1833	renamed_GCF_000008685.2	chromosome	665011	663178	1833	99.8	0.0
GCF_040790755.1_ASM4079075v1_genomic	NZ_CP161091.1	667756	664246	3510	renamed_GCF_000008685.2	chromosome	668517	665007	3510	99.4	0.0
GCF_040790755.1_ASM4079075v1_genomic	NZ_CP161091.1	672450	671004	1446	renamed_GCF_000008685.2	chromosome	673167	671766	1446	98.9	4.896e-307
GCF_040790755.1_ASM4079075v1_genomic	NZ_CP161091.1	672579	674016	1437	renamed_GCF_000008685.2	chromosome	673341	674778	1437	99.5	0.0
GCF_040790755.1_ASM4079075v1_genomic	NZ_CP161091.1	674272	675616	1344	renamed_GCF_000008685.2	chromosome	675034	676378	1344	99.3	3.983e-292
GCF_040790755.1_ASM4079075v1_genomic	NZ_CP161091.1	687731	689369	1638	renamed_GCF_000008685.2	chromosome	688489	690127	1638	100.0	0.0
GCF_040790755.1_ASM4079075v1_genomic	NZ_CP161091.1	689434	689731	297	renamed_GCF_000008685.2	chromosome	690192	690489	297	100.0	1.037e-63
GCF_040790755.1_ASM4079075v1_genomic	NZ_CP161091.1	689744	690041	297	renamed_GCF_000008685.2	chromosome	690481	690799	297	98.9	6.955e-60
GCF_040790755.1_ASM4079075v1_genomic	NZ_CP161091.1	690125	691886	1761	renamed_GCF_000008685.2	chromosome	690884	692645	1761	99.3	0.0
GCF_040790755.1_ASM4079075v1_genomic	NZ_CP161091.1	691869	692769	900	renamed_GCF_000008685.2	chromosome	692628	693528	900	99.6	4.423e-190
GCF_040790755.1_ASM4079075v1_genomic	NZ_CP161091.1	692794	693937	1143	renamed_GCF_000008685.2	chromosome	693553	694696	1143	99.4	9.695e-257
GCF_040790755.1_ASM4079075v1_genomic	NZ_CP161091.1	694764	693933	831	renamed_GCF_000008685.2	chromosome	695523	694692	831	99.6	1.298e-183
GCF_040790755.1_ASM4079075v1_genomic	NZ_CP161091.1	694862	695996	1134	renamed_GCF_000008685.2	chromosome	695630	696764	1134	98.4	9.239e-256
GCF_040790755.1_ASM4079075v1_genomic	NZ_CP161091.1	696669	695982	687	renamed_GCF_000008685.2	chromosome	697437	696750	687	99.5	1.468e-149
GCF_040790755.1_ASM4079075v1_genomic	NZ_CP161091.1	696817	697564	747	renamed_GCF_000008685.2	chromosome	697585	698332	747	99.1	7.646e-167
GCF_040790755.1_ASM4079075v1_genomic	NZ_CP161091.1	699196	697630	1566	renamed_GCF_000008685.2	chromosome	699965	698399	1566	99.4	0.0
GCF_040790755.1_ASM4079075v1_genomic	NZ_CP161091.1	700155	699282	873	renamed_GCF_000008685.2	chromosome	700924	700051	873	99.3	1.433e-189
GCF_040790755.1_ASM4079075v1_genomic	NZ_CP161091.1	700259	700616	357	renamed_GCF_000008685.2	chromosome	701028	701385	357	100.0	2.301e-81
GCF_040790755.1_ASM4079075v1_genomic	NZ_CP161091.1	700625	701036	411	renamed_GCF_000008685.2	chromosome	701394	701805	411	99.2	1.377e-87
GCF_040790755.1_ASM4079075v1_genomic	NZ_CP161091.1	701055	701505	450	renamed_GCF_000008685.2	chromosome	701824	702274	450	97.9	2.393e-96
GCF_040790755.1_ASM4079075v1_genomic	NZ_CP161091.1	702197	701513	684	renamed_GCF_000008685.2	chromosome	702951	702282	684	99.5	1.009e-144
GCF_040790755.1_ASM4079075v1_genomic	NZ_CP161091.1	702239	703199	960	renamed_GCF_000008685.2	chromosome	703008	703968	960	99.6	6.008e-214
GCF_040790755.1_ASM4079075v1_genomic	NZ_CP161091.1	703161	704190	1029	renamed_GCF_000008685.2	chromosome	703960	704959	1029	99.0	1.869e-221
GCF_040790755.1_ASM4079075v1_genomic	NZ_CP161091.1	704179	704731	552	renamed_GCF_000008685.2	chromosome	704948	705500	552	96.1	1.619e-117
GCF_040790755.1_ASM4079075v1_genomic	NZ_CP161091.1	704808	705834	1026	renamed_GCF_000008685.2	chromosome	705579	706605	1026	100.0	2.737e-225
GCF_040790755.1_ASM4079075v1_genomic	NZ_CP161091.1	705901	708496	2595	renamed_GCF_000008685.2	chromosome	706672	709267	2595	99.6	0.0
GCF_040790755.1_ASM4079075v1_genomic	NZ_CP161091.1	708502	709903	1401	renamed_GCF_000008685.2	chromosome	709273	710674	1401	99.3	1.003e-308
GCF_040790755.1_ASM4079075v1_genomic	NZ_CP161091.1	709914	710400	486	renamed_GCF_000008685.2	chromosome	710685	711171	486	100.0	5.304e-102
GCF_040790755.1_ASM4079075v1_genomic	NZ_CP161091.1	710439	710880	441	renamed_GCF_000008685.2	chromosome	711210	711651	441	100.0	1.245e-93
GCF_040790755.1_ASM4079075v1_genomic	NZ_CP161091.1	711436	710920	516	renamed_GCF_000008685.2	chromosome	712207	711691	516	100.0	1.621e-111
GCF_040790755.1_ASM4079075v1_genomic	NZ_CP161091.1	712479	711432	1047	renamed_GCF_000008685.2	chromosome	713250	712203	1047	100.0	1.709e-225
GCF_040790755.1_ASM4079075v1_genomic	NZ_CP161091.1	713336	712472	864	renamed_GCF_000008685.2	chromosome	714107	713243	864	99.6	5.599e-190
GCF_040790755.1_ASM4079075v1_genomic	NZ_CP161091.1	713995	713332	663	renamed_GCF_000008685.2	chromosome	714766	714103	663	99.0	3.258e-145
GCF_040790755.1_ASM4079075v1_genomic	NZ_CP161091.1	714237	715848	1611	renamed_GCF_000008685.2	chromosome	715008	716619	1611	99.8	0.0
GCF_040790755.1_ASM4079075v1_genomic	NZ_CP161091.1	715848	717000	1152	renamed_GCF_000008685.2	chromosome	716619	717771	1152	99.4	6.226e-246
GCF_040790755.1_ASM4079075v1_genomic	NZ_CP161091.1	716971	717898	927	renamed_GCF_000008685.2	chromosome	717742	718669	927	99.0	9.413e-195
GCF_040790755.1_ASM4079075v1_genomic	NZ_CP161091.1	718052	720314	2262	renamed_GCF_000008685.2	chromosome	718826	721088	2262	99.8	0.0
GCF_040790755.1_ASM4079075v1_genomic	NZ_CP161091.1	720344	722246	1902	renamed_GCF_000008685.2	chromosome	721118	723020	1902	99.8	0.0
GCF_040790755.1_ASM4079075v1_genomic	NZ_CP161091.1	723356	722288	1068	renamed_GCF_000008685.2	chromosome	724130	723062	1068	98.8	4.094e-245
GCF_040790755.1_ASM4079075v1_genomic	NZ_CP161091.1	723449	724673	1224	renamed_GCF_000008685.2	chromosome	724223	725447	1224	99.5	3.533e-273
GCF_040790755.1_ASM4079075v1_genomic	NZ_CP161091.1	724656	725721	1065	renamed_GCF_000008685.2	chromosome	725430	726495	1065	95.4	1.714e-228
GCF_040790755.1_ASM4079075v1_genomic	NZ_CP161091.1	725710	726979	1269	renamed_GCF_000008685.2	chromosome	726457	727753	1269	98.3	2.43e-276
GCF_040790755.1_ASM4079075v1_genomic	NZ_CP161091.1	726962	727901	939	renamed_GCF_000008685.2	chromosome	727736	728675	939	99.0	1.841e-206
GCF_040790755.1_ASM4079075v1_genomic	NZ_CP161091.1	727891	728845	954	renamed_GCF_000008685.2	chromosome	728665	729619	954	99.0	3.252e-211
GCF_040790755.1_ASM4079075v1_genomic	NZ_CP161091.1	728838	729732	894	renamed_GCF_000008685.2	chromosome	729612	730506	894	98.6	6.773e-193
GCF_040790755.1_ASM4079075v1_genomic	NZ_CP161091.1	730325	729857	468	renamed_GCF_000008685.2	chromosome	731099	730631	468	98.0	1.073e-99
GCF_040790755.1_ASM4079075v1_genomic	NZ_CP161091.1	730409	730946	537	renamed_GCF_000008685.2	chromosome	731183	731720	537	100.0	1.936e-121
GCF_040790755.1_ASM4079075v1_genomic	NZ_CP161091.1	731019	733029	2010	renamed_GCF_000008685.2	chromosome	731793	733803	2010	98.9	0.0
GCF_040790755.1_ASM4079075v1_genomic	NZ_CP161091.1	733306	734515	1209	renamed_GCF_000008685.2	chromosome	734080	735289	1209	100.0	8.188e-270
GCF_040790755.1_ASM4079075v1_genomic	NZ_CP161091.1	734577	735912	1335	renamed_GCF_000008685.2	chromosome	735351	736686	1335	99.7	2.962e-285
GCF_040790755.1_ASM4079075v1_genomic	NZ_CP161091.1	735924	736185	261	renamed_GCF_000008685.2	chromosome	736698	736959	261	100.0	3.165e-54
GCF_040790755.1_ASM4079075v1_genomic	NZ_CP161091.1	736185	736434	249	renamed_GCF_000008685.2	chromosome	736959	737208	249	100.0	2.148e-48
GCF_040790755.1_ASM4079075v1_genomic	NZ_CP161091.1	736437	736938	501	renamed_GCF_000008685.2	chromosome	737211	737712	501	100.0	9.268e-107
GCF_040790755.1_ASM4079075v1_genomic	NZ_CP161091.1	736934	737654	720	renamed_GCF_000008685.2	chromosome	737708	738428	720	99.1	2.354e-158
GCF_040790755.1_ASM4079075v1_genomic	NZ_CP161091.1	737631	737997	366	renamed_GCF_000008685.2	chromosome	738405	738771	366	100.0	9.695e-76
GCF_040790755.1_ASM4079075v1_genomic	NZ_CP161091.1	738369	738909	540	renamed_GCF_000008685.2	chromosome	739143	739683	540	100.0	2.458e-119
GCF_040790755.1_ASM4079075v1_genomic	NZ_CP161091.1	738910	739402	492	renamed_GCF_000008685.2	chromosome	739684	740176	492	100.0	4.374e-105
GCF_040790755.1_ASM4079075v1_genomic	NZ_CP161091.1	739465	739648	183	renamed_GCF_000008685.2	chromosome	740239	740422	183	100.0	1.805e-39
GCF_040790755.1_ASM4079075v1_genomic	NZ_CP161091.1	739671	739914	243	renamed_GCF_000008685.2	chromosome	740445	740688	243	100.0	1.755e-49
GCF_040790755.1_ASM4079075v1_genomic	NZ_CP161091.1	739913	740651	738	renamed_GCF_000008685.2	chromosome	740687	741425	738	100.0	4.772e-162
GCF_040790755.1_ASM4079075v1_genomic	NZ_CP161091.1	741854	740621	1233	renamed_GCF_000008685.2	chromosome	742628	741395	1233	99.2	9.028e-273
GCF_040790755.1_ASM4079075v1_genomic	NZ_CP161091.1	741969	743742	1773	renamed_GCF_000008685.2	chromosome	742743	744516	1773	99.3	0.0
GCF_040790755.1_ASM4079075v1_genomic	NZ_CP161091.1	743747	744071	324	renamed_GCF_000008685.2	chromosome	744521	744845	324	100.0	1.32e-65
GCF_040790755.1_ASM4079075v1_genomic	NZ_CP161091.1	744527	745559	1032	renamed_GCF_000008685.2	chromosome	745301	746333	1032	98.8	6.679e-225
GCF_040790755.1_ASM4079075v1_genomic	NZ_CP161091.1	747349	749245	1896	renamed_GCF_000008685.2	chromosome	748122	750018	1896	99.6	0.0
GCF_040790755.1_ASM4079075v1_genomic	NZ_CP161091.1	749257	750016	759	renamed_GCF_000008685.2	chromosome	750030	750789	759	100.0	2.255e-165
GCF_040790755.1_ASM4079075v1_genomic	NZ_CP161091.1	750417	751386	969	renamed_GCF_000008685.2	chromosome	751190	752159	969	100.0	4.772e-218
GCF_040790755.1_ASM4079075v1_genomic	NZ_CP161091.1	751396	752446	1050	renamed_GCF_000008685.2	chromosome	752169	753219	1050	100.0	6.109e-229
GCF_040790755.1_ASM4079075v1_genomic	NZ_CP161091.1	752449	753295	846	renamed_GCF_000008685.2	chromosome	753291	754068	846	99.6	1.473e-167
GCF_040790755.1_ASM4079075v1_genomic	NZ_CP161091.1	753294	753777	483	renamed_GCF_000008685.2	chromosome	754067	754550	483	100.0	1.405e-107
GCF_040790755.1_ASM4079075v1_genomic	NZ_CP161091.1	753776	755576	1800	renamed_GCF_000008685.2	chromosome	754636	756349	1800	99.8	0.0
GCF_040790755.1_ASM4079075v1_genomic	NZ_CP161091.1	755580	756897	1317	renamed_GCF_000008685.2	chromosome	756353	757670	1317	99.7	1.293e-291
GCF_040790755.1_ASM4079075v1_genomic	NZ_CP161091.1	758812	759442	630	renamed_GCF_000008685.2	chromosome	759585	760215	630	99.0	4.119e-137
GCF_040790755.1_ASM4079075v1_genomic	NZ_CP161091.1	759428	760874	1446	renamed_GCF_000008685.2	chromosome	760225	761647	1446	99.1	2.357e-315
GCF_040790755.1_ASM4079075v1_genomic	NZ_CP161091.1	762805	763588	783	renamed_GCF_000008685.2	chromosome	763578	764361	783	100.0	1.874e-171
GCF_040790755.1_ASM4079075v1_genomic	NZ_CP161091.1	763597	764569	972	renamed_GCF_000008685.2	chromosome	764370	765342	972	100.0	2.973e-215
GCF_040790755.1_ASM4079075v1_genomic	NZ_CP161091.1	764599	765943	1344	renamed_GCF_000008685.2	chromosome	765372	766716	1344	100.0	2.685e-305
GCF_040790755.1_ASM4079075v1_genomic	NZ_CP161091.1	767294	765959	1335	renamed_GCF_000008685.2	chromosome	768064	766732	1335	98.1	4.561e-289
GCF_040790755.1_ASM4079075v1_genomic	NZ_CP161091.1	768697	767305	1392	renamed_GCF_000008685.2	chromosome	769470	768078	1392	99.7	4.128e-291
GCF_040790755.1_ASM4079075v1_genomic	NZ_CP161091.1	770365	768772	1593	renamed_GCF_000008685.2	chromosome	771139	769546	1593	99.6	0.0
GCF_040790755.1_ASM4079075v1_genomic	NZ_CP161091.1	782576	784208	1632	renamed_GCF_000008685.2	chromosome	783389	785021	1632	99.6	0.0
GCF_040790755.1_ASM4079075v1_genomic	NZ_CP161091.1	784243	785941	1698	renamed_GCF_000008685.2	chromosome	785056	786754	1698	99.1	0.0
GCF_040790755.1_ASM4079075v1_genomic	NZ_CP161091.1	786046	788149	2103	renamed_GCF_000008685.2	chromosome	786859	788962	2103	99.2	0.0
GCF_040790755.1_ASM4079075v1_genomic	NZ_CP161091.1	788507	789125	618	renamed_GCF_000008685.2	chromosome	789302	789938	618	99.0	8.327e-136
GCF_040790755.1_ASM4079075v1_genomic	NZ_CP161091.1	789994	789133	861	renamed_GCF_000008685.2	chromosome	790807	789946	861	99.6	3.489e-186
GCF_040790755.1_ASM4079075v1_genomic	NZ_CP161091.1	790974	789993	981	renamed_GCF_000008685.2	chromosome	791787	790806	981	99.6	2.843e-217
GCF_040790755.1_ASM4079075v1_genomic	NZ_CP161091.1	791439	790980	459	renamed_GCF_000008685.2	chromosome	792252	791793	459	99.3	2.509e-97
GCF_040790755.1_ASM4079075v1_genomic	NZ_CP161091.1	791537	792812	1275	renamed_GCF_000008685.2	chromosome	792350	793625	1275	98.1	9.993e-279
GCF_040790755.1_ASM4079075v1_genomic	NZ_CP161091.1	794041	793027	1014	renamed_GCF_000008685.2	chromosome	794855	793841	1014	98.2	1.121e-224
GCF_040790755.1_ASM4079075v1_genomic	NZ_CP161091.1	806110	804961	1149	renamed_GCF_000008685.2	chromosome	806923	805774	1149	99.4	2.675e-246
GCF_040790755.1_ASM4079075v1_genomic	NZ_CP161091.1	807153	806106	1047	renamed_GCF_000008685.2	chromosome	807966	806919	1047	99.4	5.83e-229
GCF_040790755.1_ASM4079075v1_genomic	NZ_CP161091.1	807651	807162	489	renamed_GCF_000008685.2	chromosome	808464	807975	489	100.0	6.125e-101
GCF_040790755.1_ASM4079075v1_genomic	NZ_CP161091.1	808739	807647	1092	renamed_GCF_000008685.2	chromosome	809552	808460	1092	99.7	1.747e-241
GCF_040790755.1_ASM4079075v1_genomic	NZ_CP161091.1	809682	808887	795	renamed_GCF_000008685.2	chromosome	810495	809700	795	100.0	1.877e-173
GCF_040790755.1_ASM4079075v1_genomic	NZ_CP161091.1	810697	809656	1041	renamed_GCF_000008685.2	chromosome	811510	810469	1041	99.7	1.371e-235
GCF_040790755.1_ASM4079075v1_genomic	NZ_CP161091.1	811575	810693	882	renamed_GCF_000008685.2	chromosome	812388	811506	882	97.6	8.145e-189
GCF_040790755.1_ASM4079075v1_genomic	NZ_CP161091.1	812426	811625	801	renamed_GCF_000008685.2	chromosome	813239	812438	801	100.0	9.279e-174
GCF_040790755.1_ASM4079075v1_genomic	NZ_CP161091.1	812921	812576	345	renamed_GCF_000008685.2	chromosome	813706	813385	345	92.0	6.146e-61
GCF_040790755.1_ASM4079075v1_genomic	NZ_CP161091.1	813912	812904	1008	renamed_GCF_000008685.2	chromosome	814697	813689	1008	99.7	2.574e-214
GCF_040790755.1_ASM4079075v1_genomic	NZ_CP161091.1	820404	821589	1185	renamed_GCF_000008685.2	chromosome	821184	822369	1185	99.7	1.29e-260
GCF_040790755.1_ASM4079075v1_genomic	NZ_CP161091.1	821563	821914	351	renamed_GCF_000008685.2	chromosome	822343	822694	351	99.1	1.534e-76
GCF_040790755.1_ASM4079075v1_genomic	NZ_CP161091.1	822029	822323	294	renamed_GCF_000008685.2	chromosome	822809	823103	294	100.0	1.207e-61
GCF_040790755.1_ASM4079075v1_genomic	NZ_CP161091.1	822482	823031	549	renamed_GCF_000008685.2	chromosome	823262	823811	549	97.8	9.24e-115
GCF_040790755.1_ASM4079075v1_genomic	NZ_CP161091.1	823035	823602	567	renamed_GCF_000008685.2	chromosome	823815	824382	567	99.4	6.307e-122
GCF_040790755.1_ASM4079075v1_genomic	NZ_CP161091.1	823601	824924	1323	renamed_GCF_000008685.2	chromosome	824381	825704	1323	99.7	4.425e-296
GCF_040790755.1_ASM4079075v1_genomic	NZ_CP161091.1	824920	826840	1920	renamed_GCF_000008685.2	chromosome	825700	827620	1920	99.6	0.0
GCF_040790755.1_ASM4079075v1_genomic	NZ_CP161091.1	826850	828332	1482	renamed_GCF_000008685.2	chromosome	827630	829112	1482	99.3	0.0
GCF_040790755.1_ASM4079075v1_genomic	NZ_CP161091.1	828437	829541	1104	renamed_GCF_000008685.2	chromosome	829217	830321	1104	99.7	4.967e-249
GCF_040790755.1_ASM4079075v1_genomic	NZ_CP161091.1	830161	829537	624	renamed_GCF_000008685.2	chromosome	830941	830317	624	99.5	5.702e-141
GCF_040790755.1_ASM4079075v1_genomic	NZ_CP161091.1	859596	860931	1335	renamed_GCF_000008685.2	chromosome	860439	861774	1335	99.5	4.161e-290
GCF_040790755.1_ASM4079075v1_genomic	NZ_CP161091.1	861856	862804	948	renamed_GCF_000008685.2	chromosome	862698	863646	948	100.0	4.292e-207
GCF_040790755.1_ASM4079075v1_genomic	NZ_CP161091.1	862793	864200	1407	renamed_GCF_000008685.2	chromosome	863635	865042	1407	99.5	3.133e-314
GCF_040790755.1_ASM4079075v1_genomic	NZ_CP161091.1	864219	865077	858	renamed_GCF_000008685.2	chromosome	865052	865919	858	99.2	7.399e-186
GCF_040790755.1_ASM4079075v1_genomic	NZ_CP161091.1	865073	865616	543	renamed_GCF_000008685.2	chromosome	865915	866458	543	99.4	5.734e-119
GCF_040790755.1_ASM4079075v1_genomic	NZ_CP161091.1	865651	865852	201	renamed_GCF_000008685.2	chromosome	866493	866694	201	100.0	2.206e-40
GCF_040790755.1_ASM4079075v1_genomic	NZ_CP161091.1	865838	866759	921	renamed_GCF_000008685.2	chromosome	866680	867601	921	99.6	6.858e-206
GCF_040790755.1_ASM4079075v1_genomic	NZ_CP161091.1	867272	866900	372	renamed_GCF_000008685.2	chromosome	868114	867742	372	100.0	7.954e-79
GCF_040790755.1_ASM4079075v1_genomic	NZ_CP161091.1	867352	867898	546	renamed_GCF_000008685.2	chromosome	868194	868740	546	99.4	4.105e-123
GCF_040790755.1_ASM4079075v1_genomic	NZ_CP161091.1	868673	867890	783	renamed_GCF_000008685.2	chromosome	869380	868732	783	99.5	1.931e-145
GCF_040790755.1_ASM4079075v1_genomic	NZ_CP161102.1	45	324	279	renamed_GCF_000008685.2	cp26	45	324	279	97.8	2.569e-59
GCF_040790755.1_ASM4079075v1_genomic	NZ_CP161102.1	751	307	444	renamed_GCF_000008685.2	cp26	751	307	444	99.3	7.305e-100
GCF_040790755.1_ASM4079075v1_genomic	NZ_CP161102.1	2186	836	1350	renamed_GCF_000008685.2	cp26	2186	836	1350	100.0	7.868e-303
GCF_040790755.1_ASM4079075v1_genomic	NZ_CP161102.1	3796	2473	1323	renamed_GCF_000008685.2	cp26	3798	2475	1323	99.0	3.455e-290
GCF_040790755.1_ASM4079075v1_genomic	NZ_CP161102.1	4081	4429	348	renamed_GCF_000008685.2	cp26	4083	4431	348	100.0	1.075e-71
GCF_040790755.1_ASM4079075v1_genomic	NZ_CP161102.1	4437	4755	318	renamed_GCF_000008685.2	cp26	4481	4757	318	100.0	7.253e-55
GCF_040790755.1_ASM4079075v1_genomic	NZ_CP161102.1	4766	5864	1098	renamed_GCF_000008685.2	cp26	4768	5866	1098	99.4	1.102e-247
GCF_040790755.1_ASM4079075v1_genomic	NZ_CP161102.1	6687	7725	1038	renamed_GCF_000008685.2	cp26	6676	7714	1038	99.4	4.211e-231
GCF_040790755.1_ASM4079075v1_genomic	NZ_CP161102.1	20802	19446	1356	renamed_GCF_000008685.2	cp26	20786	19430	1356	99.7	1.971e-293
GCF_040790755.1_ASM4079075v1_genomic	NZ_CP161096.1	8733	8970	237	renamed_GCF_000008685.2	cp32-9	8741	8978	237	100.0	1.76e-48
GCF_040790755.1_ASM4079075v1_genomic	NZ_CP161096.1	8977	10252	1275	renamed_GCF_000008685.2	cp32-3	8967	10242	1275	97.6	2.281e-269
GCF_040790755.1_ASM4079075v1_genomic	NZ_CP161096.1	11967	12513	546	renamed_GCF_000008685.2	cp32-8	11919	12465	546	97.2	2.156e-113
GCF_040790755.1_ASM4079075v1_genomic	NZ_CP161096.1	15270	15474	204	renamed_GCF_000008685.2	cp32-7	15221	15425	204	100.0	2.578e-39
GCF_040790755.1_ASM4079075v1_genomic	NZ_CP161097.1	7835	8264	429	renamed_GCF_000008685.2	cp32-6	7837	8266	429	100.0	5.601e-92
GCF_040790755.1_ASM4079075v1_genomic	NZ_CP161097.1	8279	8735	456	renamed_GCF_000008685.2	cp32-7	8273	8729	456	100.0	8.859e-100
GCF_040790755.1_ASM4079075v1_genomic	NZ_CP161097.1	8731	8968	237	renamed_GCF_000008685.2	cp32-7	8725	8962	237	100.0	7.893e-49
GCF_040790755.1_ASM4079075v1_genomic	NZ_CP161097.1	8975	10313	1338	renamed_GCF_000008685.2	cp32-7	8969	10304	1338	97.3	9.934e-281
GCF_040790755.1_ASM4079075v1_genomic	NZ_CP161097.1	10325	10967	642	renamed_GCF_000008685.2	cp32-7	10316	10958	642	100.0	3.749e-140
GCF_040790755.1_ASM4079075v1_genomic	NZ_CP161097.1	10973	11912	939	renamed_GCF_000008685.2	cp32-7	10961	11903	939	99.6	2.571e-211
GCF_040790755.1_ASM4079075v1_genomic	NZ_CP161097.1	11936	12482	546	renamed_GCF_000008685.2	cp32-7	11927	12473	546	99.4	1.781e-115
GCF_040790755.1_ASM4079075v1_genomic	NZ_CP161097.1	12841	13717	876	renamed_GCF_000008685.2	cp32-3	12823	13699	876	100.0	5.609e-192
GCF_040790755.1_ASM4079075v1_genomic	NZ_CP161097.1	20398	20965	567	renamed_GCF_000008685.2	lp56	23975	24542	567	100.0	1.456e-129
GCF_040790755.1_ASM4079075v1_genomic	NZ_CP161095.1	6707	7820	1113	renamed_GCF_000008685.2	cp32-6	6710	7823	1113	98.3	4.909e-242
GCF_040790755.1_ASM4079075v1_genomic	NZ_CP161095.1	7835	8264	429	renamed_GCF_000008685.2	lp56	11296	11725	429	100.0	5.601e-92
GCF_040790755.1_ASM4079075v1_genomic	NZ_CP161095.1	8279	8735	456	renamed_GCF_000008685.2	cp32-4	8281	8737	456	99.3	2.171e-98
GCF_040790755.1_ASM4079075v1_genomic	NZ_CP161095.1	8731	8968	237	renamed_GCF_000008685.2	cp32-4	8733	8970	237	100.0	1.76e-48
GCF_040790755.1_ASM4079075v1_genomic	NZ_CP161095.1	11916	12462	546	renamed_GCF_000008685.2	cp32-3	11919	12465	546	97.7	2.156e-113
GCF_040790755.1_ASM4079075v1_genomic	NZ_CP161095.1	12491	12824	333	renamed_GCF_000008685.2	cp32-8	12494	12827	333	99.0	2.071e-70
GCF_040790755.1_ASM4079075v1_genomic	NZ_CP161095.1	20192	20759	567	renamed_GCF_000008685.2	cp32-7	20223	20790	567	99.4	1.456e-129
GCF_040790755.1_ASM4079075v1_genomic	NZ_CP161099.1	13715	14321	606	renamed_GCF_000008685.2	lp56	17207	17813	606	100.0	5.47e-130
GCF_040790755.1_ASM4079075v1_genomic	NZ_CP161099.1	15227	15431	204	renamed_GCF_000008685.2	lp56	18712	18916	204	100.0	2.578e-39
GCF_040790755.1_ASM4079075v1_genomic	NZ_CP161099.1	15434	15782	348	renamed_GCF_000008685.2	cp32-6	15437	15785	348	99.1	1.964e-73
GCF_040790755.1_ASM4079075v1_genomic	NZ_CP161099.1	16099	16453	354	renamed_GCF_000008685.2	cp32-6	16102	16456	354	100.0	1.459e-77
GCF_040790755.1_ASM4079075v1_genomic	NZ_CP161099.1	26157	26847	690	renamed_GCF_000008685.2	cp32-7	26151	26841	690	70.0	3.326e-98
GCF_040790755.1_ASM4079075v1_genomic	NZ_CP161094.1	28750	29317	567	renamed_GCF_000008685.2	cp32-3	28235	28874	567	94.6	1.015e-116
GCF_040790755.1_ASM4079075v1_genomic	NZ_CP161105.1	1407	1965	558	renamed_GCF_000008685.2	cp9	1281	1839	558	97.8	1.105e-122
GCF_040790755.1_ASM4079075v1_genomic	NZ_CP161105.1	2017	2578	561	renamed_GCF_000008685.2	cp9	1891	2452	561	96.2	1.867e-117
GCF_040790755.1_ASM4079075v1_genomic	NZ_CP161105.1	4519	3979	540	renamed_GCF_000008685.2	cp9	4377	3852	540	61.7	3.433e-65
GCF_040790755.1_ASM4079075v1_genomic	NZ_CP161105.1	4931	4661	270	renamed_GCF_000008685.2	cp9	4788	4503	270	71.2	4.224e-37
GCF_040790755.1_ASM4079075v1_genomic	NZ_CP161105.1	5746	6034	288	renamed_GCF_000008685.2	lp21	16548	16227	288	36.6	1.024e-15
GCF_040790755.1_ASM4079075v1_genomic	NZ_CP161104.1	8583	9267	684	renamed_GCF_000008685.2	lp17	5055	5739	684	98.6	3.113e-149
GCF_040790755.1_ASM4079075v1_genomic	NZ_CP161103.1	22555	21823	732	renamed_GCF_000008685.2	lp25	22677	21945	732	99.1	1.279e-158
GCF_040790755.1_ASM4079075v1_genomic	NZ_CP161098.1	221	1115	894	renamed_GCF_000008685.2	lp28-2	115	1009	894	99.3	3.345e-192
GCF_040790755.1_ASM4079075v1_genomic	NZ_CP161098.1	1164	2034	870	renamed_GCF_000008685.2	lp28-2	1046	1928	870	97.5	1.367e-189
GCF_040790755.1_ASM4079075v1_genomic	NZ_CP161098.1	2209	2716	507	renamed_GCF_000008685.2	lp56	3622	4108	507	93.7	1.866e-83
GCF_040790755.1_ASM4079075v1_genomic	NZ_CP161098.1	4154	3023	1131	renamed_GCF_000008685.2	lp28-3	27445	26977	1131	87.8	3.236e-74
GCF_040790755.1_ASM4079075v1_genomic	NZ_CP161098.1	14442	13608	834	renamed_GCF_000008685.2	lp28-2	14341	13507	834	98.1	3.319e-182
GCF_040790755.1_ASM4079075v1_genomic	NZ_CP161100.1	4023	4839	816	renamed_GCF_000008685.2	lp28-4	2535	3351	816	100.0	8.08e-178
GCF_040790755.1_ASM4079075v1_genomic	NZ_CP161100.1	6616	6835	219	renamed_GCF_000008685.2	lp28-4	5127	5346	219	100.0	1.443e-47
GCF_040790755.1_ASM4079075v1_genomic	NZ_CP161100.1	8725	9631	906	renamed_GCF_000008685.2	lp28-4	7182	8538	906	88.3	1.433e-160
GCF_040790755.1_ASM4079075v1_genomic	NZ_CP161100.1	24609	23772	837	renamed_GCF_000008685.2	lp28-4	22931	22094	837	98.9	7.731e-182
GCF_040790755.1_ASM4079075v1_genomic	NZ_CP161101.1	14991	15195	204	renamed_GCF_000008685.2	lp36	17379	17583	204	100.0	8.441e-43
GCF_040790755.1_ASM4079075v1_genomic	NZ_CP161101.1	17999	19073	1074	renamed_GCF_000008685.2	lp36	20388	21453	1074	96.0	3.126e-223
GCF_040790755.1_ASM4079075v1_genomic	NZ_CP161101.1	19531	19753	222	renamed_GCF_000008685.2	lp36	21911	22133	222	100.0	1.866e-45
GCF_040790755.1_ASM4079075v1_genomic	NZ_CP161101.1	20423	19856	567	renamed_GCF_000008685.2	lp36	26358	25812	567	97.2	1.796e-110
GCF_040790755.1_ASM4079075v1_genomic	NZ_CP161101.1	23298	22545	753	renamed_GCF_000008685.2	lp28-1	26996	28073	753	46.7	5.869e-46
GCF_040790755.1_ASM4079075v1_genomic	NZ_CP161093.1	22208	23246	1038	renamed_GCF_000008685.2	lp38	22042	23008	1038	98.7	6.3e-218
GCF_040790755.1_ASM4079075v1_genomic	NZ_CP161093.1	23525	24326	801	renamed_GCF_000008685.2	lp38	32497	33220	801	95.4	4.286e-148
GCF_040790755.1_ASM4079075v1_genomic	NZ_CP161093.1	26647	25576	1071	renamed_GCF_000008685.2	lp38	26407	25336	1071	96.6	9.289e-228
GCF_040790755.1_ASM4079075v1_genomic	NZ_CP161093.1	28297	27700	597	renamed_GCF_000008685.2	lp38	28053	26994	597	96.9	1.402e-126
GCF_040790755.1_ASM4079075v1_genomic	NZ_CP161093.1	31458	32376	918	renamed_GCF_000008685.2	lp38	31219	32140	918	99.3	1.207e-207
GCF_040790755.1_ASM4079075v1_genomic	NZ_CP161093.1	34872	34575	297	renamed_GCF_000008685.2	lp38	34668	34371	297	98.9	1.401e-60
GCF_040790755.1_ASM4079075v1_genomic	NZ_CP161106.1	4411	4843	432	renamed_GCF_000008685.2	lp5	4387	4819	432	99.3	2.641e-92
GCF_040790755.1_ASM4079075v1_genomic	NZ_CP161092.1	27432	28041	609	renamed_GCF_000008685.2	lp54	27389	27998	609	100.0	2.346e-131
GCF_040790755.1_ASM4079075v1_genomic	NZ_CP161092.1	28056	28974	918	renamed_GCF_000008685.2	lp54	28013	28931	918	100.0	2.109e-201
GCF_040790755.1_ASM4079075v1_genomic	NZ_CP161092.1	28977	29430	453	renamed_GCF_000008685.2	lp54	28934	29387	453	100.0	2.51e-96
GCF_040790755.1_ASM4079075v1_genomic	NZ_CP161092.1	29426	29801	375	renamed_GCF_000008685.2	lp54	29383	29758	375	100.0	1.685e-79
GCF_040790755.1_ASM4079075v1_genomic	NZ_CP161092.1	30136	30676	540	renamed_GCF_000008685.2	lp54	30093	30633	540	100.0	4.969e-120
GCF_040790755.1_ASM4079075v1_genomic	NZ_CP161092.1	30743	31814	1071	renamed_GCF_000008685.2	lp54	30709	31780	1071	99.4	1.082e-234
GCF_040790755.1_ASM4079075v1_genomic	NZ_CP161092.1	31813	32236	423	renamed_GCF_000008685.2	lp54	31779	32202	423	100.0	5.086e-92
GCF_040790755.1_ASM4079075v1_genomic	NZ_CP161092.1	32294	32783	489	renamed_GCF_000008685.2	lp54	32260	32749	489	100.0	3.125e-108
GCF_040790755.1_ASM4079075v1_genomic	NZ_CP161092.1	51105	50880	225	renamed_GCF_000008685.2	lp54	50077	49852	225	97.2	5.385e-43
GCF_040790755.1_ASM4079075v1_genomic	NZ_CP161092.1	52204	51313	891	renamed_GCF_000008685.2	lp54	51176	50285	891	99.3	9.02e-198
GCF_040790755.1_ASM4079075v1_genomic	NZ_CP161092.1	52733	53507	774	renamed_GCF_000008685.2	lp54	51705	52479	774	100.0	9.219e-161
GCF_040790755.1_ASM4079075v1_genomic	NZ_CP161092.1	53733	54531	798	renamed_GCF_000008685.2	lp54	52705	53503	798	99.6	3.008e-177
GCF_040790755.1_ASM4079075v1_genomic	NZ_CP161091.1	1823	794	1029	renamed_GCF_000008685.2	chromosome	1796	767	1029	99.4	1.177e-226
GCF_040790755.1_ASM4079075v1_genomic	NZ_CP161091.1	8346	7488	858	renamed_GCF_000008685.2	chromosome	8315	7457	858	99.6	1.438e-195
GCF_040790755.1_ASM4079075v1_genomic	NZ_CP161091.1	10233	10608	375	renamed_GCF_000008685.2	chromosome	10202	10577	375	100.0	3.75e-79
GCF_040790755.1_ASM4079075v1_genomic	NZ_CP161091.1	11451	12192	741	renamed_GCF_000008685.2	chromosome	11420	12161	741	99.1	2.049e-163
GCF_040790755.1_ASM4079075v1_genomic	NZ_CP161091.1	12776	14759	1983	renamed_GCF_000008685.2	chromosome	12745	14728	1983	99.8	0.0
GCF_040790755.1_ASM4079075v1_genomic	NZ_CP161091.1	33910	32029	1881	renamed_GCF_000008685.2	chromosome	34037	32156	1881	100.0	0.0
GCF_040790755.1_ASM4079075v1_genomic	NZ_CP161091.1	36482	35729	753	renamed_GCF_000008685.2	chromosome	36609	35856	753	98.0	1.62e-159
GCF_040790755.1_ASM4079075v1_genomic	NZ_CP161091.1	39511	38008	1503	renamed_GCF_000008685.2	chromosome	39638	38135	1503	99.8	0.0
GCF_040790755.1_ASM4079075v1_genomic	NZ_CP161091.1	41305	40633	672	renamed_GCF_000008685.2	chromosome	41432	40760	672	100.0	1.856e-144
GCF_040790755.1_ASM4079075v1_genomic	NZ_CP161091.1	45227	42779	2448	renamed_GCF_000008685.2	chromosome	45354	42906	2448	99.3	0.0
GCF_040790755.1_ASM4079075v1_genomic	NZ_CP161091.1	47039	47714	675	renamed_GCF_000008685.2	chromosome	47166	47841	675	99.5	1.946e-144
GCF_040790755.1_ASM4079075v1_genomic	NZ_CP161091.1	49132	48475	657	renamed_GCF_000008685.2	chromosome	49259	48602	657	99.5	1.056e-139
GCF_040790755.1_ASM4079075v1_genomic	NZ_CP161091.1	50347	49984	363	renamed_GCF_000008685.2	chromosome	50474	50111	363	100.0	4.578e-75
GCF_040790755.1_ASM4079075v1_genomic	NZ_CP161091.1	52307	51125	1182	renamed_GCF_000008685.2	chromosome	52434	51252	1182	99.7	3.289e-258
GCF_040790755.1_ASM4079075v1_genomic	NZ_CP161091.1	55377	53406	1971	renamed_GCF_000008685.2	chromosome	55504	53533	1971	99.6	0.0
GCF_040790755.1_ASM4079075v1_genomic	NZ_CP161091.1	75644	76325	681	renamed_GCF_000008685.2	chromosome	75773	76454	681	100.0	3.584e-147
GCF_040790755.1_ASM4079075v1_genomic	NZ_CP161091.1	78874	77581	1293	renamed_GCF_000008685.2	chromosome	79009	77710	1293	93.4	8.802e-266
GCF_040790755.1_ASM4079075v1_genomic	NZ_CP161091.1	79367	80636	1269	renamed_GCF_000008685.2	chromosome	79504	80773	1269	98.1	4.098e-279
GCF_040790755.1_ASM4079075v1_genomic	NZ_CP161091.1	93894	93294	600	renamed_GCF_000008685.2	chromosome	94032	93432	600	100.0	1.47e-126
GCF_040790755.1_ASM4079075v1_genomic	NZ_CP161091.1	96815	94472	2343	renamed_GCF_000008685.2	chromosome	96953	94610	2343	99.1	0.0
GCF_040790755.1_ASM4079075v1_genomic	NZ_CP161091.1	98642	97724	918	renamed_GCF_000008685.2	chromosome	98648	97862	918	98.0	6.259e-172
GCF_040790755.1_ASM4079075v1_genomic	NZ_CP161091.1	100088	100610	522	renamed_GCF_000008685.2	chromosome	100227	100749	522	97.6	1.62e-112
GCF_040790755.1_ASM4079075v1_genomic	NZ_CP161091.1	102810	101385	1425	renamed_GCF_000008685.2	chromosome	102949	101524	1425	100.0	1.009e-312
GCF_040790755.1_ASM4079075v1_genomic	NZ_CP161091.1	112630	112210	420	renamed_GCF_000008685.2	chromosome	112769	112349	420	98.5	7.151e-88
GCF_040790755.1_ASM4079075v1_genomic	NZ_CP161091.1	114668	115370	702	renamed_GCF_000008685.2	chromosome	114806	115508	702	99.1	1.161e-154
GCF_040790755.1_ASM4079075v1_genomic	NZ_CP161091.1	216678	217710	1032	renamed_GCF_000008685.2	chromosome	217277	218312	1032	99.4	4.772e-220
GCF_040790755.1_ASM4079075v1_genomic	NZ_CP161091.1	219032	218453	579	renamed_GCF_000008685.2	chromosome	219634	219055	579	99.4	8.388e-121
GCF_040790755.1_ASM4079075v1_genomic	NZ_CP161091.1	220126	221035	909	renamed_GCF_000008685.2	chromosome	220728	221637	909	99.3	4.638e-191
GCF_040790755.1_ASM4079075v1_genomic	NZ_CP161091.1	231736	234652	2916	renamed_GCF_000008685.2	chromosome	232337	235253	2916	99.2	0.0
GCF_040790755.1_ASM4079075v1_genomic	NZ_CP161091.1	236541	234993	1548	renamed_GCF_000008685.2	chromosome	237142	235594	1548	99.8	0.0
GCF_040790755.1_ASM4079075v1_genomic	NZ_CP161091.1	237355	237028	327	renamed_GCF_000008685.2	chromosome	237956	237629	327	100.0	8.435e-71
GCF_040790755.1_ASM4079075v1_genomic	NZ_CP161091.1	238527	237699	828	renamed_GCF_000008685.2	chromosome	239128	238300	828	99.6	1.027e-185
GCF_040790755.1_ASM4079075v1_genomic	NZ_CP161091.1	239649	238542	1107	renamed_GCF_000008685.2	chromosome	240250	239143	1107	99.7	3.718e-244
GCF_040790755.1_ASM4079075v1_genomic	NZ_CP161091.1	298159	296848	1311	renamed_GCF_000008685.2	chromosome	298776	297465	1311	100.0	6.981e-289
GCF_040790755.1_ASM4079075v1_genomic	NZ_CP161091.1	309162	307920	1242	renamed_GCF_000008685.2	chromosome	309780	308538	1242	99.7	3.039e-269
GCF_040790755.1_ASM4079075v1_genomic	NZ_CP161091.1	311035	309940	1095	renamed_GCF_000008685.2	chromosome	311617	310558	1095	99.4	1.229e-228
GCF_040790755.1_ASM4079075v1_genomic	NZ_CP161091.1	313506	312114	1392	renamed_GCF_000008685.2	chromosome	314123	312728	1392	99.7	5.166e-306
GCF_040790755.1_ASM4079075v1_genomic	NZ_CP161091.1	315526	314689	837	renamed_GCF_000008685.2	chromosome	316143	315306	837	99.6	1.426e-183
GCF_040790755.1_ASM4079075v1_genomic	NZ_CP161091.1	327110	326081	1029	renamed_GCF_000008685.2	chromosome	327757	326698	1029	98.5	4.402e-229
GCF_040790755.1_ASM4079075v1_genomic	NZ_CP161091.1	328647	329007	360	renamed_GCF_000008685.2	chromosome	329261	329621	360	100.0	1.609e-77
GCF_040790755.1_ASM4079075v1_genomic	NZ_CP161091.1	332993	330188	2805	renamed_GCF_000008685.2	chromosome	333598	330802	2805	99.4	0.0
GCF_040790755.1_ASM4079075v1_genomic	NZ_CP161091.1	334331	335903	1572	renamed_GCF_000008685.2	chromosome	334936	336508	1572	100.0	0.0
GCF_040790755.1_ASM4079075v1_genomic	NZ_CP161091.1	339723	340644	921	renamed_GCF_000008685.2	chromosome	340340	341261	921	98.6	3.516e-196
GCF_040790755.1_ASM4079075v1_genomic	NZ_CP161091.1	124675	124009	666	renamed_GCF_000008685.2	chromosome	124814	124148	666	100.0	8.347e-144
GCF_040790755.1_ASM4079075v1_genomic	NZ_CP161091.1	126162	125394	768	renamed_GCF_000008685.2	chromosome	126301	125533	768	100.0	3.291e-171
GCF_040790755.1_ASM4079075v1_genomic	NZ_CP161091.1	130975	130030	945	renamed_GCF_000008685.2	chromosome	131114	130169	945	100.0	6.888e-210
GCF_040790755.1_ASM4079075v1_genomic	NZ_CP161091.1	131158	132286	1128	renamed_GCF_000008685.2	chromosome	131297	132425	1128	99.7	1.76e-247
GCF_040790755.1_ASM4079075v1_genomic	NZ_CP161091.1	133835	135725	1890	renamed_GCF_000008685.2	chromosome	133974	135864	1890	99.6	0.0
GCF_040790755.1_ASM4079075v1_genomic	NZ_CP161091.1	138610	138298	312	renamed_GCF_000008685.2	chromosome	138745	138433	312	100.0	9.828e-67
GCF_040790755.1_ASM4079075v1_genomic	NZ_CP161091.1	144133	142810	1323	renamed_GCF_000008685.2	chromosome	144230	142943	1323	98.3	1.136e-276
GCF_040790755.1_ASM4079075v1_genomic	NZ_CP161091.1	146237	145337	900	renamed_GCF_000008685.2	chromosome	146370	145470	900	100.0	6.779e-194
GCF_040790755.1_ASM4079075v1_genomic	NZ_CP161091.1	159223	159898	675	renamed_GCF_000008685.2	chromosome	159367	160042	675	97.7	2.35e-142
GCF_040790755.1_ASM4079075v1_genomic	NZ_CP161091.1	162657	161055	1602	renamed_GCF_000008685.2	chromosome	162801	161199	1602	99.8	0.0
GCF_040790755.1_ASM4079075v1_genomic	NZ_CP161091.1	203205	203973	768	renamed_GCF_000008685.2	chromosome	202849	204088	768	100.0	2.852e-164
GCF_040790755.1_ASM4079075v1_genomic	NZ_CP161091.1	204957	205929	972	renamed_GCF_000008685.2	chromosome	205174	206044	972	99.6	3.289e-188
GCF_040790755.1_ASM4079075v1_genomic	NZ_CP161091.1	208504	207967	537	renamed_GCF_000008685.2	chromosome	208581	208083	537	98.7	8.112e-106
GCF_040790755.1_ASM4079075v1_genomic	NZ_CP161091.1	222576	223359	783	renamed_GCF_000008685.2	chromosome	223178	223961	783	98.8	4.166e-171
GCF_040790755.1_ASM4079075v1_genomic	NZ_CP161091.1	226009	224224	1785	renamed_GCF_000008685.2	chromosome	226610	224825	1785	99.6	0.0
GCF_040790755.1_ASM4079075v1_genomic	NZ_CP161091.1	227920	227212	708	renamed_GCF_000008685.2	chromosome	228521	227813	708	99.5	4.758e-157
GCF_040790755.1_ASM4079075v1_genomic	NZ_CP161091.1	228615	229623	1008	renamed_GCF_000008685.2	chromosome	229216	230224	1008	100.0	1.228e-222
GCF_040790755.1_ASM4079075v1_genomic	NZ_CP161091.1	244112	243341	771	renamed_GCF_000008685.2	chromosome	244713	243942	771	100.0	4.161e-169
GCF_040790755.1_ASM4079075v1_genomic	NZ_CP161091.1	245188	245953	765	renamed_GCF_000008685.2	chromosome	245789	246554	765	100.0	7.663e-170
GCF_040790755.1_ASM4079075v1_genomic	NZ_CP161091.1	286472	285353	1119	renamed_GCF_000008685.2	chromosome	287089	285970	1119	100.0	9.957e-244
GCF_040790755.1_ASM4079075v1_genomic	NZ_CP161091.1	287556	287292	264	renamed_GCF_000008685.2	chromosome	288173	287909	264	100.0	2.025e-51
GCF_040790755.1_ASM4079075v1_genomic	NZ_CP161091.1	288966	288339	627	renamed_GCF_000008685.2	chromosome	289583	288956	627	98.5	1.541e-130
GCF_040790755.1_ASM4079075v1_genomic	NZ_CP161091.1	290404	289345	1059	renamed_GCF_000008685.2	chromosome	291021	289962	1059	100.0	3.164e-229
GCF_040790755.1_ASM4079075v1_genomic	NZ_CP161091.1	300147	299112	1035	renamed_GCF_000008685.2	chromosome	300764	299729	1035	100.0	3.255e-216
GCF_040790755.1_ASM4079075v1_genomic	NZ_CP161091.1	302219	301886	333	renamed_GCF_000008685.2	chromosome	302839	302503	333	99.0	1.253e-67
GCF_040790755.1_ASM4079075v1_genomic	NZ_CP161091.1	303123	302715	408	renamed_GCF_000008685.2	chromosome	303740	303332	408	99.2	2.649e-88
GCF_040790755.1_ASM4079075v1_genomic	NZ_CP161091.1	305044	304495	549	renamed_GCF_000008685.2	chromosome	305661	305112	549	100.0	9.24e-115
GCF_040790755.1_ASM4079075v1_genomic	NZ_CP161091.1	306699	306006	693	renamed_GCF_000008685.2	chromosome	307317	306624	693	100.0	2.971e-151
GCF_040790755.1_ASM4079075v1_genomic	NZ_CP161091.1	318499	317659	840	renamed_GCF_000008685.2	chromosome	319116	318276	840	99.6	1.977e-180
GCF_040790755.1_ASM4079075v1_genomic	NZ_CP161091.1	364989	364500	489	renamed_GCF_000008685.2	chromosome	365603	365114	489	100.0	3.787e-106
GCF_040790755.1_ASM4079075v1_genomic	NZ_CP161091.1	366346	365614	732	renamed_GCF_000008685.2	chromosome	366960	366228	732	98.3	5.755e-159
GCF_040790755.1_ASM4079075v1_genomic	NZ_CP161091.1	367841	368267	426	renamed_GCF_000008685.2	chromosome	368455	368881	426	92.9	3.139e-81
GCF_040790755.1_ASM4079075v1_genomic	NZ_CP161091.1	368270	369413	1143	renamed_GCF_000008685.2	chromosome	368884	370027	1143	99.4	3.521e-242
GCF_040790755.1_ASM4079075v1_genomic	NZ_CP161091.1	112	676	564	renamed_GCF_000008685.2	chromosome	104	677	564	100.0	4.108e-126
GCF_040790755.1_ASM4079075v1_genomic	NZ_CP161091.1	3425	5219	1794	renamed_GCF_000008685.2	chromosome	3418	5188	1794	98.6	0.0
GCF_040790755.1_ASM4079075v1_genomic	NZ_CP161091.1	6337	5281	1056	renamed_GCF_000008685.2	chromosome	6306	5250	1056	99.1	1.902e-234
GCF_040790755.1_ASM4079075v1_genomic	NZ_CP161091.1	7428	6339	1089	renamed_GCF_000008685.2	chromosome	7397	6308	1089	100.0	1.828e-240
GCF_040790755.1_ASM4079075v1_genomic	NZ_CP161091.1	8457	9228	771	renamed_GCF_000008685.2	chromosome	8426	9197	771	100.0	1.781e-161
GCF_040790755.1_ASM4079075v1_genomic	NZ_CP161091.1	9232	10237	1005	renamed_GCF_000008685.2	chromosome	9201	10206	1005	98.8	9.189e-217
GCF_040790755.1_ASM4079075v1_genomic	NZ_CP161091.1	10611	11451	840	renamed_GCF_000008685.2	chromosome	10580	11420	840	100.0	7.775e-191
GCF_040790755.1_ASM4079075v1_genomic	NZ_CP161091.1	12184	12784	600	renamed_GCF_000008685.2	chromosome	12153	12753	600	99.4	2.034e-131
GCF_040790755.1_ASM4079075v1_genomic	NZ_CP161091.1	15753	15375	378	renamed_GCF_000008685.2	chromosome	15716	15344	378	100.0	1.768e-79
GCF_040790755.1_ASM4079075v1_genomic	NZ_CP161091.1	56153	55373	780	renamed_GCF_000008685.2	chromosome	56280	55500	780	99.6	1.628e-172
GCF_040790755.1_ASM4079075v1_genomic	NZ_CP161091.1	57058	56704	354	renamed_GCF_000008685.2	chromosome	57185	56831	354	99.1	6.554e-78
GCF_040790755.1_ASM4079075v1_genomic	NZ_CP161091.1	59911	58972	939	renamed_GCF_000008685.2	chromosome	60039	59100	939	98.7	4.925e-204
GCF_040790755.1_ASM4079075v1_genomic	NZ_CP161091.1	61129	60439	690	renamed_GCF_000008685.2	chromosome	61257	60567	690	98.2	8.357e-148
GCF_040790755.1_ASM4079075v1_genomic	NZ_CP161091.1	63909	65148	1239	renamed_GCF_000008685.2	chromosome	64037	65276	1239	99.7	2.817e-278
GCF_040790755.1_ASM4079075v1_genomic	NZ_CP161091.1	69437	69998	561	renamed_GCF_000008685.2	chromosome	69565	70126	561	100.0	3.775e-118
GCF_040790755.1_ASM4079075v1_genomic	NZ_CP161091.1	71072	72482	1410	renamed_GCF_000008685.2	chromosome	71200	72610	1410	99.3	1.384e-306
GCF_040790755.1_ASM4079075v1_genomic	NZ_CP161091.1	119665	118825	840	renamed_GCF_000008685.2	chromosome	119803	118963	840	98.5	1.176e-177
GCF_040790755.1_ASM4079075v1_genomic	NZ_CP161091.1	120943	120664	279	renamed_GCF_000008685.2	chromosome	121082	120803	279	100.0	1.411e-57
GCF_040790755.1_ASM4079075v1_genomic	NZ_CP161091.1	148526	147515	1011	renamed_GCF_000008685.2	chromosome	148659	147648	1011	99.7	2.697e-214
GCF_040790755.1_ASM4079075v1_genomic	NZ_CP161091.1	150828	152034	1206	renamed_GCF_000008685.2	chromosome	150973	152179	1206	99.7	1.095e-274
GCF_040790755.1_ASM4079075v1_genomic	NZ_CP161091.1	153541	152929	612	renamed_GCF_000008685.2	chromosome	153686	153074	612	99.5	5.181e-140
GCF_040790755.1_ASM4079075v1_genomic	NZ_CP161091.1	156317	157454	1137	renamed_GCF_000008685.2	chromosome	156461	157598	1137	99.7	1.277e-252
GCF_040790755.1_ASM4079075v1_genomic	NZ_CP161091.1	157913	158330	417	renamed_GCF_000008685.2	chromosome	158075	158474	417	100.0	2.72e-81
GCF_040790755.1_ASM4079075v1_genomic	NZ_CP161091.1	171107	171341	234	renamed_GCF_000008685.2	chromosome	171262	171484	234	98.6	1.134e-44
GCF_040790755.1_ASM4079075v1_genomic	NZ_CP161091.1	174941	173954	987	renamed_GCF_000008685.2	chromosome	174970	174097	987	99.6	1.701e-189
GCF_040790755.1_ASM4079075v1_genomic	NZ_CP161091.1	177710	176834	876	renamed_GCF_000008685.2	chromosome	177853	176977	876	100.0	9.427e-195
GCF_040790755.1_ASM4079075v1_genomic	NZ_CP161091.1	234933	234687	246	renamed_GCF_000008685.2	chromosome	235534	235288	246	98.7	3.025e-52
GCF_040790755.1_ASM4079075v1_genomic	NZ_CP161091.1	237028	236620	408	renamed_GCF_000008685.2	chromosome	237629	237221	408	100.0	2.649e-88
GCF_040790755.1_ASM4079075v1_genomic	NZ_CP161091.1	237625	237367	258	renamed_GCF_000008685.2	chromosome	238226	237968	258	100.0	9.113e-51
GCF_040790755.1_ASM4079075v1_genomic	NZ_CP161091.1	241688	239681	2007	renamed_GCF_000008685.2	chromosome	242289	240282	2007	99.7	0.0
GCF_040790755.1_ASM4079075v1_genomic	NZ_CP161091.1	272072	269879	2193	renamed_GCF_000008685.2	chromosome	272641	270487	2193	99.8	0.0
GCF_040790755.1_ASM4079075v1_genomic	NZ_CP161091.1	273236	274619	1383	renamed_GCF_000008685.2	chromosome	273856	275236	1383	99.7	2.662e-303
GCF_040790755.1_ASM4079075v1_genomic	NZ_CP161091.1	275940	276447	507	renamed_GCF_000008685.2	chromosome	276671	277064	507	100.0	6.298e-87
GCF_040790755.1_ASM4079075v1_genomic	NZ_CP161091.1	278441	277919	522	renamed_GCF_000008685.2	chromosome	279058	278536	522	100.0	3.966e-111
GCF_040790755.1_ASM4079075v1_genomic	NZ_CP161091.1	280694	278789	1905	renamed_GCF_000008685.2	chromosome	281311	279406	1905	99.6	0.0
GCF_040790755.1_ASM4079075v1_genomic	NZ_CP161091.1	290978	290441	537	renamed_GCF_000008685.2	chromosome	291595	291058	537	100.0	7.638e-115
GCF_040790755.1_ASM4079075v1_genomic	NZ_CP161091.1	424976	426104	1128	renamed_GCF_000008685.2	chromosome	425583	426711	1128	100.0	1.044e-244
GCF_040790755.1_ASM4079075v1_genomic	NZ_CP161091.1	447979	447589	390	renamed_GCF_000008685.2	chromosome	448591	448201	390	100.0	7.926e-82
GCF_040790755.1_ASM4079075v1_genomic	NZ_CP161091.1	448092	448698	606	renamed_GCF_000008685.2	chromosome	448707	449310	606	99.5	2.46e-130
GCF_040790755.1_ASM4079075v1_genomic	NZ_CP161091.1	448806	449559	753	renamed_GCF_000008685.2	chromosome	449418	450171	753	100.0	3.278e-160
GCF_040790755.1_ASM4079075v1_genomic	NZ_CP161091.1	451309	450526	783	renamed_GCF_000008685.2	chromosome	451921	451138	783	99.6	5.024e-169
GCF_040790755.1_ASM4079075v1_genomic	NZ_CP161091.1	453860	451427	2433	renamed_GCF_000008685.2	chromosome	454472	452039	2433	99.7	0.0
GCF_040790755.1_ASM4079075v1_genomic	NZ_CP161091.1	455776	453871	1905	renamed_GCF_000008685.2	chromosome	456388	454483	1905	99.8	0.0
GCF_040790755.1_ASM4079075v1_genomic	NZ_CP161091.1	455963	457424	1461	renamed_GCF_000008685.2	chromosome	456575	458036	1461	100.0	0.0
GCF_040790755.1_ASM4079075v1_genomic	NZ_CP161091.1	457664	458822	1158	renamed_GCF_000008685.2	chromosome	458276	459434	1158	99.4	2.984e-255
GCF_040790755.1_ASM4079075v1_genomic	NZ_CP161091.1	479091	480402	1311	renamed_GCF_000008685.2	chromosome	479708	481019	1311	100.0	7.438e-297
GCF_040790755.1_ASM4079075v1_genomic	NZ_CP161091.1	488874	489102	228	renamed_GCF_000008685.2	chromosome	489539	489719	228	100.0	1.455e-33
GCF_040790755.1_ASM4079075v1_genomic	NZ_CP161091.1	489115	489937	822	renamed_GCF_000008685.2	chromosome	489732	490554	822	99.6	1.358e-181
GCF_040790755.1_ASM4079075v1_genomic	NZ_CP161091.1	490026	491310	1284	renamed_GCF_000008685.2	chromosome	490643	491927	1284	100.0	9.564e-281
GCF_040790755.1_ASM4079075v1_genomic	NZ_CP161091.1	491970	493335	1365	renamed_GCF_000008685.2	chromosome	492587	493952	1365	100.0	1.721e-296
GCF_040790755.1_ASM4079075v1_genomic	NZ_CP161091.1	493925	493532	393	renamed_GCF_000008685.2	chromosome	494539	494149	393	99.2	2.252e-79
GCF_040790755.1_ASM4079075v1_genomic	NZ_CP161091.1	494415	495600	1185	renamed_GCF_000008685.2	chromosome	495032	496217	1185	100.0	4.832e-263
GCF_040790755.1_ASM4079075v1_genomic	NZ_CP161091.1	495650	495962	312	renamed_GCF_000008685.2	chromosome	496267	496579	312	100.0	2.953e-63
GCF_040790755.1_ASM4079075v1_genomic	NZ_CP161091.1	495997	496618	621	renamed_GCF_000008685.2	chromosome	496614	497235	621	99.5	8.732e-136
GCF_040790755.1_ASM4079075v1_genomic	NZ_CP161091.1	496627	497257	630	renamed_GCF_000008685.2	chromosome	497244	497874	630	100.0	4.528e-136
GCF_040790755.1_ASM4079075v1_genomic	NZ_CP161091.1	506384	506762	378	renamed_GCF_000008685.2	chromosome	507001	507379	378	100.0	8.763e-79
GCF_040790755.1_ASM4079075v1_genomic	NZ_CP161091.1	515868	522369	6501	renamed_GCF_000008685.2	chromosome	516492	522993	6501	99.3	0.0
GCF_040790755.1_ASM4079075v1_genomic	NZ_CP161091.1	523929	525630	1701	renamed_GCF_000008685.2	chromosome	524553	526254	1701	99.1	0.0
GCF_040790755.1_ASM4079075v1_genomic	NZ_CP161091.1	528573	527478	1095	renamed_GCF_000008685.2	chromosome	529198	528103	1095	100.0	3.934e-250
GCF_040790755.1_ASM4079075v1_genomic	NZ_CP161091.1	530480	528572	1908	renamed_GCF_000008685.2	chromosome	531105	529197	1908	100.0	0.0
GCF_040790755.1_ASM4079075v1_genomic	NZ_CP161091.1	531067	530503	564	renamed_GCF_000008685.2	chromosome	531692	531128	564	100.0	2.704e-122
GCF_040790755.1_ASM4079075v1_genomic	NZ_CP161091.1	554597	555962	1365	renamed_GCF_000008685.2	chromosome	555215	556580	1365	98.6	1.837e-304
GCF_040790755.1_ASM4079075v1_genomic	NZ_CP161091.1	567511	568381	870	renamed_GCF_000008685.2	chromosome	568269	569139	870	100.0	1.737e-195
GCF_040790755.1_ASM4079075v1_genomic	NZ_CP161091.1	568519	568780	261	renamed_GCF_000008685.2	chromosome	569277	569538	261	100.0	9.575e-51
GCF_040790755.1_ASM4079075v1_genomic	NZ_CP161091.1	568800	570522	1722	renamed_GCF_000008685.2	chromosome	569558	571280	1722	99.6	0.0
GCF_040790755.1_ASM4079075v1_genomic	NZ_CP161091.1	570524	571094	570	renamed_GCF_000008685.2	chromosome	571282	571852	570	100.0	1.471e-121
GCF_040790755.1_ASM4079075v1_genomic	NZ_CP161091.1	572982	571131	1851	renamed_GCF_000008685.2	chromosome	573740	571889	1851	100.0	0.0
GCF_040790755.1_ASM4079075v1_genomic	NZ_CP161091.1	573094	574489	1395	renamed_GCF_000008685.2	chromosome	573852	575247	1395	99.3	1.406e-312
GCF_040790755.1_ASM4079075v1_genomic	NZ_CP161091.1	575058	574515	543	renamed_GCF_000008685.2	chromosome	575816	575273	543	99.4	1.544e-116
GCF_040790755.1_ASM4079075v1_genomic	NZ_CP161091.1	575768	575222	546	renamed_GCF_000008685.2	chromosome	576499	575980	546	100.0	1.781e-115
GCF_040790755.1_ASM4079075v1_genomic	NZ_CP161091.1	576429	575823	606	renamed_GCF_000008685.2	chromosome	577187	576581	606	99.5	1.106e-130
GCF_040790755.1_ASM4079075v1_genomic	NZ_CP161091.1	615633	615006	627	renamed_GCF_000008685.2	chromosome	616390	615763	627	100.0	5.736e-133
GCF_040790755.1_ASM4079075v1_genomic	NZ_CP161091.1	617802	615654	2148	renamed_GCF_000008685.2	chromosome	618559	616411	2148	100.0	0.0
GCF_040790755.1_ASM4079075v1_genomic	NZ_CP161091.1	618070	620278	2208	renamed_GCF_000008685.2	chromosome	618827	621035	2208	99.7	0.0
GCF_040790755.1_ASM4079075v1_genomic	NZ_CP161091.1	621196	620287	909	renamed_GCF_000008685.2	chromosome	621953	621044	909	98.3	4.467e-200
GCF_040790755.1_ASM4079075v1_genomic	NZ_CP161091.1	621247	622690	1443	renamed_GCF_000008685.2	chromosome	622004	623447	1443	99.5	0.0
GCF_040790755.1_ASM4079075v1_genomic	NZ_CP161091.1	622693	624250	1557	renamed_GCF_000008685.2	chromosome	623450	625007	1557	98.8	0.0
GCF_040790755.1_ASM4079075v1_genomic	NZ_CP161091.1	624249	625503	1254	renamed_GCF_000008685.2	chromosome	625006	626260	1254	100.0	1.925e-276
GCF_040790755.1_ASM4079075v1_genomic	NZ_CP161091.1	625528	626281	753	renamed_GCF_000008685.2	chromosome	626285	627038	753	99.6	9.23e-166
GCF_040790755.1_ASM4079075v1_genomic	NZ_CP161091.1	628191	626334	1857	renamed_GCF_000008685.2	chromosome	628948	627091	1857	99.1	0.0
GCF_040790755.1_ASM4079075v1_genomic	NZ_CP161091.1	629941	628438	1503	renamed_GCF_000008685.2	chromosome	630698	629195	1503	99.6	6e-323
GCF_040790755.1_ASM4079075v1_genomic	NZ_CP161091.1	675714	677103	1389	renamed_GCF_000008685.2	chromosome	676471	677860	1389	99.7	3.202e-302
GCF_040790755.1_ASM4079075v1_genomic	NZ_CP161091.1	678181	677134	1047	renamed_GCF_000008685.2	chromosome	678938	677891	1047	98.8	3.051e-236
GCF_040790755.1_ASM4079075v1_genomic	NZ_CP161091.1	678992	678200	792	renamed_GCF_000008685.2	chromosome	679750	678958	792	99.6	3.445e-166
GCF_040790755.1_ASM4079075v1_genomic	NZ_CP161091.1	679805	678995	810	renamed_GCF_000008685.2	chromosome	680557	679753	810	99.6	5.278e-173
GCF_040790755.1_ASM4079075v1_genomic	NZ_CP161091.1	680848	679804	1044	renamed_GCF_000008685.2	chromosome	681606	680562	1044	100.0	8.539e-233
GCF_040790755.1_ASM4079075v1_genomic	NZ_CP161091.1	681766	680926	840	renamed_GCF_000008685.2	chromosome	682524	681684	840	100.0	1.641e-182
GCF_040790755.1_ASM4079075v1_genomic	NZ_CP161091.1	681920	682619	699	renamed_GCF_000008685.2	chromosome	682678	683377	699	100.0	1.337e-152
GCF_040790755.1_ASM4079075v1_genomic	NZ_CP161091.1	682664	684209	1545	renamed_GCF_000008685.2	chromosome	683422	684967	1545	99.6	0.0
GCF_040790755.1_ASM4079075v1_genomic	NZ_CP161091.1	685222	684238	984	renamed_GCF_000008685.2	chromosome	685980	684996	984	99.0	9.254e-222
GCF_040790755.1_ASM4079075v1_genomic	NZ_CP161091.1	782435	782162	273	renamed_GCF_000008685.2	chromosome	783248	782975	273	100.0	3.858e-54
GCF_040790755.1_ASM4079075v1_genomic	NZ_CP161091.1	797234	796304	930	renamed_GCF_000008685.2	chromosome	798048	797118	930	100.0	3.063e-199
GCF_040790755.1_ASM4079075v1_genomic	NZ_CP161091.1	798202	797242	960	renamed_GCF_000008685.2	chromosome	799016	798056	960	99.3	3.255e-212
GCF_040790755.1_ASM4079075v1_genomic	NZ_CP161091.1	799461	798393	1068	renamed_GCF_000008685.2	chromosome	800275	799207	1068	99.1	4.094e-245
GCF_040790755.1_ASM4079075v1_genomic	NZ_CP161091.1	799661	800258	597	renamed_GCF_000008685.2	chromosome	800475	801072	597	99.4	1.402e-126
GCF_040790755.1_ASM4079075v1_genomic	NZ_CP161091.1	800196	800964	768	renamed_GCF_000008685.2	chromosome	801118	801778	768	99.0	1.204e-139
GCF_040790755.1_ASM4079075v1_genomic	NZ_CP161091.1	801985	801127	858	renamed_GCF_000008685.2	chromosome	802798	801940	858	100.0	3.462e-177
GCF_040790755.1_ASM4079075v1_genomic	NZ_CP161091.1	802354	802024	330	renamed_GCF_000008685.2	chromosome	803167	802837	330	100.0	2.178e-69
GCF_040790755.1_ASM4079075v1_genomic	NZ_CP161091.1	814517	814082	435	renamed_GCF_000008685.2	chromosome	815302	814867	435	100.0	4.611e-95
GCF_040790755.1_ASM4079075v1_genomic	NZ_CP161091.1	815514	814716	798	renamed_GCF_000008685.2	chromosome	816299	815501	798	100.0	1.968e-173
GCF_040790755.1_ASM4079075v1_genomic	NZ_CP161091.1	816417	815526	891	renamed_GCF_000008685.2	chromosome	817160	816311	891	99.6	1.029e-187
GCF_040790755.1_ASM4079075v1_genomic	NZ_CP161091.1	816615	817176	561	renamed_GCF_000008685.2	chromosome	817395	817956	561	99.4	1.601e-127
GCF_040790755.1_ASM4079075v1_genomic	NZ_CP161091.1	817237	817768	531	renamed_GCF_000008685.2	chromosome	818017	818548	531	100.0	1.403e-115
GCF_040790755.1_ASM4079075v1_genomic	NZ_CP161091.1	817824	818136	312	renamed_GCF_000008685.2	chromosome	818604	818916	312	100.0	1.086e-65
GCF_040790755.1_ASM4079075v1_genomic	NZ_CP161091.1	818141	818462	321	renamed_GCF_000008685.2	chromosome	819035	819242	321	97.0	1.267e-41
GCF_040790755.1_ASM4079075v1_genomic	NZ_CP161091.1	818461	818707	246	renamed_GCF_000008685.2	chromosome	819241	819487	246	100.0	8.275e-50
GCF_040790755.1_ASM4079075v1_genomic	NZ_CP161091.1	818761	819748	987	renamed_GCF_000008685.2	chromosome	819541	820528	987	100.0	5.255e-220
GCF_040790755.1_ASM4079075v1_genomic	NZ_CP161091.1	846282	846645	363	renamed_GCF_000008685.2	chromosome	847125	847488	363	100.0	2.269e-74
GCF_040790755.1_ASM4079075v1_genomic	NZ_CP161091.1	846647	847496	849	renamed_GCF_000008685.2	chromosome	847490	848339	849	97.8	4.198e-182
GCF_040790755.1_ASM4079075v1_genomic	NZ_CP161091.1	847694	847961	267	renamed_GCF_000008685.2	chromosome	848537	848804	267	100.0	3.495e-54
GCF_040790755.1_ASM4079075v1_genomic	NZ_CP161091.1	847975	850144	2169	renamed_GCF_000008685.2	chromosome	848836	850987	2169	99.5	0.0
GCF_040790755.1_ASM4079075v1_genomic	NZ_CP161091.1	850150	851671	1521	renamed_GCF_000008685.2	chromosome	850993	852514	1521	99.2	0.0
GCF_040790755.1_ASM4079075v1_genomic	NZ_CP161091.1	851645	852935	1290	renamed_GCF_000008685.2	chromosome	852488	853778	1290	100.0	6.634e-286
GCF_040790755.1_ASM4079075v1_genomic	NZ_CP161091.1	852931	853999	1068	renamed_GCF_000008685.2	chromosome	853774	854842	1068	99.1	7.372e-230
GCF_040790755.1_ASM4079075v1_genomic	NZ_CP161091.1	854025	855153	1128	renamed_GCF_000008685.2	chromosome	854868	855996	1128	97.3	1.11e-252
GCF_040790755.1_ASM4079075v1_genomic	NZ_CP161091.1	855145	856666	1521	renamed_GCF_000008685.2	chromosome	855988	857509	1521	99.8	0.0
GCF_040790755.1_ASM4079075v1_genomic	NZ_CP161091.1	856662	858072	1410	renamed_GCF_000008685.2	chromosome	857505	858915	1410	99.3	7.483e-305
GCF_040790755.1_ASM4079075v1_genomic	NZ_CP161091.1	899972	900956	984	renamed_GCF_000008685.2	chromosome	900798	901782	984	99.0	6.621e-217
GCF_040790755.1_ASM4079075v1_genomic	NZ_CP161102.1	7846	8776	930	renamed_GCF_000008685.2	cp26	7835	8765	930	98.3	5.152e-202
GCF_040790755.1_ASM4079075v1_genomic	NZ_CP161102.1	9285	10047	762	renamed_GCF_000008685.2	cp26	9274	10036	762	99.2	1.168e-164
GCF_040790755.1_ASM4079075v1_genomic	NZ_CP161102.1	10114	10663	549	renamed_GCF_000008685.2	cp26	10103	10652	549	98.3	3.776e-116
GCF_040790755.1_ASM4079075v1_genomic	NZ_CP161102.1	11429	10931	498	renamed_GCF_000008685.2	cp26	11417	10919	498	99.3	3.972e-107
GCF_040790755.1_ASM4079075v1_genomic	NZ_CP161102.1	12007	13600	1593	renamed_GCF_000008685.2	cp26	12013	13606	1593	99.0	0.0
GCF_040790755.1_ASM4079075v1_genomic	NZ_CP161102.1	15101	13886	1215	renamed_GCF_000008685.2	cp26	15107	13892	1215	98.5	7.027e-264
GCF_040790755.1_ASM4079075v1_genomic	NZ_CP161102.1	16664	15125	1539	renamed_GCF_000008685.2	cp26	16667	15131	1539	98.6	0.0
GCF_040790755.1_ASM4079075v1_genomic	NZ_CP161102.1	16895	17531	636	renamed_GCF_000008685.2	cp26	16902	17535	636	74.1	5.73e-92
GCF_040790755.1_ASM4079075v1_genomic	NZ_CP161096.1	22405	23092	687	renamed_GCF_000008685.2	cp32-1	22130	22763	687	91.6	9.616e-129
GCF_040790755.1_ASM4079075v1_genomic	NZ_CP161096.1	24782	25208	426	renamed_GCF_000008685.2	cp32-7	24512	24938	426	99.2	3.989e-95
GCF_040790755.1_ASM4079075v1_genomic	NZ_CP161096.1	26421	26985	564	renamed_GCF_000008685.2	cp32-9	26209	26770	564	88.7	9.32e-109
GCF_040790755.1_ASM4079075v1_genomic	NZ_CP161096.1	27012	28062	1050	renamed_GCF_000008685.2	cp32-9	26797	27829	1050	97.6	1.166e-221
GCF_040790755.1_ASM4079075v1_genomic	NZ_CP161097.1	19291	20389	1098	renamed_GCF_000008685.2	lp56	22868	23966	1098	99.1	2.233e-248
GCF_040790755.1_ASM4079075v1_genomic	NZ_CP161095.1	2	1289	1287	renamed_GCF_000008685.2	cp32-6	65	1289	1287	99.7	2.746e-269
GCF_040790755.1_ASM4079075v1_genomic	NZ_CP161095.1	2010	2574	564	renamed_GCF_000008685.2	cp32-6	2009	2573	564	99.4	1.105e-123
GCF_040790755.1_ASM4079075v1_genomic	NZ_CP161095.1	3373	3949	576	renamed_GCF_000008685.2	lp56	6835	7411	576	97.9	5.468e-125
GCF_040790755.1_ASM4079075v1_genomic	NZ_CP161095.1	4948	5404	456	renamed_GCF_000008685.2	cp32-6	4948	5404	456	98.6	2.634e-96
GCF_040790755.1_ASM4079075v1_genomic	NZ_CP161095.1	5774	6164	390	renamed_GCF_000008685.2	cp32-4	5777	6167	390	100.0	3.229e-83
GCF_040790755.1_ASM4079075v1_genomic	NZ_CP161095.1	15209	15413	204	renamed_GCF_000008685.2	cp32-3	15211	15415	204	100.0	2.578e-39
GCF_040790755.1_ASM4079075v1_genomic	NZ_CP161095.1	16081	16435	354	renamed_GCF_000008685.2	cp32-3	16083	16437	354	100.0	1.459e-77
GCF_040790755.1_ASM4079075v1_genomic	NZ_CP161095.1	16539	17193	654	renamed_GCF_000008685.2	cp32-7	16551	17139	654	85.7	2.355e-113
GCF_040790755.1_ASM4079075v1_genomic	NZ_CP161095.1	17298	17727	429	renamed_GCF_000008685.2	cp32-9	17301	17730	429	83.3	1.313e-74
GCF_040790755.1_ASM4079075v1_genomic	NZ_CP161095.1	18709	17764	945	renamed_GCF_000008685.2	cp32-3	19228	18286	945	96.8	4.095e-207
GCF_040790755.1_ASM4079075v1_genomic	NZ_CP161099.1	10959	11910	951	renamed_GCF_000008685.2	cp32-8	10951	11902	951	99.3	2.14e-215
GCF_040790755.1_ASM4079075v1_genomic	NZ_CP161099.1	17243	17687	444	renamed_GCF_000008685.2	cp32-6	17246	17696	444	96.5	6.466e-93
GCF_040790755.1_ASM4079075v1_genomic	NZ_CP161099.1	20160	20727	567	renamed_GCF_000008685.2	cp32-1	20223	20790	567	100.0	2.944e-130
GCF_040790755.1_ASM4079075v1_genomic	NZ_CP161099.1	20702	21443	741	renamed_GCF_000008685.2	cp32-8	20739	21480	741	99.5	5.003e-162
GCF_040790755.1_ASM4079075v1_genomic	NZ_CP161099.1	22074	22653	579	renamed_GCF_000008685.2	cp32-8	22112	22691	579	100.0	3.43e-122
GCF_040790755.1_ASM4079075v1_genomic	NZ_CP161099.1	23140	24466	1326	renamed_GCF_000008685.2	cp32-7	23134	24460	1326	99.3	7.819e-299
GCF_040790755.1_ASM4079075v1_genomic	NZ_CP161099.1	24518	24944	426	renamed_GCF_000008685.2	cp32-3	25068	25494	426	98.5	3.989e-95
GCF_040790755.1_ASM4079075v1_genomic	NZ_CP161094.1	22171	22744	573	renamed_GCF_000008685.2	cp32-9	22183	22723	573	93.6	8.876e-111
GCF_040790755.1_ASM4079075v1_genomic	NZ_CP161104.1	600	1599	999	renamed_GCF_000008685.2	lp36	34079	33080	999	99.0	1.212e-212
GCF_040790755.1_ASM4079075v1_genomic	NZ_CP161104.1	1853	2840	987	renamed_GCF_000008685.2	lp36	30463	29476	987	98.7	2.847e-218
GCF_040790755.1_ASM4079075v1_genomic	NZ_CP161104.1	3104	3926	822	renamed_GCF_000008685.2	lp36	31585	30718	822	47.7	2.982e-66
GCF_040790755.1_ASM4079075v1_genomic	NZ_CP161104.1	4028	4934	906	renamed_GCF_000008685.2	lp36	28288	27382	906	97.0	4.857e-190
GCF_040790755.1_ASM4079075v1_genomic	NZ_CP161104.1	7127	7349	222	renamed_GCF_000008685.2	lp17	3651	3819	222	100.0	6.565e-33
GCF_040790755.1_ASM4079075v1_genomic	NZ_CP161103.1	4239	423	3816	renamed_GCF_000008685.2	lp28-3	7728	3891	3816	84.5	0.0
GCF_040790755.1_ASM4079075v1_genomic	NZ_CP161103.1	6684	7548	864	renamed_GCF_000008685.2	lp25	6897	7761	864	98.9	9.409e-193
GCF_040790755.1_ASM4079075v1_genomic	NZ_CP161103.1	10000	9379	621	renamed_GCF_000008685.2	lp25	10187	9566	621	94.1	1.275e-131
GCF_040790755.1_ASM4079075v1_genomic	NZ_CP161103.1	10513	10012	501	renamed_GCF_000008685.2	lp25	10694	10199	501	81.0	1.053e-88
GCF_040790755.1_ASM4079075v1_genomic	NZ_CP161103.1	11884	11302	582	renamed_GCF_000008685.2	lp25	12079	11497	582	100.0	4.521e-128
GCF_040790755.1_ASM4079075v1_genomic	NZ_CP161103.1	12659	11900	759	renamed_GCF_000008685.2	lp25	12854	12095	759	100.0	2.255e-165
GCF_040790755.1_ASM4079075v1_genomic	NZ_CP161103.1	13198	12634	564	renamed_GCF_000008685.2	lp25	13393	12829	564	100.0	4.519e-125
GCF_040790755.1_ASM4079075v1_genomic	NZ_CP161098.1	13596	13257	339	renamed_GCF_000008685.2	lp28-2	13495	13156	339	100.0	3.422e-74
GCF_040790755.1_ASM4079075v1_genomic	NZ_CP161098.1	23118	22743	375	renamed_GCF_000008685.2	lp28-2	23033	22658	375	97.5	5.035e-76
GCF_040790755.1_ASM4079075v1_genomic	NZ_CP161098.1	23810	23117	693	renamed_GCF_000008685.2	lp28-2	23725	23032	693	98.2	1.216e-152
GCF_040790755.1_ASM4079075v1_genomic	NZ_CP161098.1	24181	23806	375	renamed_GCF_000008685.2	lp28-2	24108	23721	375	89.0	9.084e-70
GCF_040790755.1_ASM4079075v1_genomic	NZ_CP161098.1	24555	26025	1470	renamed_GCF_000008685.2	lp28-2	24488	25955	1470	92.6	2.069e-303
GCF_040790755.1_ASM4079075v1_genomic	NZ_CP161098.1	26049	26451	402	renamed_GCF_000008685.2	lp28-2	25979	26390	402	88.0	3.163e-77
GCF_040790755.1_ASM4079075v1_genomic	NZ_CP161098.1	26698	27127	429	renamed_GCF_000008685.2	lp28-2	26569	27085	429	94.3	6.173e-91
GCF_040790755.1_ASM4079075v1_genomic	NZ_CP161098.1	27159	27987	828	renamed_GCF_000008685.2	lp28-2	27112	27940	828	97.4	1.07e-176
GCF_040790755.1_ASM4079075v1_genomic	NZ_CP161098.1	28077	28791	714	renamed_GCF_000008685.2	lp28-2	28030	28831	714	87.9	8.759e-143
GCF_040790755.1_ASM4079075v1_genomic	NZ_CP161100.1	185	950	765	renamed_GCF_000008685.2	lp28-2	29618	28853	765	75.9	7.774e-127
GCF_040790755.1_ASM4079075v1_genomic	NZ_CP161100.1	23240	22487	753	renamed_GCF_000008685.2	lp28-4	21562	20770	753	98.3	1.223e-162
GCF_040790755.1_ASM4079075v1_genomic	NZ_CP161101.1	3984	4260	276	renamed_GCF_000008685.2	lp36	6365	6650	276	100.0	1.214e-58
GCF_040790755.1_ASM4079075v1_genomic	NZ_CP161101.1	4942	5707	765	renamed_GCF_000008685.2	lp36	6040	5287	765	85.4	1.193e-130
GCF_040790755.1_ASM4079075v1_genomic	NZ_CP161101.1	6469	5773	696	renamed_GCF_000008685.2	lp36	8859	8163	696	96.9	1.009e-146
GCF_040790755.1_ASM4079075v1_genomic	NZ_CP161101.1	6982	7381	399	renamed_GCF_000008685.2	lp36	9372	9999	399	99.1	1.114e-79
GCF_040790755.1_ASM4079075v1_genomic	NZ_CP161101.1	7911	9558	1647	renamed_GCF_000008685.2	lp36	10300	11947	1647	99.8	0.0
GCF_040790755.1_ASM4079075v1_genomic	NZ_CP161101.1	10212	10848	636	renamed_GCF_000008685.2	lp36	12601	13237	636	99.5	1.686e-139
GCF_040790755.1_ASM4079075v1_genomic	NZ_CP161101.1	11937	11187	750	renamed_GCF_000008685.2	lp36	14326	13576	750	99.5	5.248e-163
GCF_040790755.1_ASM4079075v1_genomic	NZ_CP161101.1	12452	11912	540	renamed_GCF_000008685.2	lp36	14841	14301	540	100.0	2.234e-120
GCF_040790755.1_ASM4079075v1_genomic	NZ_CP161093.1	20238	21468	1230	renamed_GCF_000008685.2	lp38	20000	21230	1230	99.7	3.323e-266
GCF_040790755.1_ASM4079075v1_genomic	NZ_CP161093.1	35794	35107	687	renamed_GCF_000008685.2	lp38	35591	34904	687	99.5	4.529e-154
GCF_040790755.1_ASM4079075v1_genomic	NZ_CP161093.1	36451	35836	615	renamed_GCF_000008685.2	lp38	36248	35633	615	98.5	1.541e-128
GCF_040790755.1_ASM4079075v1_genomic	NZ_CP161106.1	284	659	375	renamed_GCF_000008685.2	lp5	263	638	375	100.0	1.385e-81
GCF_040790755.1_ASM4079075v1_genomic	NZ_CP161106.1	764	1118	354	renamed_GCF_000008685.2	lp5	743	1097	354	100.0	7.233e-77
GCF_040790755.1_ASM4079075v1_genomic	NZ_CP161106.1	1228	1597	369	renamed_GCF_000008685.2	lp5	1207	1576	369	99.1	3.085e-80
GCF_040790755.1_ASM4079075v1_genomic	NZ_CP161106.1	2168	3278	1110	renamed_GCF_000008685.2	lp5	2147	3254	1110	99.4	4.535e-251
GCF_040790755.1_ASM4079075v1_genomic	NZ_CP161092.1	15370	15802	432	renamed_GCF_000008685.2	lp54	15369	15801	432	98.6	8.873e-96
GCF_040790755.1_ASM4079075v1_genomic	NZ_CP161092.1	16586	16001	585	renamed_GCF_000008685.2	lp54	16576	16000	585	77.0	4.229e-87
GCF_040790755.1_ASM4079075v1_genomic	NZ_CP161092.1	17269	16705	564	renamed_GCF_000008685.2	lp54	17259	16695	564	100.0	1.065e-115
GCF_040790755.1_ASM4079075v1_genomic	NZ_CP161092.1	18137	18731	594	renamed_GCF_000008685.2	lp54	18127	18721	594	99.4	7.271e-125
GCF_040790755.1_ASM4079075v1_genomic	NZ_CP161092.1	18734	20087	1353	renamed_GCF_000008685.2	lp54	18724	20077	1353	100.0	1.524e-304
GCF_040790755.1_ASM4079075v1_genomic	NZ_CP161092.1	20770	20965	195	renamed_GCF_000008685.2	lp54	20717	20912	195	100.0	2.214e-39
GCF_040790755.1_ASM4079075v1_genomic	NZ_CP161092.1	21139	21679	540	renamed_GCF_000008685.2	lp54	21086	21626	540	99.4	1.96e-113
GCF_040790755.1_ASM4079075v1_genomic	NZ_CP161092.1	23326	21736	1590	renamed_GCF_000008685.2	lp54	23273	21683	1590	99.6	0.0
GCF_040790755.1_ASM4079075v1_genomic	NZ_CP161092.1	23829	24468	639	renamed_GCF_000008685.2	lp54	23776	24415	639	100.0	9.606e-138
GCF_040790755.1_ASM4079075v1_genomic	NZ_CP161092.1	49443	48651	792	renamed_GCF_000008685.2	lp54	48267	47475	792	99.6	4.799e-171
GCF_040790755.1_ASM4079075v1_genomic	NZ_CP161091.1	80844	81270	426	renamed_GCF_000008685.2	chromosome	80982	81408	426	98.5	2.913e-90
GCF_040790755.1_ASM4079075v1_genomic	NZ_CP161091.1	81266	82802	1536	renamed_GCF_000008685.2	chromosome	81404	82940	1536	99.8	0.0
GCF_040790755.1_ASM4079075v1_genomic	NZ_CP161091.1	83782	82831	951	renamed_GCF_000008685.2	chromosome	83920	82969	951	99.6	3.736e-209
GCF_040790755.1_ASM4079075v1_genomic	NZ_CP161091.1	85582	83902	1680	renamed_GCF_000008685.2	chromosome	85720	84040	1680	100.0	0.0
GCF_040790755.1_ASM4079075v1_genomic	NZ_CP161091.1	86716	85741	975	renamed_GCF_000008685.2	chromosome	86854	85879	975	99.6	4.354e-220
GCF_040790755.1_ASM4079075v1_genomic	NZ_CP161091.1	87222	86787	435	renamed_GCF_000008685.2	chromosome	87360	86925	435	100.0	2.772e-92
GCF_040790755.1_ASM4079075v1_genomic	NZ_CP161091.1	89670	89061	609	renamed_GCF_000008685.2	chromosome	89808	89199	609	99.5	2.836e-129
GCF_040790755.1_ASM4079075v1_genomic	NZ_CP161091.1	90977	89672	1305	renamed_GCF_000008685.2	chromosome	91115	89810	1305	100.0	2.863e-289
GCF_040790755.1_ASM4079075v1_genomic	NZ_CP161091.1	129993	127287	2706	renamed_GCF_000008685.2	chromosome	130132	127426	2706	99.4	0.0
GCF_040790755.1_ASM4079075v1_genomic	NZ_CP161091.1	133703	132332	1371	renamed_GCF_000008685.2	chromosome	133842	132471	1371	100.0	2.422e-302
GCF_040790755.1_ASM4079075v1_genomic	NZ_CP161091.1	137627	135734	1893	renamed_GCF_000008685.2	chromosome	137766	135873	1893	99.8	0.0
GCF_040790755.1_ASM4079075v1_genomic	NZ_CP161091.1	142799	141845	954	renamed_GCF_000008685.2	chromosome	142932	141978	954	99.3	1.665e-201
GCF_040790755.1_ASM4079075v1_genomic	NZ_CP161091.1	145325	144452	873	renamed_GCF_000008685.2	chromosome	145458	144585	873	98.6	7.464e-197
GCF_040790755.1_ASM4079075v1_genomic	NZ_CP161091.1	158483	159200	717	renamed_GCF_000008685.2	chromosome	158627	159344	717	97.0	3.592e-153
GCF_040790755.1_ASM4079075v1_genomic	NZ_CP161091.1	159945	161064	1119	renamed_GCF_000008685.2	chromosome	160089	161208	1119	99.7	1.16e-250
GCF_040790755.1_ASM4079075v1_genomic	NZ_CP161091.1	162733	162901	168	renamed_GCF_000008685.2	chromosome	162877	163045	168	100.0	5.294e-34
GCF_040790755.1_ASM4079075v1_genomic	NZ_CP161091.1	206413	207964	1551	renamed_GCF_000008685.2	chromosome	206528	208106	1551	99.8	0.0
GCF_040790755.1_ASM4079075v1_genomic	NZ_CP161091.1	224183	223361	822	renamed_GCF_000008685.2	chromosome	224785	223963	822	100.0	3.638e-179
GCF_040790755.1_ASM4079075v1_genomic	NZ_CP161091.1	227226	226008	1218	renamed_GCF_000008685.2	chromosome	227827	226609	1218	99.5	1.492e-264
GCF_040790755.1_ASM4079075v1_genomic	NZ_CP161091.1	230890	229612	1278	renamed_GCF_000008685.2	chromosome	231491	230213	1278	100.0	4.58e-288
GCF_040790755.1_ASM4079075v1_genomic	NZ_CP161091.1	231019	231721	702	renamed_GCF_000008685.2	chromosome	231620	232322	702	99.1	2.837e-153
GCF_040790755.1_ASM4079075v1_genomic	NZ_CP161091.1	244778	244175	603	renamed_GCF_000008685.2	chromosome	245382	244776	603	99.5	7.936e-134
GCF_040790755.1_ASM4079075v1_genomic	NZ_CP161091.1	245995	247501	1506	renamed_GCF_000008685.2	chromosome	246596	248102	1506	100.0	0.0
GCF_040790755.1_ASM4079075v1_genomic	NZ_CP161091.1	250069	249574	495	renamed_GCF_000008685.2	chromosome	250670	250175	495	100.0	5.051e-104
GCF_040790755.1_ASM4079075v1_genomic	NZ_CP161091.1	289300	288958	342	renamed_GCF_000008685.2	chromosome	289917	289575	342	100.0	1.077e-70
GCF_040790755.1_ASM4079075v1_genomic	NZ_CP161091.1	299098	298177	921	renamed_GCF_000008685.2	chromosome	299715	298794	921	99.3	1.132e-191
GCF_040790755.1_ASM4079075v1_genomic	NZ_CP161091.1	301872	300162	1710	renamed_GCF_000008685.2	chromosome	302489	300779	1710	99.8	0.0
GCF_040790755.1_ASM4079075v1_genomic	NZ_CP161091.1	302692	302233	459	renamed_GCF_000008685.2	chromosome	303309	302850	459	100.0	4.601e-99
GCF_040790755.1_ASM4079075v1_genomic	NZ_CP161091.1	304503	303156	1347	renamed_GCF_000008685.2	chromosome	305120	303773	1347	100.0	1.016e-290
GCF_040790755.1_ASM4079075v1_genomic	NZ_CP161091.1	306000	305052	948	renamed_GCF_000008685.2	chromosome	306615	305670	948	98.4	2.119e-206
GCF_040790755.1_ASM4079075v1_genomic	NZ_CP161091.1	317388	316629	759	renamed_GCF_000008685.2	chromosome	318005	317246	759	99.6	6.045e-163
GCF_040790755.1_ASM4079075v1_genomic	NZ_CP161091.1	319019	318488	531	renamed_GCF_000008685.2	chromosome	319636	319105	531	100.0	1.699e-113
GCF_040790755.1_ASM4079075v1_genomic	NZ_CP161091.1	319691	320735	1044	renamed_GCF_000008685.2	chromosome	320308	321352	1044	99.7	6.693e-227
GCF_040790755.1_ASM4079075v1_genomic	NZ_CP161091.1	322229	321422	807	renamed_GCF_000008685.2	chromosome	322846	322039	807	98.8	5.036e-173
GCF_040790755.1_ASM4079075v1_genomic	NZ_CP161091.1	384834	385548	714	renamed_GCF_000008685.2	chromosome	385448	386162	714	100.0	3.427e-153
GCF_040790755.1_ASM4079075v1_genomic	NZ_CP161091.1	385544	386723	1179	renamed_GCF_000008685.2	chromosome	386158	387337	1179	100.0	1.981e-263
GCF_040790755.1_ASM4079075v1_genomic	NZ_CP161091.1	386719	387193	474	renamed_GCF_000008685.2	chromosome	387333	387807	474	100.0	1.339e-106
GCF_040790755.1_ASM4079075v1_genomic	NZ_CP161091.1	387866	387203	663	renamed_GCF_000008685.2	chromosome	388480	387817	663	98.1	2.965e-146
GCF_040790755.1_ASM4079075v1_genomic	NZ_CP161091.1	388312	387892	420	renamed_GCF_000008685.2	chromosome	388926	388506	420	100.0	9.787e-93
GCF_040790755.1_ASM4079075v1_genomic	NZ_CP161091.1	389727	388362	1365	renamed_GCF_000008685.2	chromosome	390341	388976	1365	99.3	3.579e-288
GCF_040790755.1_ASM4079075v1_genomic	NZ_CP161091.1	391205	389780	1425	renamed_GCF_000008685.2	chromosome	391819	390391	1425	99.7	0.0
GCF_040790755.1_ASM4079075v1_genomic	NZ_CP161091.1	392343	391317	1026	renamed_GCF_000008685.2	chromosome	392957	391931	1026	98.8	1.626e-222
GCF_040790755.1_ASM4079075v1_genomic	NZ_CP161091.1	393449	392429	1020	renamed_GCF_000008685.2	chromosome	394063	393043	1020	99.4	1.624e-221
GCF_040790755.1_ASM4079075v1_genomic	NZ_CP161091.1	407286	406731	555	renamed_GCF_000008685.2	chromosome	407898	407343	555	100.0	5.734e-121
GCF_040790755.1_ASM4079075v1_genomic	NZ_CP161091.1	407768	407588	180	renamed_GCF_000008685.2	chromosome	408380	408200	180	100.0	2.118e-37
GCF_040790755.1_ASM4079075v1_genomic	NZ_CP161091.1	408790	407941	849	renamed_GCF_000008685.2	chromosome	409402	408553	849	100.0	9.834e-190
GCF_040790755.1_ASM4079075v1_genomic	NZ_CP161091.1	409835	408803	1032	renamed_GCF_000008685.2	chromosome	410447	409415	1032	99.4	1.191e-235
GCF_040790755.1_ASM4079075v1_genomic	NZ_CP161091.1	410173	410833	660	renamed_GCF_000008685.2	chromosome	410786	411446	660	97.7	2.706e-138
GCF_040790755.1_ASM4079075v1_genomic	NZ_CP161091.1	412387	410842	1545	renamed_GCF_000008685.2	chromosome	413006	411455	1545	99.4	0.0
GCF_040790755.1_ASM4079075v1_genomic	NZ_CP161091.1	412499	413708	1209	renamed_GCF_000008685.2	chromosome	413112	414315	1209	99.7	3.463e-262
GCF_040790755.1_ASM4079075v1_genomic	NZ_CP161091.1	415180	413713	1467	renamed_GCF_000008685.2	chromosome	415793	414326	1467	99.1	0.0
GCF_040790755.1_ASM4079075v1_genomic	NZ_CP161091.1	415910	415232	678	renamed_GCF_000008685.2	chromosome	416478	415845	678	99.0	1.108e-142
GCF_040790755.1_ASM4079075v1_genomic	NZ_CP161091.1	416075	416492	417	renamed_GCF_000008685.2	chromosome	416688	417105	417	100.0	1.248e-89
GCF_040790755.1_ASM4079075v1_genomic	NZ_CP161091.1	426128	427343	1215	renamed_GCF_000008685.2	chromosome	426735	427950	1215	99.5	1.876e-261
GCF_040790755.1_ASM4079075v1_genomic	NZ_CP161091.1	427379	428015	636	renamed_GCF_000008685.2	chromosome	427986	428622	636	99.5	1.686e-139
GCF_040790755.1_ASM4079075v1_genomic	NZ_CP161091.1	428038	429067	1029	renamed_GCF_000008685.2	chromosome	428645	429674	1029	99.7	8.604e-239
GCF_040790755.1_ASM4079075v1_genomic	NZ_CP161091.1	430003	429085	918	renamed_GCF_000008685.2	chromosome	430616	429692	918	98.6	5.143e-200
GCF_040790755.1_ASM4079075v1_genomic	NZ_CP161091.1	434496	430011	4485	renamed_GCF_000008685.2	chromosome	435103	430618	4485	99.4	0.0
GCF_040790755.1_ASM4079075v1_genomic	NZ_CP161091.1	441946	441106	840	renamed_GCF_000008685.2	chromosome	442552	441712	840	98.5	3.646e-182
GCF_040790755.1_ASM4079075v1_genomic	NZ_CP161091.1	442639	442078	561	renamed_GCF_000008685.2	chromosome	443248	442687	561	99.4	1.054e-123
GCF_040790755.1_ASM4079075v1_genomic	NZ_CP161091.1	446262	445713	549	renamed_GCF_000008685.2	chromosome	446875	446326	549	98.3	5.212e-121
GCF_040790755.1_ASM4079075v1_genomic	NZ_CP161091.1	447031	446356	675	renamed_GCF_000008685.2	chromosome	447736	446968	675	99.5	9.618e-144
GCF_040790755.1_ASM4079075v1_genomic	NZ_CP161091.1	447242	447560	318	renamed_GCF_000008685.2	chromosome	447854	448172	318	100.0	8.883e-69
GCF_040790755.1_ASM4079075v1_genomic	NZ_CP161091.1	459303	459459	156	renamed_GCF_000008685.2	chromosome	459915	460071	156	100.0	2.965e-30
GCF_040790755.1_ASM4079075v1_genomic	NZ_CP161091.1	869181	868665	516	renamed_GCF_000008685.2	chromosome	870023	869507	516	99.4	3.605e-111
GCF_040790755.1_ASM4079075v1_genomic	NZ_CP161091.1	871741	869269	2472	renamed_GCF_000008685.2	chromosome	872583	870111	2472	99.8	0.0
GCF_040790755.1_ASM4079075v1_genomic	NZ_CP161091.1	874290	871743	2547	renamed_GCF_000008685.2	chromosome	875132	872585	2547	99.8	0.0
GCF_040790755.1_ASM4079075v1_genomic	NZ_CP161091.1	874364	875606	1242	renamed_GCF_000008685.2	chromosome	875206	876448	1242	98.5	1.457e-277
GCF_040790755.1_ASM4079075v1_genomic	NZ_CP161091.1	875586	878439	2853	renamed_GCF_000008685.2	chromosome	876491	879281	2853	99.2	0.0
GCF_040790755.1_ASM4079075v1_genomic	NZ_CP161091.1	878472	879408	936	renamed_GCF_000008685.2	chromosome	879314	880250	936	100.0	3.242e-208
GCF_040790755.1_ASM4079075v1_genomic	NZ_CP161091.1	880249	879424	825	renamed_GCF_000008685.2	chromosome	881091	880266	825	98.9	1.563e-180
GCF_040790755.1_ASM4079075v1_genomic	NZ_CP161091.1	883384	880813	2571	renamed_GCF_000008685.2	chromosome	884213	881084	2571	99.5	0.0
GCF_040790755.1_ASM4079075v1_genomic	NZ_CP161091.1	901007	902432	1425	renamed_GCF_000008685.2	chromosome	901833	903258	1425	99.3	1.454e-308
GCF_040790755.1_ASM4079075v1_genomic	NZ_CP161102.1	21380	20873	507	renamed_GCF_000008685.2	cp26	21364	20857	507	100.0	3.123e-111
GCF_040790755.1_ASM4079075v1_genomic	NZ_CP161102.1	21840	21354	486	renamed_GCF_000008685.2	cp26	21833	21338	486	100.0	3.279e-107
GCF_040790755.1_ASM4079075v1_genomic	NZ_CP161102.1	21913	22609	696	renamed_GCF_000008685.2	cp26	21897	22593	696	99.1	3.423e-150
GCF_040790755.1_ASM4079075v1_genomic	NZ_CP161102.1	23170	22618	552	renamed_GCF_000008685.2	cp26	23154	22602	552	100.0	6.015e-120
GCF_040790755.1_ASM4079075v1_genomic	NZ_CP161102.1	23586	24516	930	renamed_GCF_000008685.2	cp26	23254	24499	930	99.6	1.328e-208
GCF_040790755.1_ASM4079075v1_genomic	NZ_CP161102.1	24841	26470	1629	renamed_GCF_000008685.2	cp26	24824	26453	1629	99.8	0.0
GCF_040790755.1_ASM4079075v1_genomic	NZ_CP161096.1	16142	16496	354	renamed_GCF_000008685.2	lp56	19584	19938	354	100.0	1.459e-77
GCF_040790755.1_ASM4079075v1_genomic	NZ_CP161096.1	17335	17968	633	renamed_GCF_000008685.2	lp56	20843	21455	633	75.2	4.784e-102
GCF_040790755.1_ASM4079075v1_genomic	NZ_CP161096.1	18996	18048	948	renamed_GCF_000008685.2	cp32-6	18680	17732	948	97.7	4.979e-214
GCF_040790755.1_ASM4079075v1_genomic	NZ_CP161096.1	21040	21781	741	renamed_GCF_000008685.2	cp32-1	20765	21506	741	100.0	1.112e-161
GCF_040790755.1_ASM4079075v1_genomic	NZ_CP161096.1	21835	22393	558	renamed_GCF_000008685.2	cp32-1	21560	22118	558	99.4	3.272e-119
GCF_040790755.1_ASM4079075v1_genomic	NZ_CP161097.1	2015	2573	558	renamed_GCF_000008685.2	cp32-1	2010	2568	558	94.5	4.355e-116
GCF_040790755.1_ASM4079075v1_genomic	NZ_CP161097.1	2579	3344	765	renamed_GCF_000008685.2	cp32-7	2573	3338	765	98.8	1.703e-169
GCF_040790755.1_ASM4079075v1_genomic	NZ_CP161097.1	3967	4927	960	renamed_GCF_000008685.2	cp32-1	3962	4922	960	99.3	1.607e-211
GCF_040790755.1_ASM4079075v1_genomic	NZ_CP161097.1	5401	5785	384	renamed_GCF_000008685.2	cp32-6	5403	5787	384	100.0	2.931e-83
GCF_040790755.1_ASM4079075v1_genomic	NZ_CP161097.1	5772	6162	390	renamed_GCF_000008685.2	cp32-6	5774	6164	390	98.4	1.6e-82
GCF_040790755.1_ASM4079075v1_genomic	NZ_CP161097.1	6158	6728	570	renamed_GCF_000008685.2	cp32-6	6160	6730	570	98.4	5.468e-124
GCF_040790755.1_ASM4079075v1_genomic	NZ_CP161097.1	6708	7821	1113	renamed_GCF_000008685.2	cp32-7	6702	7815	1113	98.6	2.015e-243
GCF_040790755.1_ASM4079075v1_genomic	NZ_CP161097.1	20940	21696	756	renamed_GCF_000008685.2	lp56	24517	25273	756	99.6	5.251e-164
GCF_040790755.1_ASM4079075v1_genomic	NZ_CP161097.1	22312	22819	507	renamed_GCF_000008685.2	lp56	25889	26426	507	93.8	2.496e-105
GCF_040790755.1_ASM4079075v1_genomic	NZ_CP161097.1	27542	28070	528	renamed_GCF_000008685.2	cp32-4	27675	28203	528	89.7	7.038e-106
GCF_040790755.1_ASM4079075v1_genomic	NZ_CP161095.1	20734	21499	765	renamed_GCF_000008685.2	lp28-1	13793	13028	765	73.1	1.193e-130
GCF_040790755.1_ASM4079075v1_genomic	NZ_CP161095.1	21526	22087	561	renamed_GCF_000008685.2	cp32-4	21414	21960	561	66.1	6.238e-79
GCF_040790755.1_ASM4079075v1_genomic	NZ_CP161095.1	25689	24912	777	renamed_GCF_000008685.2	cp32-7	25720	24943	777	100.0	1.414e-173
GCF_040790755.1_ASM4079075v1_genomic	NZ_CP161095.1	26119	26746	627	renamed_GCF_000008685.2	cp32-3	26707	27298	627	64.7	8.244e-78
GCF_040790755.1_ASM4079075v1_genomic	NZ_CP161095.1	26857	27367	510	renamed_GCF_000008685.2	cp32-3	27409	27919	510	99.4	1.964e-108
GCF_040790755.1_ASM4079075v1_genomic	NZ_CP161095.1	28959	30312	1353	renamed_GCF_000008685.2	cp32-8	29532	30885	1353	99.3	1.524e-304
GCF_040790755.1_ASM4079075v1_genomic	NZ_CP161099.1	1305	1998	693	renamed_GCF_000008685.2	cp32-6	1305	1998	693	99.5	5.741e-144
GCF_040790755.1_ASM4079075v1_genomic	NZ_CP161099.1	2009	2573	564	renamed_GCF_000008685.2	cp32-4	2012	2576	564	99.4	1.105e-123
GCF_040790755.1_ASM4079075v1_genomic	NZ_CP161099.1	2576	3344	768	renamed_GCF_000008685.2	cp32-6	2576	3344	768	98.8	8.033e-170
GCF_040790755.1_ASM4079075v1_genomic	NZ_CP161099.1	3372	3948	576	renamed_GCF_000008685.2	cp32-6	3372	3948	576	99.4	1.005e-126
GCF_040790755.1_ASM4079075v1_genomic	NZ_CP161099.1	3969	4929	960	renamed_GCF_000008685.2	cp32-6	3969	4929	960	100.0	6.008e-214
GCF_040790755.1_ASM4079075v1_genomic	NZ_CP161099.1	11927	12473	546	renamed_GCF_000008685.2	cp32-1	11919	12465	546	97.7	2.156e-113
GCF_040790755.1_ASM4079075v1_genomic	NZ_CP161099.1	27701	28268	567	renamed_GCF_000008685.2	cp32-7	28884	29451	567	100.0	5.734e-123
GCF_040790755.1_ASM4079075v1_genomic	NZ_CP161099.1	28264	29617	1353	renamed_GCF_000008685.2	cp32-6	28485	29838	1353	99.1	3.386e-304
GCF_040790755.1_ASM4079075v1_genomic	NZ_CP161094.1	1306	1999	693	renamed_GCF_000008685.2	lp56	35114	35807	693	97.8	3.424e-141
GCF_040790755.1_ASM4079075v1_genomic	NZ_CP161094.1	4944	5400	456	renamed_GCF_000008685.2	cp32-7	4940	5396	456	97.3	2.901e-95
GCF_040790755.1_ASM4079075v1_genomic	NZ_CP161094.1	5770	6160	390	renamed_GCF_000008685.2	cp32-1	5767	6157	390	100.0	3.229e-83
GCF_040790755.1_ASM4079075v1_genomic	NZ_CP161094.1	6156	6723	567	renamed_GCF_000008685.2	lp56	9623	10190	567	98.9	1.159e-123
GCF_040790755.1_ASM4079075v1_genomic	NZ_CP161104.1	9991	9412	579	renamed_GCF_000008685.2	lp17	6452	5873	579	98.9	1.16e-125
GCF_040790755.1_ASM4079075v1_genomic	NZ_CP161104.1	11320	11647	327	renamed_GCF_000008685.2	lp17	7784	8111	327	99.0	2.291e-68
GCF_040790755.1_ASM4079075v1_genomic	NZ_CP161104.1	11802	12915	1113	renamed_GCF_000008685.2	lp17	8266	9379	1113	98.3	1.837e-244
GCF_040790755.1_ASM4079075v1_genomic	NZ_CP161104.1	13426	13132	294	renamed_GCF_000008685.2	lp17	9980	9590	294	93.7	7.322e-59
GCF_040790755.1_ASM4079075v1_genomic	NZ_CP161104.1	15185	14522	663	renamed_GCF_000008685.2	lp17	11646	10983	663	100.0	1.005e-149
GCF_040790755.1_ASM4079075v1_genomic	NZ_CP161104.1	17026	17767	741	renamed_GCF_000008685.2	lp17	13338	14079	741	99.5	7.64e-166
GCF_040790755.1_ASM4079075v1_genomic	NZ_CP161104.1	17757	18027	270	renamed_GCF_000008685.2	lp17	14069	14339	270	97.7	1.824e-53
GCF_040790755.1_ASM4079075v1_genomic	NZ_CP161104.1	19802	19571	231	renamed_GCF_000008685.2	lp17	16119	15888	231	98.6	8.774e-47
GCF_040790755.1_ASM4079075v1_genomic	NZ_CP161103.1	15383	14846	537	renamed_GCF_000008685.2	lp25	15545	15041	537	99.4	7.638e-115
GCF_040790755.1_ASM4079075v1_genomic	NZ_CP161098.1	14987	14477	510	renamed_GCF_000008685.2	lp28-2	14885	14375	510	97.0	1.069e-106
GCF_040790755.1_ASM4079075v1_genomic	NZ_CP161098.1	15533	14987	546	renamed_GCF_000008685.2	lp28-2	15431	14885	546	96.1	5.802e-111
GCF_040790755.1_ASM4079075v1_genomic	NZ_CP161098.1	16585	15559	1026	renamed_GCF_000008685.2	lp28-2	16482	15456	1026	98.5	2.275e-227
GCF_040790755.1_ASM4079075v1_genomic	NZ_CP161098.1	17787	16596	1191	renamed_GCF_000008685.2	lp28-2	17684	16493	1191	99.4	3.347e-268
GCF_040790755.1_ASM4079075v1_genomic	NZ_CP161098.1	18122	17783	339	renamed_GCF_000008685.2	lp28-2	18019	17680	339	99.1	2.521e-69
GCF_040790755.1_ASM4079075v1_genomic	NZ_CP161098.1	18912	18132	780	renamed_GCF_000008685.2	lp28-2	18827	18029	780	73.6	3.134e-122
GCF_040790755.1_ASM4079075v1_genomic	NZ_CP161098.1	19704	18921	783	renamed_GCF_000008685.2	lp28-2	19619	18836	783	80.7	3.91e-146
GCF_040790755.1_ASM4079075v1_genomic	NZ_CP161098.1	22395	19704	2691	renamed_GCF_000008685.2	lp28-2	22259	19619	2691	97.7	0.0
GCF_040790755.1_ASM4079075v1_genomic	NZ_CP161098.1	22744	22357	387	renamed_GCF_000008685.2	lp28-2	22659	22272	387	96.0	6.848e-83
GCF_040790755.1_ASM4079075v1_genomic	NZ_CP161100.1	1697	2141	444	renamed_GCF_000008685.2	lp28-3	1044	1368	444	82.6	6.903e-51
GCF_040790755.1_ASM4079075v1_genomic	NZ_CP161100.1	29346	28452	894	renamed_GCF_000008685.2	lp36	187	1081	894	98.6	8.951e-190
GCF_040790755.1_ASM4079075v1_genomic	NZ_CP161101.1	13884	14496	612	renamed_GCF_000008685.2	lp36	16274	16886	612	100.0	9.153e-134
GCF_040790755.1_ASM4079075v1_genomic	NZ_CP161093.1	4597	5518	921	renamed_GCF_000008685.2	lp38	4575	5496	921	99.3	1.905e-194
GCF_040790755.1_ASM4079075v1_genomic	NZ_CP161093.1	6178	6952	774	renamed_GCF_000008685.2	lp38	6088	6862	774	100.0	2.049e-160
GCF_040790755.1_ASM4079075v1_genomic	NZ_CP161093.1	9092	8798	294	renamed_GCF_000008685.2	lp38	9155	8876	294	93.4	2.701e-53
GCF_040790755.1_ASM4079075v1_genomic	NZ_CP161093.1	21460	22186	726	renamed_GCF_000008685.2	lp38	21222	21948	726	99.5	2.587e-158
GCF_040790755.1_ASM4079075v1_genomic	NZ_CP161092.1	634	1120	486	renamed_GCF_000008685.2	lp28-3	28197	27624	486	48.4	2.052e-45
GCF_040790755.1_ASM4079075v1_genomic	NZ_CP161092.1	1443	1953	510	renamed_GCF_000008685.2	lp54	1460	1970	510	100.0	8.829e-109
GCF_040790755.1_ASM4079075v1_genomic	NZ_CP161092.1	2877	2028	849	renamed_GCF_000008685.2	lp54	2893	2044	849	98.5	3.484e-184
GCF_040790755.1_ASM4079075v1_genomic	NZ_CP161092.1	4240	2986	1254	renamed_GCF_000008685.2	lp54	4256	3002	1254	100.0	3.245e-279
GCF_040790755.1_ASM4079075v1_genomic	NZ_CP161092.1	5124	4650	474	renamed_GCF_000008685.2	lp54	5140	4666	474	97.4	2.894e-98
GCF_040790755.1_ASM4079075v1_genomic	NZ_CP161092.1	5297	5633	336	renamed_GCF_000008685.2	lp54	5313	5649	336	100.0	1.784e-72
GCF_040790755.1_ASM4079075v1_genomic	NZ_CP161092.1	5629	6502	873	renamed_GCF_000008685.2	lp54	5645	6518	873	100.0	2.408e-192
GCF_040790755.1_ASM4079075v1_genomic	NZ_CP161092.1	6504	7131	627	renamed_GCF_000008685.2	lp54	6520	7147	627	99.0	1.16e-133
GCF_040790755.1_ASM4079075v1_genomic	NZ_CP161092.1	7192	8227	1035	renamed_GCF_000008685.2	lp54	7208	8243	1035	100.0	8.138e-232
GCF_040790755.1_ASM4079075v1_genomic	NZ_CP161092.1	25505	26747	1242	renamed_GCF_000008685.2	lp54	25467	26694	1242	99.7	3.331e-268
GCF_040790755.1_ASM4079075v1_genomic	NZ_CP161092.1	32775	32994	219	renamed_GCF_000008685.2	lp54	32741	32960	219	100.0	7.958e-46
GCF_040790755.1_ASM4079075v1_genomic	NZ_CP161092.1	34418	34982	564	renamed_GCF_000008685.2	lp54	34384	34948	564	99.4	3.599e-119
GCF_040790755.1_ASM4079075v1_genomic	NZ_CP161092.1	35021	35867	846	renamed_GCF_000008685.2	lp54	34987	35833	846	99.2	1.362e-185
GCF_040790755.1_ASM4079075v1_genomic	NZ_CP161092.1	35987	36263	276	renamed_GCF_000008685.2	lp54	35953	36229	276	100.0	3.31e-56
GCF_040790755.1_ASM4079075v1_genomic	NZ_CP161092.1	36301	36568	267	renamed_GCF_000008685.2	lp54	36255	36534	267	98.8	1.568e-54
GCF_040790755.1_ASM4079075v1_genomic	NZ_CP161092.1	39439	38194	1245	renamed_GCF_000008685.2	lp54	39405	38160	1245	99.7	1.088e-272
GCF_040790755.1_ASM4079075v1_genomic	NZ_CP161091.1	15376	14755	621	renamed_GCF_000008685.2	chromosome	15345	14724	621	99.5	1.607e-137
GCF_040790755.1_ASM4079075v1_genomic	NZ_CP161091.1	16025	16835	810	renamed_GCF_000008685.2	chromosome	15994	16804	810	100.0	1.068e-173
GCF_040790755.1_ASM4079075v1_genomic	NZ_CP161091.1	21974	20930	1044	renamed_GCF_000008685.2	chromosome	22101	21057	1044	100.0	6.693e-227
GCF_040790755.1_ASM4079075v1_genomic	NZ_CP161091.1	22691	23831	1140	renamed_GCF_000008685.2	chromosome	22818	23958	1140	97.8	1.874e-257
GCF_040790755.1_ASM4079075v1_genomic	NZ_CP161091.1	24569	23837	732	renamed_GCF_000008685.2	chromosome	24696	23964	732	100.0	2.844e-158
GCF_040790755.1_ASM4079075v1_genomic	NZ_CP161091.1	25625	26264	639	renamed_GCF_000008685.2	chromosome	25752	26391	639	100.0	1.211e-143
GCF_040790755.1_ASM4079075v1_genomic	NZ_CP161091.1	27738	27306	432	renamed_GCF_000008685.2	chromosome	27865	27433	432	98.6	1.441e-90
GCF_040790755.1_ASM4079075v1_genomic	NZ_CP161091.1	29345	28364	981	renamed_GCF_000008685.2	chromosome	29472	28491	981	100.0	8.047e-223
GCF_040790755.1_ASM4079075v1_genomic	NZ_CP161091.1	30893	31352	459	renamed_GCF_000008685.2	chromosome	31026	31479	459	99.3	5.582e-97
GCF_040790755.1_ASM4079075v1_genomic	NZ_CP161091.1	56621	56153	468	renamed_GCF_000008685.2	chromosome	56748	56280	468	98.7	9.748e-101
GCF_040790755.1_ASM4079075v1_genomic	NZ_CP161091.1	57131	57848	717	renamed_GCF_000008685.2	chromosome	57258	57975	717	99.1	7.269e-154
GCF_040790755.1_ASM4079075v1_genomic	NZ_CP161091.1	58909	57901	1008	renamed_GCF_000008685.2	chromosome	58982	58028	1008	99.0	6.479e-204
GCF_040790755.1_ASM4079075v1_genomic	NZ_CP161091.1	60405	59907	498	renamed_GCF_000008685.2	chromosome	60533	60035	498	98.7	8.026e-108
GCF_040790755.1_ASM4079075v1_genomic	NZ_CP161091.1	63018	63900	882	renamed_GCF_000008685.2	chromosome	63146	64028	882	99.6	6.762e-191
GCF_040790755.1_ASM4079075v1_genomic	NZ_CP161091.1	65162	65624	462	renamed_GCF_000008685.2	chromosome	65290	65752	462	100.0	3.193e-95
GCF_040790755.1_ASM4079075v1_genomic	NZ_CP161091.1	67119	69441	2322	renamed_GCF_000008685.2	chromosome	67247	69569	2322	99.0	0.0
GCF_040790755.1_ASM4079075v1_genomic	NZ_CP161091.1	70242	71091	849	renamed_GCF_000008685.2	chromosome	70141	71219	849	98.9	5.332e-188
GCF_040790755.1_ASM4079075v1_genomic	NZ_CP161091.1	72518	73364	846	renamed_GCF_000008685.2	chromosome	72646	73492	846	99.2	6.38e-177
GCF_040790755.1_ASM4079075v1_genomic	NZ_CP161091.1	118791	118236	555	renamed_GCF_000008685.2	chromosome	118929	118374	555	99.4	3.776e-117
GCF_040790755.1_ASM4079075v1_genomic	NZ_CP161091.1	120451	119668	783	renamed_GCF_000008685.2	chromosome	120589	119806	783	100.0	5.024e-169
GCF_040790755.1_ASM4079075v1_genomic	NZ_CP161091.1	147362	146243	1119	renamed_GCF_000008685.2	chromosome	147495	146376	1119	100.0	3.727e-246
GCF_040790755.1_ASM4079075v1_genomic	NZ_CP161091.1	152060	152867	807	renamed_GCF_000008685.2	chromosome	152205	153012	807	98.8	2.384e-181
GCF_040790755.1_ASM4079075v1_genomic	NZ_CP161091.1	156255	153555	2700	renamed_GCF_000008685.2	chromosome	156400	153700	2700	99.8	0.0
GCF_040790755.1_ASM4079075v1_genomic	NZ_CP161091.1	157482	157917	435	renamed_GCF_000008685.2	chromosome	157626	158061	435	99.3	1.372e-91
GCF_040790755.1_ASM4079075v1_genomic	NZ_CP161091.1	170954	170576	378	renamed_GCF_000008685.2	chromosome	171097	170719	378	100.0	1.603e-80
GCF_040790755.1_ASM4079075v1_genomic	NZ_CP161091.1	173437	171388	2049	renamed_GCF_000008685.2	chromosome	173535	171531	2049	99.2	0.0
GCF_040790755.1_ASM4079075v1_genomic	NZ_CP161091.1	173973	173385	588	renamed_GCF_000008685.2	chromosome	174116	173528	588	100.0	1.529e-132
GCF_040790755.1_ASM4079075v1_genomic	NZ_CP161091.1	176831	175925	906	renamed_GCF_000008685.2	chromosome	176974	176068	906	99.0	3.676e-193
GCF_040790755.1_ASM4079075v1_genomic	NZ_CP161091.1	178717	177724	993	renamed_GCF_000008685.2	chromosome	178860	177867	993	100.0	4.528e-214
GCF_040790755.1_ASM4079075v1_genomic	NZ_CP161091.1	189133	188932	201	renamed_GCF_000008685.2	chromosome	189276	189075	201	98.4	4.922e-40
GCF_040790755.1_ASM4079075v1_genomic	NZ_CP161091.1	189933	190587	654	renamed_GCF_000008685.2	chromosome	190186	190717	654	99.4	1.404e-110
GCF_040790755.1_ASM4079075v1_genomic	NZ_CP161091.1	192197	191387	810	renamed_GCF_000008685.2	chromosome	192327	191517	810	99.6	2.276e-182
GCF_040790755.1_ASM4079075v1_genomic	NZ_CP161091.1	194745	195606	861	renamed_GCF_000008685.2	chromosome	194875	195736	861	98.2	1.891e-184
GCF_040790755.1_ASM4079075v1_genomic	NZ_CP161091.1	241836	243402	1566	renamed_GCF_000008685.2	chromosome	242437	244003	1566	98.4	0.0
GCF_040790755.1_ASM4079075v1_genomic	NZ_CP161091.1	273030	272025	1005	renamed_GCF_000008685.2	chromosome	273647	272633	1005	96.7	5.458e-214
GCF_040790755.1_ASM4079075v1_genomic	NZ_CP161091.1	275879	274625	1254	renamed_GCF_000008685.2	chromosome	276496	275242	1254	99.2	2.7e-281
GCF_040790755.1_ASM4079075v1_genomic	NZ_CP161091.1	277942	276472	1470	renamed_GCF_000008685.2	chromosome	278559	277089	1470	99.7	1.976e-321
GCF_040790755.1_ASM4079075v1_genomic	NZ_CP161091.1	278763	278460	303	renamed_GCF_000008685.2	chromosome	279380	279077	303	99.0	2.307e-64
GCF_040790755.1_ASM4079075v1_genomic	NZ_CP161091.1	281176	280696	480	renamed_GCF_000008685.2	chromosome	281793	281313	480	98.7	5.307e-101
GCF_040790755.1_ASM4079075v1_genomic	NZ_CP161091.1	292591	291808	783	renamed_GCF_000008685.2	chromosome	293208	292425	783	100.0	6.057e-167
GCF_040790755.1_ASM4079075v1_genomic	NZ_CP161091.1	294163	292834	1329	renamed_GCF_000008685.2	chromosome	294780	293451	1329	99.7	1.183e-294
GCF_040790755.1_ASM4079075v1_genomic	NZ_CP161091.1	295803	294624	1179	renamed_GCF_000008685.2	chromosome	296420	295241	1179	98.9	1.413e-258
GCF_040790755.1_ASM4079075v1_genomic	NZ_CP161091.1	296428	295810	618	renamed_GCF_000008685.2	chromosome	297045	296427	618	99.5	5.47e-132
GCF_040790755.1_ASM4079075v1_genomic	NZ_CP161091.1	350714	350438	276	renamed_GCF_000008685.2	chromosome	351331	351055	276	95.6	4.486e-53
GCF_040790755.1_ASM4079075v1_genomic	NZ_CP161091.1	354022	352822	1200	renamed_GCF_000008685.2	chromosome	354636	353439	1200	98.7	3.302e-261
GCF_040790755.1_ASM4079075v1_genomic	NZ_CP161091.1	354876	356295	1419	renamed_GCF_000008685.2	chromosome	355490	356909	1419	98.9	9.19e-313
GCF_040790755.1_ASM4079075v1_genomic	NZ_CP161091.1	357843	358584	741	renamed_GCF_000008685.2	chromosome	358457	359198	741	99.1	2.251e-162
GCF_040790755.1_ASM4079075v1_genomic	NZ_CP161091.1	105707	105278	429	renamed_GCF_000008685.2	chromosome	105846	105417	429	99.2	1.514e-89
GCF_040790755.1_ASM4079075v1_genomic	NZ_CP161091.1	108031	106834	1197	renamed_GCF_000008685.2	chromosome	108170	106973	1197	99.2	2.049e-257
GCF_040790755.1_ASM4079075v1_genomic	NZ_CP161091.1	108167	109532	1365	renamed_GCF_000008685.2	chromosome	108306	109671	1365	99.7	2.146e-311
GCF_040790755.1_ASM4079075v1_genomic	NZ_CP161091.1	111428	110906	522	renamed_GCF_000008685.2	chromosome	111567	111045	522	100.0	1.783e-111
GCF_040790755.1_ASM4079075v1_genomic	NZ_CP161091.1	112199	111749	450	renamed_GCF_000008685.2	chromosome	112338	111888	450	100.0	4.387e-98
GCF_040790755.1_ASM4079075v1_genomic	NZ_CP161091.1	122352	121740	612	renamed_GCF_000008685.2	chromosome	122491	121879	612	98.5	7.99e-127
GCF_040790755.1_ASM4079075v1_genomic	NZ_CP161091.1	164676	162927	1749	renamed_GCF_000008685.2	chromosome	164820	163071	1749	99.4	0.0
GCF_040790755.1_ASM4079075v1_genomic	NZ_CP161091.1	167615	165770	1845	renamed_GCF_000008685.2	chromosome	167759	165914	1845	99.3	0.0
GCF_040790755.1_ASM4079075v1_genomic	NZ_CP161091.1	169395	170565	1170	renamed_GCF_000008685.2	chromosome	169562	170708	1170	99.4	6.647e-257
GCF_040790755.1_ASM4079075v1_genomic	NZ_CP161091.1	182659	181264	1395	renamed_GCF_000008685.2	chromosome	182802	181407	1395	100.0	4.219e-300
GCF_040790755.1_ASM4079075v1_genomic	NZ_CP161091.1	186805	187051	246	renamed_GCF_000008685.2	chromosome	186948	187194	246	100.0	9.168e-49
GCF_040790755.1_ASM4079075v1_genomic	NZ_CP161091.1	188094	187680	414	renamed_GCF_000008685.2	chromosome	188237	187823	414	100.0	2.918e-88
GCF_040790755.1_ASM4079075v1_genomic	NZ_CP161091.1	202464	200937	1527	renamed_GCF_000008685.2	chromosome	202578	201051	1527	97.2	0.0
GCF_040790755.1_ASM4079075v1_genomic	NZ_CP161091.1	247925	249488	1563	renamed_GCF_000008685.2	chromosome	248505	250089	1563	100.0	0.0
GCF_040790755.1_ASM4079075v1_genomic	NZ_CP161091.1	250610	250055	555	renamed_GCF_000008685.2	chromosome	251211	250656	555	100.0	3.12e-119
GCF_040790755.1_ASM4079075v1_genomic	NZ_CP161091.1	251832	252438	606	renamed_GCF_000008685.2	chromosome	252433	253039	606	99.5	2.035e-132
GCF_040790755.1_ASM4079075v1_genomic	NZ_CP161091.1	254343	255048	705	renamed_GCF_000008685.2	chromosome	254944	255649	705	99.5	3.589e-151
GCF_040790755.1_ASM4079075v1_genomic	NZ_CP161091.1	255861	258384	2523	renamed_GCF_000008685.2	chromosome	256462	258985	2523	98.6	0.0
GCF_040790755.1_ASM4079075v1_genomic	NZ_CP161091.1	263110	260689	2421	renamed_GCF_000008685.2	chromosome	263712	261291	2421	99.7	0.0
GCF_040790755.1_ASM4079075v1_genomic	NZ_CP161091.1	265498	266443	945	renamed_GCF_000008685.2	chromosome	266106	267051	945	100.0	6.277e-211
GCF_040790755.1_ASM4079075v1_genomic	NZ_CP161091.1	282070	281182	888	renamed_GCF_000008685.2	chromosome	282687	281799	888	100.0	4.025e-189
GCF_040790755.1_ASM4079075v1_genomic	NZ_CP161091.1	283248	282081	1167	renamed_GCF_000008685.2	chromosome	283865	282698	1167	100.0	1.172e-258
GCF_040790755.1_ASM4079075v1_genomic	NZ_CP161091.1	319641	319062	579	renamed_GCF_000008685.2	chromosome	320249	319679	579	98.9	3.43e-122
GCF_040790755.1_ASM4079075v1_genomic	NZ_CP161091.1	320734	321421	687	renamed_GCF_000008685.2	chromosome	321351	322038	687	100.0	1.336e-150
GCF_040790755.1_ASM4079075v1_genomic	NZ_CP161091.1	323162	322229	933	renamed_GCF_000008685.2	chromosome	323779	322846	933	100.0	1.839e-205
GCF_040790755.1_ASM4079075v1_genomic	NZ_CP161091.1	325671	324618	1053	renamed_GCF_000008685.2	chromosome	326288	325235	1053	99.7	1.991e-233
GCF_040790755.1_ASM4079075v1_genomic	NZ_CP161091.1	341717	342590	873	renamed_GCF_000008685.2	chromosome	342334	343207	873	99.6	3.495e-188
GCF_040790755.1_ASM4079075v1_genomic	NZ_CP161091.1	344445	345747	1302	renamed_GCF_000008685.2	chromosome	345062	346364	1302	99.7	2.995e-288
GCF_040790755.1_ASM4079075v1_genomic	NZ_CP161091.1	346684	346243	441	renamed_GCF_000008685.2	chromosome	347301	346860	441	100.0	1.706e-98
GCF_040790755.1_ASM4079075v1_genomic	NZ_CP161091.1	348993	347535	1458	renamed_GCF_000008685.2	chromosome	349610	348152	1458	99.5	0.0
GCF_040790755.1_ASM4079075v1_genomic	NZ_CP161091.1	363503	361703	1800	renamed_GCF_000008685.2	chromosome	364117	362317	1800	99.8	0.0