QUERY_ID	QUERY_NAME	QUERY_START	QUERY_END	QUERY_LENGTH	REF_ID	REF_NAME	REF_START	REF_END	REF_LENGTH	IDENTITY	EVALUE
B418P	contig_1	21973	20929	1044	renamed_GCF_000008685.2	chromosome	22101	21057	1044	100.0	6.693e-227
B418P	contig_1	24568	23836	732	renamed_GCF_000008685.2	chromosome	24696	23964	732	100.0	2.844e-158
B418P	contig_1	25624	26263	639	renamed_GCF_000008685.2	chromosome	25752	26391	639	100.0	1.211e-143
B418P	contig_1	28362	27726	636	renamed_GCF_000008685.2	chromosome	28490	27854	636	98.5	2.037e-137
B418P	contig_1	30892	31351	459	renamed_GCF_000008685.2	chromosome	31026	31479	459	99.3	5.582e-97
B418P	contig_1	35708	33908	1800	renamed_GCF_000008685.2	chromosome	35836	34036	1800	99.6	0.0
B418P	contig_1	39697	40549	852	renamed_GCF_000008685.2	chromosome	39825	40677	852	99.2	2.515e-188
B418P	contig_1	42753	42351	402	renamed_GCF_000008685.2	chromosome	42881	42479	402	100.0	2.405e-88
B418P	contig_1	45226	42778	2448	renamed_GCF_000008685.2	chromosome	45354	42906	2448	99.3	0.0
B418P	contig_1	80843	81269	426	renamed_GCF_000008685.2	chromosome	80982	81408	426	98.5	2.913e-90
B418P	contig_1	83781	82830	951	renamed_GCF_000008685.2	chromosome	83920	82969	951	99.3	8.301e-209
B418P	contig_1	87223	86788	435	renamed_GCF_000008685.2	chromosome	87360	86925	435	100.0	2.772e-92
B418P	contig_1	90978	89673	1305	renamed_GCF_000008685.2	chromosome	91115	89810	1305	100.0	2.863e-289
B418P	contig_1	93895	93295	600	renamed_GCF_000008685.2	chromosome	94032	93432	600	100.0	1.47e-126
B418P	contig_1	96816	94473	2343	renamed_GCF_000008685.2	chromosome	96953	94610	2343	99.1	0.0
B418P	contig_1	98678	100067	1389	renamed_GCF_000008685.2	chromosome	98816	100205	1389	99.5	2.368e-314
B418P	contig_1	102811	101386	1425	renamed_GCF_000008685.2	chromosome	102949	101524	1425	100.0	1.009e-312
B418P	contig_1	114466	112771	1695	renamed_GCF_000008685.2	chromosome	114603	112908	1695	100.0	0.0
B418P	contig_1	245997	247503	1506	renamed_GCF_000008685.2	chromosome	246596	248102	1506	100.0	0.0
B418P	contig_1	250071	249576	495	renamed_GCF_000008685.2	chromosome	250670	250175	495	100.0	5.051e-104
B418P	contig_1	251638	250612	1026	renamed_GCF_000008685.2	chromosome	252237	251211	1026	99.1	3.003e-224
B418P	contig_1	254345	255050	705	renamed_GCF_000008685.2	chromosome	254944	255649	705	100.0	7.263e-152
B418P	contig_1	275887	274633	1254	renamed_GCF_000008685.2	chromosome	276496	275242	1254	99.5	1.215e-281
B418P	contig_1	277950	276480	1470	renamed_GCF_000008685.2	chromosome	278559	277089	1470	99.7	1.976e-321
B418P	contig_1	278449	277927	522	renamed_GCF_000008685.2	chromosome	279058	278536	522	100.0	3.966e-111
B418P	contig_1	278771	278468	303	renamed_GCF_000008685.2	chromosome	279380	279077	303	98.0	2.549e-63
B418P	contig_1	280702	278797	1905	renamed_GCF_000008685.2	chromosome	281311	279406	1905	99.5	0.0
B418P	contig_1	281184	280704	480	renamed_GCF_000008685.2	chromosome	281793	281313	480	98.7	5.307e-101
B418P	contig_1	372530	372911	381	renamed_GCF_000008685.2	chromosome	373139	373520	381	100.0	1.683e-80
B418P	contig_1	384839	385553	714	renamed_GCF_000008685.2	chromosome	385448	386162	714	100.0	3.427e-153
B418P	contig_1	385549	386728	1179	renamed_GCF_000008685.2	chromosome	386158	387337	1179	99.7	9.776e-263
B418P	contig_1	386724	387198	474	renamed_GCF_000008685.2	chromosome	387333	387807	474	100.0	1.339e-106
B418P	contig_1	387871	387208	663	renamed_GCF_000008685.2	chromosome	388480	387817	663	99.5	1.104e-148
B418P	contig_1	388317	387897	420	renamed_GCF_000008685.2	chromosome	388926	388506	420	100.0	9.787e-93
B418P	contig_1	389732	388367	1365	renamed_GCF_000008685.2	chromosome	390341	388976	1365	99.3	3.579e-288
B418P	contig_1	391210	389785	1425	renamed_GCF_000008685.2	chromosome	391819	390391	1425	100.0	0.0
B418P	contig_1	392348	391322	1026	renamed_GCF_000008685.2	chromosome	392957	391931	1026	98.8	1.626e-222
B418P	contig_1	393454	392434	1020	renamed_GCF_000008685.2	chromosome	394063	393043	1020	99.4	1.624e-221
B418P	contig_1	426132	427347	1215	renamed_GCF_000008685.2	chromosome	426735	427950	1215	99.2	9.257e-261
B418P	contig_1	459447	459807	360	renamed_GCF_000008685.2	chromosome	460051	460411	360	99.1	5.311e-73
B418P	contig_1	461440	462169	729	renamed_GCF_000008685.2	chromosome	462044	462773	729	99.1	5.489e-159
B418P	contig_1	462214	463282	1068	renamed_GCF_000008685.2	chromosome	462818	463886	1068	100.0	4.491e-244
B418P	contig_1	463448	464528	1080	renamed_GCF_000008685.2	chromosome	464052	465132	1080	99.1	2.223e-245
B418P	contig_1	466684	464923	1761	renamed_GCF_000008685.2	chromosome	467278	465517	1761	99.3	0.0
B418P	contig_1	468793	466687	2106	renamed_GCF_000008685.2	chromosome	469387	467281	2106	99.7	0.0
B418P	contig_1	469071	468795	276	renamed_GCF_000008685.2	chromosome	469665	469389	276	97.8	9.032e-54
B418P	contig_1	469377	469083	294	renamed_GCF_000008685.2	chromosome	469971	469677	294	100.0	2.2e-63
B418P	contig_1	515887	522388	6501	renamed_GCF_000008685.2	chromosome	516492	522993	6501	99.5	0.0
B418P	contig_1	547885	547240	645	renamed_GCF_000008685.2	chromosome	548490	547845	645	100.0	1.056e-137
B418P	contig_1	548280	547881	399	renamed_GCF_000008685.2	chromosome	548885	548486	399	99.2	3.385e-84
B418P	contig_1	549013	548314	699	renamed_GCF_000008685.2	chromosome	549618	548919	699	100.0	1.058e-146
B418P	contig_1	551118	549036	2082	renamed_GCF_000008685.2	chromosome	551723	549641	2082	99.7	0.0
B418P	contig_1	552539	553190	651	renamed_GCF_000008685.2	chromosome	553138	553789	651	99.5	3.256e-143
B418P	contig_1	553392	554613	1221	renamed_GCF_000008685.2	chromosome	553991	555212	1221	99.7	2.636e-267
B418P	contig_1	554616	555981	1365	renamed_GCF_000008685.2	chromosome	555215	556580	1365	98.6	1.837e-304
B418P	contig_1	577208	577520	312	renamed_GCF_000008685.2	chromosome	577949	578261	312	100.0	5.387e-65
B418P	contig_1	606235	604030	2205	renamed_GCF_000008685.2	chromosome	606983	604778	2205	99.3	0.0
B418P	contig_1	606387	607185	798	renamed_GCF_000008685.2	chromosome	607137	607935	798	99.2	2.604e-170
B418P	contig_1	609156	608310	846	renamed_GCF_000008685.2	chromosome	609906	609060	846	98.9	1.802e-182
B418P	contig_1	610443	609192	1251	renamed_GCF_000008685.2	chromosome	611193	609942	1251	98.7	1.89e-267
B418P	contig_1	610558	611272	714	renamed_GCF_000008685.2	chromosome	611308	612022	714	99.5	4.333e-159
B418P	contig_1	611297	613235	1938	renamed_GCF_000008685.2	chromosome	612047	613985	1938	99.5	0.0
B418P	contig_1	615021	613263	1758	renamed_GCF_000008685.2	chromosome	615771	614013	1758	99.6	0.0
B418P	contig_1	615640	615013	627	renamed_GCF_000008685.2	chromosome	616390	615763	627	100.0	5.736e-133
B418P	contig_1	696825	697572	747	renamed_GCF_000008685.2	chromosome	697585	698332	747	99.5	7.646e-167
B418P	contig_1	716979	717906	927	renamed_GCF_000008685.2	chromosome	717742	718669	927	99.6	3.861e-196
B418P	contig_1	718063	720325	2262	renamed_GCF_000008685.2	chromosome	718826	721088	2262	99.6	0.0
B418P	contig_1	720355	722257	1902	renamed_GCF_000008685.2	chromosome	721118	723020	1902	99.8	0.0
B418P	contig_1	723367	722299	1068	renamed_GCF_000008685.2	chromosome	724130	723062	1068	99.1	4.094e-245
B418P	contig_1	723460	724684	1224	renamed_GCF_000008685.2	chromosome	724223	725447	1224	99.2	1.743e-272
B418P	contig_1	724667	725732	1065	renamed_GCF_000008685.2	chromosome	725430	726495	1065	95.4	1.714e-228
B418P	contig_1	725721	726990	1269	renamed_GCF_000008685.2	chromosome	726457	727753	1269	98.3	2.43e-276
B418P	contig_1	726973	727912	939	renamed_GCF_000008685.2	chromosome	727736	728675	939	100.0	1.678e-207
B418P	contig_1	727902	728856	954	renamed_GCF_000008685.2	chromosome	728665	729619	954	98.7	7.929e-210
B418P	contig_1	806120	804971	1149	renamed_GCF_000008685.2	chromosome	806923	805774	1149	99.4	2.675e-246
B418P	contig_1	835275	837741	2466	renamed_GCF_000008685.2	chromosome	836060	838526	2466	99.7	0.0
B418P	contig_1	837761	838295	534	renamed_GCF_000008685.2	chromosome	838546	839080	534	100.0	7.282e-115
B418P	contig_1	838458	841047	2589	renamed_GCF_000008685.2	chromosome	839243	841832	2589	99.6	0.0
B418P	contig_1	841048	841666	618	renamed_GCF_000008685.2	chromosome	841833	842451	618	100.0	1.393e-138
B418P	contig_1	841766	842204	438	renamed_GCF_000008685.2	chromosome	842500	842989	438	99.3	1.307e-92
B418P	contig_1	842217	843666	1449	renamed_GCF_000008685.2	chromosome	843002	844451	1449	99.7	3.805e-319
B418P	contig_1	843668	846254	2586	renamed_GCF_000008685.2	chromosome	844453	847102	2586	96.3	0.0
B418P	contig_1	846277	846640	363	renamed_GCF_000008685.2	chromosome	847125	847488	363	100.0	2.269e-74
B418P	contig_1	868668	867885	783	renamed_GCF_000008685.2	chromosome	869380	868732	783	99.5	1.931e-145
B418P	contig_1	889477	892330	2853	renamed_GCF_000008685.2	chromosome	890321	893174	2853	99.6	0.0
B418P	contig_1	892284	895725	3441	renamed_GCF_000008685.2	chromosome	893128	896569	3441	98.4	0.0
B418P	contig_1	896283	895734	549	renamed_GCF_000008685.2	chromosome	897127	896578	549	99.4	1.275e-119
B418P	contig_1	896851	896251	600	renamed_GCF_000008685.2	chromosome	897695	897095	600	99.4	6.881e-135
B418P	contig_1	898476	896859	1617	renamed_GCF_000008685.2	chromosome	899320	897703	1617	98.6	0.0
B418P	contig_1	898654	899893	1239	renamed_GCF_000008685.2	chromosome	899498	900731	1239	98.5	2.414e-271
B418P	contig_1	899953	900937	984	renamed_GCF_000008685.2	chromosome	900798	901782	984	99.0	6.621e-217
B418P	contig_1	900988	902413	1425	renamed_GCF_000008685.2	chromosome	901833	903258	1425	99.1	1.593e-307
B418P	contig_3	3797	2855	942	renamed_GCF_000008685.2	cp32-7	10961	11903	942	100.0	2.456e-212
B418P	contig_3	10800	9840	960	renamed_GCF_000008685.2	cp32-1	3962	4922	960	99.0	7.937e-211
B418P	contig_3	11394	10821	573	renamed_GCF_000008685.2	cp32-6	3372	3948	573	89.0	1.632e-112
B418P	contig_3	12188	11423	765	renamed_GCF_000008685.2	cp32-7	2573	3338	765	98.8	1.703e-169
B418P	contig_3	12752	12194	558	renamed_GCF_000008685.2	cp32-1	2010	2568	558	94.5	4.355e-116
B418P	contig_3	14702	13475	1227	renamed_GCF_000008685.2	cp32-6	65	1289	1227	99.5	2.639e-268
B418P	contig_3	16120	14767	1353	renamed_GCF_000008685.2	cp32-8	29532	30885	1353	98.8	1.671e-303
B418P	contig_3	17392	16864	528	renamed_GCF_000008685.2	cp32-4	27675	28203	528	89.7	7.038e-106
B418P	contig_3	19026	19803	777	renamed_GCF_000008685.2	cp32-3	26276	25499	777	98.4	1.706e-171
B418P	contig_3	20234	19808	426	renamed_GCF_000008685.2	cp32-3	25068	25494	426	97.1	9.782e-94
B418P	contig_3	22610	22103	507	renamed_GCF_000008685.2	lp56	25889	26426	507	93.8	2.496e-105
B418P	contig_3	23982	23226	756	renamed_GCF_000008685.2	lp56	24517	25273	756	99.6	5.251e-164
B418P	contig_3	24524	23957	567	renamed_GCF_000008685.2	lp56	23975	24542	567	100.0	1.456e-129
B418P	contig_3	25631	24533	1098	renamed_GCF_000008685.2	lp56	22868	23966	1098	99.1	2.233e-248
B418P	contig_3	27675	27045	630	renamed_GCF_000008685.2	lp56	20843	21455	630	73.1	8.011e-96
B418P	contig_3	27846	28329	483	renamed_GCF_000008685.2	cp32-6	17075	16592	483	99.3	2.502e-101
B418P	contig_3	28820	28466	354	renamed_GCF_000008685.2	cp32-1	16086	16440	354	99.1	1.459e-77
B418P	contig_3	29148	28812	336	renamed_GCF_000008685.2	lp56	19256	19592	336	100.0	5.348e-69
B418P	contig_3	29692	29488	204	renamed_GCF_000008685.2	cp32-1	15214	15418	204	100.0	2.578e-39
B418P	contig_6	17711	16889	822	renamed_GCF_000008685.2	lp56	17822	18638	822	76.1	1.275e-130
B418P	contig_6	18326	17720	606	renamed_GCF_000008685.2	lp56	17207	17813	606	100.0	5.47e-130
B418P	contig_6	21194	21623	429	renamed_GCF_000008685.2	lp56	11296	11725	429	100.0	5.601e-92
B418P	contig_6	22090	22327	237	renamed_GCF_000008685.2	cp32-9	8741	8978	237	100.0	1.76e-48
B418P	contig_7	6881	6365	516	renamed_GCF_000008685.2	cp32-8	26381	26903	516	81.49	4.943e-91
B418P	contig_7	8519	8093	426	renamed_GCF_000008685.2	cp32-7	24512	24938	426	98.5	8.877e-95
B418P	contig_8	20024	20792	768	renamed_GCF_000008685.2	cp32-6	2576	3344	768	92.1	1.012e-158
B418P	contig_8	22394	22850	456	renamed_GCF_000008685.2	cp32-1	4941	5397	456	97.3	2.901e-95
B418P	contig_10	13433	13139	294	renamed_GCF_000008685.2	lp17	9980	9590	294	93.7	7.322e-59
B418P	contig_10	19748	19517	231	renamed_GCF_000008685.2	lp17	16119	15888	231	98.6	8.774e-47
B418P	contig_11	6684	7548	864	renamed_GCF_000008685.2	lp25	6897	7761	864	98.9	9.409e-193
B418P	contig_11	10001	9380	621	renamed_GCF_000008685.2	lp25	10187	9566	621	94.1	1.275e-131
B418P	contig_12	1204	2074	870	renamed_GCF_000008685.2	lp28-2	1046	1928	870	97.9	1.367e-189
B418P	contig_12	6051	6819	768	renamed_GCF_000008685.2	lp28-2	5910	6678	768	98.4	2.852e-164
B418P	contig_18	653	1139	486	renamed_GCF_000008685.2	lp28-3	28197	27624	486	48.4	2.052e-45
B418P	contig_18	4258	3004	1254	renamed_GCF_000008685.2	lp54	4256	3002	1254	99.7	7.21e-279
B418P	contig_18	5315	5651	336	renamed_GCF_000008685.2	lp54	5313	5649	336	100.0	1.784e-72
B418P	contig_18	24528	25134	606	renamed_GCF_000008685.2	lp54	24497	25103	606	98.0	4.344e-124
B418P	contig_18	44562	43713	849	renamed_GCF_000008685.2	lp54	44533	43684	849	100.0	7.054e-185
B418P	contig_1	60404	59906	498	renamed_GCF_000008685.2	chromosome	60533	60035	498	98.7	8.026e-108
B418P	contig_1	61128	60438	690	renamed_GCF_000008685.2	chromosome	61257	60567	690	98.2	8.357e-148
B418P	contig_1	63017	63899	882	renamed_GCF_000008685.2	chromosome	63146	64028	882	99.6	6.762e-191
B418P	contig_1	129994	127288	2706	renamed_GCF_000008685.2	chromosome	130132	127426	2706	99.3	0.0
B418P	contig_1	131159	132287	1128	renamed_GCF_000008685.2	chromosome	131297	132425	1128	99.7	1.76e-247
B418P	contig_1	152061	152868	807	renamed_GCF_000008685.2	chromosome	152205	153012	807	98.8	2.384e-181
B418P	contig_1	153542	152930	612	renamed_GCF_000008685.2	chromosome	153686	153074	612	99.5	5.181e-140
B418P	contig_1	157483	157918	435	renamed_GCF_000008685.2	chromosome	157626	158061	435	97.2	1.836e-88
B418P	contig_1	170955	170577	378	renamed_GCF_000008685.2	chromosome	171097	170719	378	100.0	1.603e-80
B418P	contig_1	173974	173386	588	renamed_GCF_000008685.2	chromosome	174116	173528	588	98.4	4.112e-130
B418P	contig_1	177711	176835	876	renamed_GCF_000008685.2	chromosome	177853	176977	876	100.0	9.427e-195
B418P	contig_1	237030	236622	408	renamed_GCF_000008685.2	chromosome	237629	237221	408	100.0	2.649e-88
B418P	contig_1	237627	237369	258	renamed_GCF_000008685.2	chromosome	238226	237968	258	100.0	9.113e-51
B418P	contig_1	241838	243404	1566	renamed_GCF_000008685.2	chromosome	242437	244003	1566	99.2	0.0
B418P	contig_1	255046	255661	615	renamed_GCF_000008685.2	chromosome	255645	256260	615	99.5	1.16e-131
B418P	contig_1	263112	260691	2421	renamed_GCF_000008685.2	chromosome	263712	261291	2421	99.7	0.0
B418P	contig_1	265506	266451	945	renamed_GCF_000008685.2	chromosome	266106	267051	945	100.0	6.277e-211
B418P	contig_1	272080	269887	2193	renamed_GCF_000008685.2	chromosome	272641	270487	2193	99.7	0.0
B418P	contig_1	286480	285361	1119	renamed_GCF_000008685.2	chromosome	287089	285970	1119	99.4	2.426e-242
B418P	contig_1	287564	287300	264	renamed_GCF_000008685.2	chromosome	288173	287909	264	100.0	2.025e-51
B418P	contig_1	346229	345818	411	renamed_GCF_000008685.2	chromosome	346841	346430	411	100.0	6.821e-87
B418P	contig_1	347548	346738	810	renamed_GCF_000008685.2	chromosome	348160	347350	810	99.6	4.196e-184
B418P	contig_1	350433	348987	1446	renamed_GCF_000008685.2	chromosome	351045	349599	1446	99.1	1.792e-318
B418P	contig_1	352828	350728	2100	renamed_GCF_000008685.2	chromosome	353437	351340	2100	98.4	0.0
B418P	contig_1	354689	354038	651	renamed_GCF_000008685.2	chromosome	355298	354647	651	100.0	1.769e-141
B418P	contig_1	356397	357831	1434	renamed_GCF_000008685.2	chromosome	357006	358440	1434	97.0	2.007e-306
B418P	contig_1	358886	358607	279	renamed_GCF_000008685.2	chromosome	359495	359216	279	100.0	2.841e-58
B418P	contig_1	360590	361712	1122	renamed_GCF_000008685.2	chromosome	361187	362321	1122	98.9	6.579e-249
B418P	contig_1	373542	372957	585	renamed_GCF_000008685.2	chromosome	374151	373566	585	98.4	1.16e-126
B418P	contig_1	447156	446364	792	renamed_GCF_000008685.2	chromosome	447736	446968	792	98.8	2.051e-163
B418P	contig_1	448100	448706	606	renamed_GCF_000008685.2	chromosome	448707	449310	606	99.5	2.46e-130
B418P	contig_1	453868	451435	2433	renamed_GCF_000008685.2	chromosome	454472	452039	2433	99.7	0.0
B418P	contig_1	455971	457432	1461	renamed_GCF_000008685.2	chromosome	456575	458036	1461	99.7	0.0
B418P	contig_1	459311	459467	156	renamed_GCF_000008685.2	chromosome	459915	460071	156	100.0	2.965e-30
B418P	contig_1	471971	472814	843	renamed_GCF_000008685.2	chromosome	472565	473408	843	98.9	2.632e-186
B418P	contig_1	475011	475617	606	renamed_GCF_000008685.2	chromosome	475605	476211	606	99.5	2.237e-131
B418P	contig_1	479110	480421	1311	renamed_GCF_000008685.2	chromosome	479708	481019	1311	100.0	7.438e-297
B418P	contig_1	482001	483684	1683	renamed_GCF_000008685.2	chromosome	482599	484282	1683	99.1	0.0
B418P	contig_1	506269	506383	114	renamed_GCF_000008685.2	chromosome	506864	506984	114	100.0	7.638e-22
B418P	contig_1	506804	507197	393	renamed_GCF_000008685.2	chromosome	507405	507798	393	100.0	3.073e-84
B418P	contig_1	541657	542419	762	renamed_GCF_000008685.2	chromosome	542262	543024	762	99.6	1.226e-172
B418P	contig_1	543980	546782	2802	renamed_GCF_000008685.2	chromosome	544585	547387	2802	99.3	0.0
B418P	contig_1	560010	557283	2727	renamed_GCF_000008685.2	chromosome	560732	558005	2727	99.8	0.0
B418P	contig_1	560814	560394	420	renamed_GCF_000008685.2	chromosome	561554	561116	420	93.0	2.589e-82
B418P	contig_1	567069	567537	468	renamed_GCF_000008685.2	chromosome	567809	568277	468	99.3	9.748e-101
B418P	contig_1	579744	580902	1158	renamed_GCF_000008685.2	chromosome	580485	581643	1158	100.0	7.971e-253
B418P	contig_1	582716	583091	375	renamed_GCF_000008685.2	chromosome	583457	583832	375	99.1	1.859e-78
B418P	contig_1	587322	588924	1602	renamed_GCF_000008685.2	chromosome	588065	589667	1602	100.0	0.0
B418P	contig_1	590439	591609	1170	renamed_GCF_000008685.2	chromosome	591187	592357	1170	98.9	1.155e-250
B418P	contig_1	595194	595773	579	renamed_GCF_000008685.2	chromosome	595942	596521	579	99.4	1.865e-120
B418P	contig_1	598628	597839	789	renamed_GCF_000008685.2	chromosome	599376	598587	789	98.8	1.29e-176
B418P	contig_1	598746	600096	1350	renamed_GCF_000008685.2	chromosome	599494	600844	1350	100.0	3.989e-293
B418P	contig_1	600261	601596	1335	renamed_GCF_000008685.2	chromosome	601009	602344	1335	100.0	3.161e-293
B418P	contig_1	601625	602981	1356	renamed_GCF_000008685.2	chromosome	602373	603729	1356	98.8	1.497e-296
B418P	contig_1	631240	631732	492	renamed_GCF_000008685.2	chromosome	631990	632482	492	100.0	1.786e-106
B418P	contig_1	631734	633714	1980	renamed_GCF_000008685.2	chromosome	632484	634464	1980	99.2	0.0
B418P	contig_1	633830	635261	1431	renamed_GCF_000008685.2	chromosome	634580	636011	1431	97.6	2.459e-312
B418P	contig_1	635839	637204	1365	renamed_GCF_000008685.2	chromosome	636592	637957	1365	99.1	3.824e-296
B418P	contig_1	637209	637803	594	renamed_GCF_000008685.2	chromosome	637971	638556	594	100.0	1.47e-125
B418P	contig_1	637826	639119	1293	renamed_GCF_000008685.2	chromosome	638579	639872	1293	99.7	6.951e-286
B418P	contig_1	639087	641496	2409	renamed_GCF_000008685.2	chromosome	639858	642249	2409	99.3	0.0
B418P	contig_1	641535	641688	153	renamed_GCF_000008685.2	chromosome	642288	642441	153	100.0	5.64e-31
B418P	contig_1	642373	641746	627	renamed_GCF_000008685.2	chromosome	643126	642499	627	100.0	8.735e-137
B418P	contig_1	643897	642541	1356	renamed_GCF_000008685.2	chromosome	644650	643294	1356	99.1	4.671e-301
B418P	contig_1	675722	677111	1389	renamed_GCF_000008685.2	chromosome	676471	677860	1389	99.7	3.202e-302
B418P	contig_1	678189	677142	1047	renamed_GCF_000008685.2	chromosome	678938	677891	1047	98.8	3.051e-236
B418P	contig_1	679000	678208	792	renamed_GCF_000008685.2	chromosome	679750	678958	792	99.6	3.445e-166
B418P	contig_1	679813	679003	810	renamed_GCF_000008685.2	chromosome	680557	679753	810	99.6	5.278e-173
B418P	contig_1	680856	679812	1044	renamed_GCF_000008685.2	chromosome	681606	680562	1044	100.0	8.539e-233
B418P	contig_1	681774	680934	840	renamed_GCF_000008685.2	chromosome	682524	681684	840	100.0	1.641e-182
B418P	contig_1	681928	682627	699	renamed_GCF_000008685.2	chromosome	682678	683377	699	100.0	1.337e-152
B418P	contig_1	682672	684217	1545	renamed_GCF_000008685.2	chromosome	683422	684967	1545	99.8	0.0
B418P	contig_1	685230	684246	984	renamed_GCF_000008685.2	chromosome	685980	684996	984	99.0	9.254e-222
B418P	contig_1	685757	685226	531	renamed_GCF_000008685.2	chromosome	686507	685976	531	100.0	1.053e-118
B418P	contig_1	738379	738919	540	renamed_GCF_000008685.2	chromosome	739143	739683	540	100.0	2.458e-119
B418P	contig_1	739681	739924	243	renamed_GCF_000008685.2	chromosome	740445	740688	243	100.0	1.755e-49
B418P	contig_1	741864	740631	1233	renamed_GCF_000008685.2	chromosome	742628	741395	1233	98.7	1.085e-270
B418P	contig_1	744537	745569	1032	renamed_GCF_000008685.2	chromosome	745301	746333	1032	99.4	6.089e-226
B418P	contig_1	747359	749255	1896	renamed_GCF_000008685.2	chromosome	748122	750018	1896	99.6	0.0
B418P	contig_1	750427	751396	969	renamed_GCF_000008685.2	chromosome	751190	752159	969	99.6	1.06e-217
B418P	contig_1	752459	753305	846	renamed_GCF_000008685.2	chromosome	753291	754068	846	99.6	1.473e-167
B418P	contig_1	753786	755586	1800	renamed_GCF_000008685.2	chromosome	754636	756349	1800	99.8	0.0
B418P	contig_1	758822	759452	630	renamed_GCF_000008685.2	chromosome	759585	760215	630	99.0	4.119e-137
B418P	contig_1	850145	851666	1521	renamed_GCF_000008685.2	chromosome	850993	852514	1521	99.2	0.0
B418P	contig_1	854020	855148	1128	renamed_GCF_000008685.2	chromosome	854868	855996	1128	96.5	6.587e-250
B418P	contig_1	855140	856661	1521	renamed_GCF_000008685.2	chromosome	855988	857509	1521	99.8	0.0
B418P	contig_1	859591	860926	1335	renamed_GCF_000008685.2	chromosome	860439	861774	1335	99.3	4.561e-289
B418P	contig_1	874285	871738	2547	renamed_GCF_000008685.2	chromosome	875132	872585	2547	99.8	0.0
B418P	contig_1	875581	878434	2853	renamed_GCF_000008685.2	chromosome	876491	879281	2853	99.1	0.0
B418P	contig_1	883366	880237	3129	renamed_GCF_000008685.2	chromosome	884213	881084	3129	99.6	0.0
B418P	contig_2	1491	942	549	renamed_GCF_000008685.2	cp26	10103	10652	549	98.3	3.776e-116
B418P	contig_2	4918	3880	1038	renamed_GCF_000008685.2	cp26	6676	7714	1038	99.4	4.211e-231
B418P	contig_4	16585	17368	783	renamed_GCF_000008685.2	cp32-8	20739	21480	783	80.8	2.002e-136
B418P	contig_5	4140	5088	948	renamed_GCF_000008685.2	cp32-6	18680	17732	948	97.4	1.214e-212
B418P	contig_5	7023	6669	354	renamed_GCF_000008685.2	cp32-3	16083	16437	354	100.0	1.459e-77
B418P	contig_5	10034	8681	1353	renamed_GCF_000008685.2	cp32-6	28485	29838	1353	99.3	3.386e-304
B418P	contig_6	4567	5254	687	renamed_GCF_000008685.2	cp32-6	27745	27076	687	51.6	1.957e-59
B418P	contig_6	6358	7135	777	renamed_GCF_000008685.2	cp32-7	25720	24943	777	100.0	1.414e-173
B418P	contig_7	15720	15285	435	renamed_GCF_000008685.2	cp32-9	17301	17730	435	84.1	6.484e-75
B418P	contig_7	16838	16484	354	renamed_GCF_000008685.2	cp32-7	16093	16447	354	99.1	3.249e-77
B418P	contig_8	461	1067	606	renamed_GCF_000008685.2	cp32-8	13708	14314	606	99.0	6.014e-129
B418P	contig_8	8953	9526	573	renamed_GCF_000008685.2	cp32-9	22183	22723	573	93.6	8.876e-111
B418P	contig_8	23606	24173	567	renamed_GCF_000008685.2	lp56	9623	10190	567	98.9	1.159e-123
B418P	contig_8	26176	26413	237	renamed_GCF_000008685.2	cp32-7	8725	8962	237	98.7	8.748e-48
B418P	contig_12	22784	22397	387	renamed_GCF_000008685.2	lp28-2	22659	22272	387	96.0	6.848e-83
B418P	contig_12	23158	22783	375	renamed_GCF_000008685.2	lp28-2	23033	22658	375	96.7	1.121e-75
B418P	contig_12	23850	23157	693	renamed_GCF_000008685.2	lp28-2	23725	23032	693	98.2	1.216e-152
B418P	contig_12	24221	23846	375	renamed_GCF_000008685.2	lp28-2	24108	23721	375	89.0	9.084e-70
B418P	contig_13	9400	8644	756	renamed_GCF_000008685.2	lp28-3	17946	18702	756	99.6	4.353e-166
B418P	contig_14	23351	22598	753	renamed_GCF_000008685.2	lp28-4	21562	20770	753	97.9	2.718e-162
B418P	contig_14	24720	23883	837	renamed_GCF_000008685.2	lp28-4	22931	22094	837	98.9	7.731e-182
B418P	contig_14	25814	24947	867	renamed_GCF_000008685.2	lp28-4	25089	24222	867	95.8	6.102e-181
B418P	contig_14	29456	28562	894	renamed_GCF_000008685.2	lp36	187	1081	894	98.6	8.951e-190
B418P	contig_15	187	952	765	renamed_GCF_000008685.2	lp28-2	29618	28853	765	77.5	1.436e-128
B418P	contig_16	4809	5574	765	renamed_GCF_000008685.2	lp36	6040	5287	765	85.4	1.193e-130
B418P	contig_16	6849	7248	399	renamed_GCF_000008685.2	lp36	9372	9999	399	99.1	1.114e-79
B418P	contig_16	19290	19512	222	renamed_GCF_000008685.2	lp36	21911	22133	222	98.6	4.162e-45
B418P	contig_16	20747	20876	129	renamed_GCF_000008685.2	lp28-1	3849	3681	129	97.5	5.007e-21
B418P	contig_17	4702	5380	678	renamed_GCF_000008685.2	lp38	4575	5496	678	97.6	1.162e-133
B418P	contig_1	25495	24568	927	renamed_GCF_000008685.2	chromosome	25623	24696	927	99.0	6.495e-199
B418P	contig_1	26270	27320	1050	renamed_GCF_000008685.2	chromosome	26398	27448	1050	98.8	1.9e-233
B418P	contig_1	27737	27305	432	renamed_GCF_000008685.2	chromosome	27865	27433	432	98.6	1.441e-90
B418P	contig_1	29344	28363	981	renamed_GCF_000008685.2	chromosome	29472	28491	981	100.0	8.047e-223
B418P	contig_1	29414	30887	1473	renamed_GCF_000008685.2	chromosome	29542	31015	1473	99.1	0.0
B418P	contig_1	31961	31421	540	renamed_GCF_000008685.2	chromosome	32089	31549	540	100.0	3.274e-116
B418P	contig_1	33909	32028	1881	renamed_GCF_000008685.2	chromosome	34037	32156	1881	100.0	0.0
B418P	contig_1	36481	35728	753	renamed_GCF_000008685.2	chromosome	36609	35856	753	98.0	1.62e-159
B418P	contig_1	39510	38007	1503	renamed_GCF_000008685.2	chromosome	39638	38135	1503	99.8	0.0
B418P	contig_1	41304	40632	672	renamed_GCF_000008685.2	chromosome	41432	40760	672	100.0	1.856e-144
B418P	contig_1	42355	41314	1041	renamed_GCF_000008685.2	chromosome	42483	41442	1041	99.1	1.075e-229
B418P	contig_1	46251	45882	369	renamed_GCF_000008685.2	chromosome	46379	46010	369	99.1	1.529e-79
B418P	contig_1	47038	47713	675	renamed_GCF_000008685.2	chromosome	47166	47841	675	99.5	1.946e-144
B418P	contig_1	49131	48474	657	renamed_GCF_000008685.2	chromosome	49259	48602	657	99.5	1.056e-139
B418P	contig_1	49212	49884	672	renamed_GCF_000008685.2	chromosome	49340	50012	672	100.0	9.591e-152
B418P	contig_1	51123	50361	762	renamed_GCF_000008685.2	chromosome	51251	50489	762	100.0	1.168e-164
B418P	contig_1	52306	51124	1182	renamed_GCF_000008685.2	chromosome	52434	51252	1182	100.0	6.664e-259
B418P	contig_1	55376	53405	1971	renamed_GCF_000008685.2	chromosome	55504	53533	1971	99.8	0.0
B418P	contig_1	56620	56152	468	renamed_GCF_000008685.2	chromosome	56748	56280	468	99.3	1.969e-101
B418P	contig_1	57130	57847	717	renamed_GCF_000008685.2	chromosome	57258	57975	717	98.3	7.985e-153
B418P	contig_1	58908	57900	1008	renamed_GCF_000008685.2	chromosome	58982	58028	1008	99.0	2.916e-204
B418P	contig_1	71071	72481	1410	renamed_GCF_000008685.2	chromosome	71200	72610	1410	99.3	1.384e-306
B418P	contig_1	72517	73363	846	renamed_GCF_000008685.2	chromosome	72646	73492	846	99.2	6.38e-177
B418P	contig_1	76320	77571	1251	renamed_GCF_000008685.2	chromosome	76450	77701	1251	100.0	1.724e-268
B418P	contig_1	79216	78865	351	renamed_GCF_000008685.2	chromosome	79322	79001	351	100.0	3.732e-67
B418P	contig_1	79366	80635	1269	renamed_GCF_000008685.2	chromosome	79504	80773	1269	98.1	4.098e-279
B418P	contig_1	81265	82801	1536	renamed_GCF_000008685.2	chromosome	81404	82940	1536	99.8	0.0
B418P	contig_1	85731	83901	1830	renamed_GCF_000008685.2	chromosome	85720	84040	1830	99.8	0.0
B418P	contig_1	86717	85742	975	renamed_GCF_000008685.2	chromosome	86854	85879	975	99.6	4.354e-220
B418P	contig_1	89671	89062	609	renamed_GCF_000008685.2	chromosome	89808	89199	609	100.0	1.275e-129
B418P	contig_1	93286	92740	546	renamed_GCF_000008685.2	chromosome	93423	92877	546	97.7	3.273e-117
B418P	contig_1	94468	94081	387	renamed_GCF_000008685.2	chromosome	94605	94218	387	100.0	1.031e-86
B418P	contig_1	97729	96805	924	renamed_GCF_000008685.2	chromosome	97866	96942	924	100.0	7.888e-205
B418P	contig_1	98643	97725	918	renamed_GCF_000008685.2	chromosome	98648	97862	918	98.4	1.268e-172
B418P	contig_1	100089	100611	522	renamed_GCF_000008685.2	chromosome	100227	100749	522	97.6	1.62e-112
B418P	contig_1	101201	100607	594	renamed_GCF_000008685.2	chromosome	101339	100745	594	99.4	3.093e-134
B418P	contig_1	112631	112211	420	renamed_GCF_000008685.2	chromosome	112769	112349	420	98.5	7.151e-88
B418P	contig_1	114669	115371	702	renamed_GCF_000008685.2	chromosome	114806	115508	702	99.1	1.161e-154
B418P	contig_1	116669	115367	1302	renamed_GCF_000008685.2	chromosome	116806	115504	1302	98.1	1.154e-281
B418P	contig_1	118233	117540	693	renamed_GCF_000008685.2	chromosome	118370	117677	693	98.6	6.012e-152
B418P	contig_1	118792	118237	555	renamed_GCF_000008685.2	chromosome	118929	118374	555	99.4	3.776e-117
B418P	contig_1	120452	119669	783	renamed_GCF_000008685.2	chromosome	120589	119806	783	100.0	5.024e-169
B418P	contig_1	133704	132333	1371	renamed_GCF_000008685.2	chromosome	133842	132471	1371	100.0	2.422e-302
B418P	contig_1	133836	135726	1890	renamed_GCF_000008685.2	chromosome	133974	135864	1890	99.6	0.0
B418P	contig_1	138611	138299	312	renamed_GCF_000008685.2	chromosome	138745	138433	312	100.0	9.828e-67
B418P	contig_1	142800	141846	954	renamed_GCF_000008685.2	chromosome	142932	141978	954	99.3	1.665e-201
B418P	contig_1	144174	144465	291	renamed_GCF_000008685.2	chromosome	144306	144597	291	94.7	3.46e-58
B418P	contig_1	145326	144453	873	renamed_GCF_000008685.2	chromosome	145458	144585	873	98.9	3.059e-198
B418P	contig_1	158484	159201	717	renamed_GCF_000008685.2	chromosome	158627	159344	717	96.2	3.946e-152
B418P	contig_1	159224	159899	675	renamed_GCF_000008685.2	chromosome	159367	160042	675	97.7	5.223e-142
B418P	contig_1	162658	161056	1602	renamed_GCF_000008685.2	chromosome	162801	161199	1602	99.8	0.0
B418P	contig_1	162734	162902	168	renamed_GCF_000008685.2	chromosome	162877	163045	168	100.0	5.294e-34
B418P	contig_1	165744	164757	987	renamed_GCF_000008685.2	chromosome	165887	164900	987	99.6	2.948e-209
B418P	contig_1	167616	165771	1845	renamed_GCF_000008685.2	chromosome	167759	165914	1845	99.5	0.0
B418P	contig_1	169396	170566	1170	renamed_GCF_000008685.2	chromosome	169562	170708	1170	99.4	6.647e-257
B418P	contig_1	182660	181265	1395	renamed_GCF_000008685.2	chromosome	182802	181407	1395	100.0	4.219e-300
B418P	contig_1	182743	183238	495	renamed_GCF_000008685.2	chromosome	182885	183380	495	100.0	9.271e-106
B418P	contig_1	186806	187052	246	renamed_GCF_000008685.2	chromosome	186948	187194	246	100.0	9.168e-49
B418P	contig_1	187689	187035	654	renamed_GCF_000008685.2	chromosome	187831	187177	654	100.0	1.397e-144
B418P	contig_1	188352	188091	261	renamed_GCF_000008685.2	chromosome	188494	188233	261	100.0	7.054e-54
B418P	contig_1	200937	199851	1086	renamed_GCF_000008685.2	chromosome	201050	199964	1086	98.6	7.16e-242
B418P	contig_1	202736	203975	1239	renamed_GCF_000008685.2	chromosome	202849	204088	1239	99.7	6.044e-261
B418P	contig_1	204023	204959	936	renamed_GCF_000008685.2	chromosome	204136	205072	936	100.0	4.7e-204
B418P	contig_1	206415	207966	1551	renamed_GCF_000008685.2	chromosome	206528	208106	1551	99.6	0.0
B418P	contig_1	208506	207969	537	renamed_GCF_000008685.2	chromosome	208581	208083	537	98.7	8.112e-106
B418P	contig_1	226011	224226	1785	renamed_GCF_000008685.2	chromosome	226610	224825	1785	99.6	0.0
B418P	contig_1	227228	226010	1218	renamed_GCF_000008685.2	chromosome	227827	226609	1218	99.5	1.492e-264
B418P	contig_1	230892	229614	1278	renamed_GCF_000008685.2	chromosome	231491	230213	1278	100.0	4.58e-288
B418P	contig_1	231021	231723	702	renamed_GCF_000008685.2	chromosome	231620	232322	702	99.5	5.74e-154
B418P	contig_1	244780	244177	603	renamed_GCF_000008685.2	chromosome	245382	244776	603	99.5	7.936e-134
B418P	contig_1	245190	245955	765	renamed_GCF_000008685.2	chromosome	245789	246554	765	100.0	7.663e-170
B418P	contig_1	247927	249490	1563	renamed_GCF_000008685.2	chromosome	248505	250089	1563	100.0	0.0
B418P	contig_1	250612	250057	555	renamed_GCF_000008685.2	chromosome	251211	250656	555	100.0	3.12e-119
B418P	contig_1	251834	252440	606	renamed_GCF_000008685.2	chromosome	252433	253039	606	99.5	4.115e-133
B418P	contig_1	252559	254332	1773	renamed_GCF_000008685.2	chromosome	253158	254931	1773	99.3	0.0
B418P	contig_1	273038	272033	1005	renamed_GCF_000008685.2	chromosome	273647	272633	1005	96.4	1.213e-213
B418P	contig_1	273244	274627	1383	renamed_GCF_000008685.2	chromosome	273856	275236	1383	99.7	2.662e-303
B418P	contig_1	275948	276455	507	renamed_GCF_000008685.2	chromosome	276671	277064	507	100.0	6.298e-87
B418P	contig_6	21638	22094	456	renamed_GCF_000008685.2	cp32-4	8281	8737	456	98.0	2.391e-97
B418P	contig_6	22334	23609	1275	renamed_GCF_000008685.2	cp32-3	8967	10242	1275	98.1	2.081e-270
B418P	contig_7	7311	8088	777	renamed_GCF_000008685.2	lp56	29506	28729	777	99.6	6.988e-173
B418P	contig_7	10944	10371	573	renamed_GCF_000008685.2	cp32-7	22087	22660	573	100.0	7.629e-121
B418P	contig_7	12266	11516	750	renamed_GCF_000008685.2	cp32-7	20765	21515	750	100.0	2.593e-162
B418P	contig_8	5933	7034	1101	renamed_GCF_000008685.2	cp32-9	19163	20264	1101	98.0	6.254e-246
B418P	contig_8	7586	8342	756	renamed_GCF_000008685.2	cp32-9	20816	21572	756	99.6	4.781e-165
B418P	contig_8	19457	20021	564	renamed_GCF_000008685.2	cp32-6	2009	2573	564	99.4	1.105e-123
B418P	contig_8	22849	23233	384	renamed_GCF_000008685.2	cp32-9	5412	5796	384	99.2	1.452e-82
B418P	contig_8	23220	23610	390	renamed_GCF_000008685.2	cp32-9	5783	6173	390	100.0	3.229e-83
B418P	contig_10	15192	14529	663	renamed_GCF_000008685.2	lp17	11646	10983	663	100.0	1.005e-149
B418P	contig_10	16971	17712	741	renamed_GCF_000008685.2	lp17	13338	14079	741	99.5	7.64e-166
B418P	contig_10	17702	17972	270	renamed_GCF_000008685.2	lp17	14069	14339	270	97.7	1.824e-53
B418P	contig_15	10897	11236	339	renamed_GCF_000008685.2	lp28-2	18019	17680	339	100.0	5.085e-70
B418P	contig_15	11232	12423	1191	renamed_GCF_000008685.2	lp28-2	17684	16493	1191	100.0	6.781e-269
B418P	contig_15	13485	14031	546	renamed_GCF_000008685.2	lp28-2	15431	14885	546	99.4	2.156e-113
B418P	contig_15	14576	15410	834	renamed_GCF_000008685.2	lp28-2	14341	13507	834	99.2	1.36e-183
B418P	contig_15	15422	15761	339	renamed_GCF_000008685.2	lp28-2	13495	13156	339	100.0	3.422e-74
B418P	contig_15	16165	16609	444	renamed_GCF_000008685.2	lp28-2	12752	12308	444	100.0	8.866e-98
B418P	contig_16	11696	10946	750	renamed_GCF_000008685.2	lp36	14326	13576	750	99.5	5.248e-163
B418P	contig_16	13130	12203	927	renamed_GCF_000008685.2	lp36	15760	14833	927	98.7	7.534e-206
B418P	contig_16	13643	14255	612	renamed_GCF_000008685.2	lp36	16274	16886	612	100.0	9.153e-134
B418P	contig_18	1461	1971	510	renamed_GCF_000008685.2	lp54	1460	1970	510	100.0	8.829e-109
B418P	contig_18	2895	2046	849	renamed_GCF_000008685.2	lp54	2893	2044	849	100.0	5.332e-188
B418P	contig_18	5142	4668	474	renamed_GCF_000008685.2	lp54	5140	4666	474	96.1	3.509e-96
B418P	contig_18	23301	21711	1590	renamed_GCF_000008685.2	lp54	23273	21683	1590	99.6	0.0
B418P	contig_18	23804	24446	642	renamed_GCF_000008685.2	lp54	23776	24415	642	98.1	6.61e-134
B418P	contig_18	25490	26732	1242	renamed_GCF_000008685.2	lp54	25467	26694	1242	100.0	1.5e-268
B418P	contig_18	27417	28026	609	renamed_GCF_000008685.2	lp54	27389	27998	609	100.0	2.346e-131
B418P	contig_18	28041	28959	918	renamed_GCF_000008685.2	lp54	28013	28931	918	100.0	2.109e-201
B418P	contig_18	28962	29415	453	renamed_GCF_000008685.2	lp54	28934	29387	453	100.0	2.51e-96
B418P	contig_1	122353	121741	612	renamed_GCF_000008685.2	chromosome	122491	121879	612	98.5	7.99e-127
B418P	contig_1	124676	124010	666	renamed_GCF_000008685.2	chromosome	124814	124148	666	98.6	2.241e-141
B418P	contig_1	126163	125395	768	renamed_GCF_000008685.2	chromosome	126301	125533	768	99.6	7.315e-171
B418P	contig_1	127275	126177	1098	renamed_GCF_000008685.2	chromosome	127413	126315	1098	99.1	1.647e-234
B418P	contig_1	130976	130031	945	renamed_GCF_000008685.2	chromosome	131114	130169	945	100.0	6.888e-210
B418P	contig_1	147363	146244	1119	renamed_GCF_000008685.2	chromosome	147495	146376	1119	100.0	3.727e-246
B418P	contig_1	148527	147516	1011	renamed_GCF_000008685.2	chromosome	148659	147648	1011	99.7	2.697e-214
B418P	contig_1	150829	152035	1206	renamed_GCF_000008685.2	chromosome	150973	152179	1206	99.7	1.095e-274
B418P	contig_1	156256	153556	2700	renamed_GCF_000008685.2	chromosome	156400	153700	2700	99.7	0.0
B418P	contig_1	156318	157455	1137	renamed_GCF_000008685.2	chromosome	156461	157598	1137	100.0	1.164e-253
B418P	contig_1	195563	197567	2004	renamed_GCF_000008685.2	chromosome	195692	197696	2004	99.7	0.0
B418P	contig_1	214826	216659	1833	renamed_GCF_000008685.2	chromosome	215426	217259	1833	99.1	0.0
B418P	contig_1	218478	217824	654	renamed_GCF_000008685.2	chromosome	219078	218424	654	99.0	5.201e-147
B418P	contig_1	219199	220039	840	renamed_GCF_000008685.2	chromosome	219799	220639	840	99.6	8.103e-182
B418P	contig_1	221033	222578	1545	renamed_GCF_000008685.2	chromosome	221741	223178	1545	99.1	3.462e-310
B418P	contig_1	234935	234689	246	renamed_GCF_000008685.2	chromosome	235534	235288	246	98.7	3.025e-52
B418P	contig_1	236543	234995	1548	renamed_GCF_000008685.2	chromosome	237142	235594	1548	99.8	0.0
B418P	contig_1	237357	237030	327	renamed_GCF_000008685.2	chromosome	237956	237629	327	100.0	8.435e-71
B418P	contig_1	285350	283259	2091	renamed_GCF_000008685.2	chromosome	285962	283868	2091	99.4	0.0
B418P	contig_1	287268	286479	789	renamed_GCF_000008685.2	chromosome	287877	287088	789	100.0	1.783e-164
B418P	contig_1	288337	287572	765	renamed_GCF_000008685.2	chromosome	288946	288181	765	100.0	2.478e-165
B418P	contig_1	288974	288347	627	renamed_GCF_000008685.2	chromosome	289583	288956	627	99.5	6.305e-132
B418P	contig_1	290412	289353	1059	renamed_GCF_000008685.2	chromosome	291021	289962	1059	100.0	3.164e-229
B418P	contig_1	290986	290449	537	renamed_GCF_000008685.2	chromosome	291595	291058	537	100.0	7.638e-115
B418P	contig_1	301880	300170	1710	renamed_GCF_000008685.2	chromosome	302489	300779	1710	99.8	0.0
B418P	contig_1	302700	302241	459	renamed_GCF_000008685.2	chromosome	303309	302850	459	100.0	4.601e-99
B418P	contig_1	303131	302723	408	renamed_GCF_000008685.2	chromosome	303740	303332	408	99.2	2.649e-88
B418P	contig_1	305052	304503	549	renamed_GCF_000008685.2	chromosome	305661	305112	549	100.0	9.24e-115
B418P	contig_1	346689	346248	441	renamed_GCF_000008685.2	chromosome	347301	346860	441	100.0	1.706e-98
B418P	contig_1	348998	347540	1458	renamed_GCF_000008685.2	chromosome	349610	348152	1458	99.3	0.0
B418P	contig_1	350719	350443	276	renamed_GCF_000008685.2	chromosome	351331	351055	276	95.6	4.486e-53
B418P	contig_1	354027	352827	1200	renamed_GCF_000008685.2	chromosome	354636	353439	1200	98.7	3.302e-261
B418P	contig_1	354881	356300	1419	renamed_GCF_000008685.2	chromosome	355490	356909	1419	98.9	9.19e-313
B418P	contig_1	357848	358589	741	renamed_GCF_000008685.2	chromosome	358457	359198	741	99.1	2.251e-162
B418P	contig_1	360469	358903	1566	renamed_GCF_000008685.2	chromosome	361078	359512	1566	99.4	0.0
B418P	contig_1	363508	361708	1800	renamed_GCF_000008685.2	chromosome	364117	362317	1800	99.8	0.0
B418P	contig_1	373667	375044	1377	renamed_GCF_000008685.2	chromosome	374276	375653	1377	99.1	7.568e-308
B418P	contig_1	375051	375330	279	renamed_GCF_000008685.2	chromosome	375660	375939	279	100.0	3.143e-57
B418P	contig_1	428042	429071	1029	renamed_GCF_000008685.2	chromosome	428645	429674	1029	99.4	4.248e-238
B418P	contig_1	430007	429089	918	renamed_GCF_000008685.2	chromosome	430616	429692	918	98.6	5.143e-200
B418P	contig_1	441950	441110	840	renamed_GCF_000008685.2	chromosome	442552	441712	840	98.2	3.646e-182
B418P	contig_1	446270	445721	549	renamed_GCF_000008685.2	chromosome	446875	446326	549	99.4	4.738e-122
B418P	contig_1	447250	447568	318	renamed_GCF_000008685.2	chromosome	447854	448172	318	100.0	8.883e-69
B418P	contig_1	447987	447597	390	renamed_GCF_000008685.2	chromosome	448591	448201	390	100.0	7.926e-82
B418P	contig_1	448814	449567	753	renamed_GCF_000008685.2	chromosome	449418	450171	753	100.0	3.278e-160
B418P	contig_1	451317	450534	783	renamed_GCF_000008685.2	chromosome	451921	451138	783	99.6	5.024e-169
B418P	contig_1	455784	453879	1905	renamed_GCF_000008685.2	chromosome	456388	454483	1905	99.6	0.0
B418P	contig_1	457672	458830	1158	renamed_GCF_000008685.2	chromosome	458276	459434	1158	99.4	2.984e-255
B418P	contig_1	502349	502748	399	renamed_GCF_000008685.2	chromosome	502950	503349	399	99.2	3.385e-84
B418P	contig_1	503324	503684	360	renamed_GCF_000008685.2	chromosome	503925	504285	360	98.3	1.071e-73
B418P	contig_1	504197	504503	306	renamed_GCF_000008685.2	chromosome	504798	505104	306	99.0	3.271e-61
B418P	contig_1	504952	506257	1305	renamed_GCF_000008685.2	chromosome	505553	506858	1305	99.7	2.039e-284
B418P	contig_1	506400	506778	378	renamed_GCF_000008685.2	chromosome	507001	507379	378	100.0	8.763e-79
B418P	contig_1	523948	525649	1701	renamed_GCF_000008685.2	chromosome	524553	526254	1701	99.6	0.0
B418P	contig_1	528592	527497	1095	renamed_GCF_000008685.2	chromosome	529198	528103	1095	99.7	8.741e-250
B418P	contig_1	530499	528591	1908	renamed_GCF_000008685.2	chromosome	531105	529197	1908	100.0	0.0
B418P	contig_1	543226	544000	774	renamed_GCF_000008685.2	chromosome	543831	544605	774	99.6	8.828e-170
B418P	contig_1	557302	556684	618	renamed_GCF_000008685.2	chromosome	558024	557406	618	99.5	1.337e-130
B418P	contig_1	560405	560006	399	renamed_GCF_000008685.2	chromosome	561127	560728	399	94.6	2.734e-78
B418P	contig_1	561203	560822	381	renamed_GCF_000008685.2	chromosome	561943	561562	381	99.2	5.027e-77
B418P	contig_1	561444	563427	1983	renamed_GCF_000008685.2	chromosome	562184	564167	1983	99.6	0.0
B418P	contig_1	565229	567083	1854	renamed_GCF_000008685.2	chromosome	565954	567823	1854	99.6	0.0
B418P	contig_1	567529	568399	870	renamed_GCF_000008685.2	chromosome	568269	569139	870	99.6	3.86e-195
B418P	contig_1	577535	579680	2145	renamed_GCF_000008685.2	chromosome	578276	580421	2145	99.5	0.0
B418P	contig_1	580903	582676	1773	renamed_GCF_000008685.2	chromosome	581644	583417	1773	99.6	0.0
B418P	contig_1	584137	583447	690	renamed_GCF_000008685.2	chromosome	584880	584190	690	99.1	4.749e-154
B418P	contig_1	741979	743752	1773	renamed_GCF_000008685.2	chromosome	742743	744516	1773	99.3	0.0
B418P	contig_1	743757	744081	324	renamed_GCF_000008685.2	chromosome	744521	744845	324	100.0	1.32e-65
B418P	contig_1	749267	750026	759	renamed_GCF_000008685.2	chromosome	750030	750789	759	100.0	2.255e-165
B418P	contig_1	751406	752456	1050	renamed_GCF_000008685.2	chromosome	752169	753219	1050	100.0	6.109e-229
B418P	contig_1	753304	753787	483	renamed_GCF_000008685.2	chromosome	754067	754550	483	100.0	1.405e-107
B418P	contig_1	755590	756907	1317	renamed_GCF_000008685.2	chromosome	756353	757670	1317	99.5	1.417e-290
B418P	contig_1	759438	760884	1446	renamed_GCF_000008685.2	chromosome	760225	761647	1446	99.1	2.357e-315
B418P	contig_1	782587	784219	1632	renamed_GCF_000008685.2	chromosome	783389	785021	1632	99.6	0.0
B418P	contig_1	784254	785952	1698	renamed_GCF_000008685.2	chromosome	785056	786754	1698	99.2	0.0
B418P	contig_1	788517	789135	618	renamed_GCF_000008685.2	chromosome	789302	789938	618	99.5	1.684e-136
B418P	contig_1	790984	790003	981	renamed_GCF_000008685.2	chromosome	791787	790806	981	99.6	2.843e-217
B418P	contig_1	791449	790990	459	renamed_GCF_000008685.2	chromosome	792252	791793	459	99.3	2.509e-97
B418P	contig_1	794051	793058	993	renamed_GCF_000008685.2	chromosome	794855	793841	993	98.4	1.282e-219
B418P	contig_1	807163	806116	1047	renamed_GCF_000008685.2	chromosome	807966	806919	1047	99.1	2.878e-228
B418P	contig_1	808749	807657	1092	renamed_GCF_000008685.2	chromosome	809552	808460	1092	99.4	8.623e-241
B418P	contig_1	810707	809666	1041	renamed_GCF_000008685.2	chromosome	811510	810469	1041	99.4	6.771e-235
B418P	contig_1	823030	823597	567	renamed_GCF_000008685.2	chromosome	823815	824382	567	99.4	6.307e-122
B418P	contig_1	823596	824919	1323	renamed_GCF_000008685.2	chromosome	824381	825704	1323	100.0	8.966e-297
B418P	contig_1	824915	826835	1920	renamed_GCF_000008685.2	chromosome	825700	827620	1920	99.6	0.0
B418P	contig_1	826845	828327	1482	renamed_GCF_000008685.2	chromosome	827630	829112	1482	99.3	0.0
B418P	contig_1	828432	829536	1104	renamed_GCF_000008685.2	chromosome	829217	830321	1104	99.7	4.967e-249
B418P	contig_1	830156	829532	624	renamed_GCF_000008685.2	chromosome	830941	830317	624	99.5	5.702e-141
B418P	contig_1	830778	830169	609	renamed_GCF_000008685.2	chromosome	831563	830954	609	99.5	8.728e-134
B418P	contig_1	847689	847956	267	renamed_GCF_000008685.2	chromosome	848537	848804	267	100.0	3.495e-54
B418P	contig_1	847970	850139	2169	renamed_GCF_000008685.2	chromosome	848836	850987	2169	99.5	0.0
B418P	contig_1	851640	852930	1290	renamed_GCF_000008685.2	chromosome	852488	853778	1290	99.7	1.474e-285
B418P	contig_2	2320	1558	762	renamed_GCF_000008685.2	cp26	9274	10036	762	99.2	1.168e-164
B418P	contig_2	3759	2829	930	renamed_GCF_000008685.2	cp26	7835	8765	930	98.3	5.152e-202
B418P	contig_2	6826	5728	1098	renamed_GCF_000008685.2	cp26	4768	5866	1098	99.4	1.102e-247
B418P	contig_2	7511	7163	348	renamed_GCF_000008685.2	cp26	4083	4431	348	100.0	1.075e-71
B418P	contig_2	7796	9119	1323	renamed_GCF_000008685.2	cp26	3798	2475	1323	99.5	7.001e-291
B418P	contig_2	10841	11285	444	renamed_GCF_000008685.2	cp26	751	307	444	99.3	7.305e-100
B418P	contig_2	11547	11268	279	renamed_GCF_000008685.2	cp26	45	324	279	97.8	2.569e-59
B418P	contig_2	14836	13591	1245	renamed_GCF_000008685.2	cp26	23254	24499	1245	99.5	2.573e-280
B418P	contig_2	16193	15497	696	renamed_GCF_000008685.2	cp26	21897	22593	696	99.5	6.925e-151
B418P	contig_4	21872	22640	768	renamed_GCF_000008685.2	cp32-6	26256	27015	768	48.2	1.457e-66
B418P	contig_5	6565	5911	654	renamed_GCF_000008685.2	cp32-7	16551	17139	654	85.7	2.355e-113
B418P	contig_6	15942	15588	354	renamed_GCF_000008685.2	cp32-6	16102	16456	354	99.1	7.233e-77
B418P	contig_6	16607	16259	348	renamed_GCF_000008685.2	cp32-8	15421	15769	348	99.1	1.964e-73
B418P	contig_6	23631	24315	684	renamed_GCF_000008685.2	cp32-8	10264	10948	684	98.6	3.758e-147
B418P	contig_6	24318	25269	951	renamed_GCF_000008685.2	cp32-8	10951	11902	951	98.7	5.726e-213
B418P	contig_8	29320	29875	555	renamed_GCF_000008685.2	cp32-6	11929	12484	555	90.2	9.788e-107
B418P	contig_9	1063	2191	1128	renamed_GCF_000008685.2	cp9	162	1272	1128	92.1	1.418e-232
B418P	contig_9	2803	3364	561	renamed_GCF_000008685.2	cp9	1891	2452	561	94.6	1.867e-117
B418P	contig_9	3708	4617	909	renamed_GCF_000008685.2	cp9	2803	3712	909	98.3	2.329e-207
B418P	contig_10	7128	7350	222	renamed_GCF_000008685.2	lp17	3651	3819	222	100.0	6.565e-33
B418P	contig_10	8584	9268	684	renamed_GCF_000008685.2	lp17	5055	5739	684	99.1	6.297e-150
B418P	contig_10	9992	9413	579	renamed_GCF_000008685.2	lp17	6452	5873	579	98.9	1.16e-125
B418P	contig_10	11321	11648	327	renamed_GCF_000008685.2	lp17	7784	8111	327	99.0	2.291e-68
B418P	contig_10	11803	12916	1113	renamed_GCF_000008685.2	lp17	8266	9379	1113	98.3	1.837e-244
B418P	contig_11	10520	10013	507	renamed_GCF_000008685.2	lp25	10694	10199	507	81.0	1.157e-88
B418P	contig_11	11890	11308	582	renamed_GCF_000008685.2	lp25	12079	11497	582	100.0	4.521e-128
B418P	contig_11	12665	11906	759	renamed_GCF_000008685.2	lp25	12854	12095	759	100.0	2.255e-165
B418P	contig_16	3851	4127	276	renamed_GCF_000008685.2	lp36	6365	6650	276	100.0	1.214e-58
B418P	contig_16	6336	5640	696	renamed_GCF_000008685.2	lp36	8859	8163	696	96.9	1.009e-146
B418P	contig_16	7778	9425	1647	renamed_GCF_000008685.2	lp36	10300	11947	1647	99.8	0.0
B418P	contig_16	20182	19615	567	renamed_GCF_000008685.2	lp36	26358	25812	567	97.2	1.796e-110
B418P	contig_18	17310	16746	564	renamed_GCF_000008685.2	lp54	17259	16695	564	98.3	5.792e-114
B418P	contig_18	18178	18772	594	renamed_GCF_000008685.2	lp54	18127	18721	594	99.4	7.271e-125
B418P	contig_18	18775	20128	1353	renamed_GCF_000008685.2	lp54	18724	20077	1353	100.0	1.524e-304
B418P	contig_18	20745	20940	195	renamed_GCF_000008685.2	lp54	20717	20912	195	100.0	2.214e-39
B418P	contig_18	21114	21654	540	renamed_GCF_000008685.2	lp54	21086	21626	540	98.8	4.36e-113
B418P	contig_18	30121	30661	540	renamed_GCF_000008685.2	lp54	30093	30633	540	100.0	4.969e-120
B418P	contig_18	30727	31798	1071	renamed_GCF_000008685.2	lp54	30709	31780	1071	99.4	1.082e-234
B418P	contig_18	31797	32220	423	renamed_GCF_000008685.2	lp54	31779	32202	423	100.0	5.086e-92
B418P	contig_18	32278	32767	489	renamed_GCF_000008685.2	lp54	32260	32749	489	100.0	3.125e-108
B418P	contig_18	32759	32978	219	renamed_GCF_000008685.2	lp54	32741	32960	219	100.0	7.958e-46
B418P	contig_1	111	675	564	renamed_GCF_000008685.2	chromosome	104	677	564	100.0	4.108e-126
B418P	contig_1	3424	5218	1794	renamed_GCF_000008685.2	chromosome	3418	5188	1794	98.6	0.0
B418P	contig_1	7427	6338	1089	renamed_GCF_000008685.2	chromosome	7397	6308	1089	100.0	1.828e-240
B418P	contig_1	8456	9227	771	renamed_GCF_000008685.2	chromosome	8426	9197	771	100.0	1.781e-161
B418P	contig_1	10232	10607	375	renamed_GCF_000008685.2	chromosome	10202	10577	375	100.0	3.75e-79
B418P	contig_1	11450	12191	741	renamed_GCF_000008685.2	chromosome	11420	12161	741	99.1	4.555e-163
B418P	contig_1	15375	14754	621	renamed_GCF_000008685.2	chromosome	15345	14724	621	99.5	1.607e-137
B418P	contig_1	45317	45863	546	renamed_GCF_000008685.2	chromosome	45445	45991	546	98.8	3.601e-116
B418P	contig_1	47776	48478	702	renamed_GCF_000008685.2	chromosome	47916	48606	702	98.6	2.464e-146
B418P	contig_1	50346	49983	363	renamed_GCF_000008685.2	chromosome	50474	50111	363	100.0	4.578e-75
B418P	contig_1	53333	52325	1008	renamed_GCF_000008685.2	chromosome	53461	52453	1008	100.0	6.65e-221
B418P	contig_1	56152	55372	780	renamed_GCF_000008685.2	chromosome	56280	55500	780	99.6	1.628e-172
B418P	contig_1	57057	56703	354	renamed_GCF_000008685.2	chromosome	57185	56831	354	99.1	6.554e-78
B418P	contig_1	70241	71090	849	renamed_GCF_000008685.2	chromosome	70141	71219	849	98.9	5.332e-188
B418P	contig_1	75643	76324	681	renamed_GCF_000008685.2	chromosome	75773	76454	681	100.0	3.584e-147
B418P	contig_1	78873	77580	1293	renamed_GCF_000008685.2	chromosome	79009	77710	1293	93.4	8.802e-266
B418P	contig_1	119666	118826	840	renamed_GCF_000008685.2	chromosome	119803	118963	840	98.5	1.176e-177
B418P	contig_1	120944	120665	279	renamed_GCF_000008685.2	chromosome	121082	120803	279	100.0	1.411e-57
B418P	contig_1	137628	135735	1893	renamed_GCF_000008685.2	chromosome	137766	135873	1893	99.8	0.0
B418P	contig_1	144134	142811	1323	renamed_GCF_000008685.2	chromosome	144230	142943	1323	99.0	2.102e-278
B418P	contig_1	146238	145338	900	renamed_GCF_000008685.2	chromosome	146370	145470	900	100.0	6.779e-194
B418P	contig_1	159946	161065	1119	renamed_GCF_000008685.2	chromosome	160089	161208	1119	98.9	1.395e-248
B418P	contig_1	164677	162928	1749	renamed_GCF_000008685.2	chromosome	164820	163071	1749	99.4	0.0
B418P	contig_1	169256	167735	1521	renamed_GCF_000008685.2	chromosome	169399	167878	1521	99.2	0.0
B418P	contig_1	181263	179397	1866	renamed_GCF_000008685.2	chromosome	181405	179539	1866	99.3	0.0
B418P	contig_1	186411	186804	393	renamed_GCF_000008685.2	chromosome	186553	186946	393	100.0	5.626e-86
B418P	contig_1	188095	187681	414	renamed_GCF_000008685.2	chromosome	188237	187823	414	100.0	2.918e-88
B418P	contig_1	202465	200938	1527	renamed_GCF_000008685.2	chromosome	202578	201051	1527	98.8	0.0
B418P	contig_1	204959	205931	972	renamed_GCF_000008685.2	chromosome	205174	206044	972	99.6	3.289e-188
B418P	contig_1	224185	223363	822	renamed_GCF_000008685.2	chromosome	224785	223963	822	100.0	3.638e-179
B418P	contig_1	227922	227214	708	renamed_GCF_000008685.2	chromosome	228521	227813	708	99.5	4.758e-157
B418P	contig_1	228617	229625	1008	renamed_GCF_000008685.2	chromosome	229216	230224	1008	100.0	1.228e-222
B418P	contig_1	231738	234654	2916	renamed_GCF_000008685.2	chromosome	232337	235253	2916	99.4	0.0
B418P	contig_1	282078	281190	888	renamed_GCF_000008685.2	chromosome	282687	281799	888	100.0	4.025e-189
B418P	contig_1	291817	291034	783	renamed_GCF_000008685.2	chromosome	292426	291643	783	100.0	1.874e-171
B418P	contig_1	292599	291816	783	renamed_GCF_000008685.2	chromosome	293208	292425	783	100.0	6.057e-167
B418P	contig_1	292820	292595	225	renamed_GCF_000008685.2	chromosome	293429	293204	225	100.0	8.8e-46
B418P	contig_1	294171	292842	1329	renamed_GCF_000008685.2	chromosome	294780	293451	1329	99.5	1.183e-294
B418P	contig_1	294619	294175	444	renamed_GCF_000008685.2	chromosome	295228	294784	444	99.3	2.638e-94
B418P	contig_1	295811	294632	1179	renamed_GCF_000008685.2	chromosome	296420	295241	1179	98.9	1.413e-258
B418P	contig_1	296436	295818	618	renamed_GCF_000008685.2	chromosome	297045	296427	618	99.5	5.47e-132
B418P	contig_1	296860	296428	432	renamed_GCF_000008685.2	chromosome	297469	297037	432	98.6	4.841e-94
B418P	contig_1	298167	296856	1311	renamed_GCF_000008685.2	chromosome	298776	297465	1311	100.0	6.981e-289
B418P	contig_1	299106	298185	921	renamed_GCF_000008685.2	chromosome	299715	298794	921	99.3	1.132e-191
B418P	contig_1	309170	307928	1242	renamed_GCF_000008685.2	chromosome	309780	308538	1242	99.7	3.039e-269
B418P	contig_1	309913	309169	744	renamed_GCF_000008685.2	chromosome	310523	309779	744	100.0	5.245e-162
B418P	contig_1	311043	309948	1095	renamed_GCF_000008685.2	chromosome	311617	310558	1095	99.4	1.229e-228
B418P	contig_1	312105	311049	1056	renamed_GCF_000008685.2	chromosome	312715	311659	1056	100.0	1.239e-230
B418P	contig_1	313514	312122	1392	renamed_GCF_000008685.2	chromosome	314123	312728	1392	99.7	5.166e-306
B418P	contig_1	313818	313536	282	renamed_GCF_000008685.2	chromosome	314427	314145	282	100.0	2.699e-59
B418P	contig_1	314705	313814	891	renamed_GCF_000008685.2	chromosome	315314	314423	891	100.0	4.455e-197
B418P	contig_1	315534	314697	837	renamed_GCF_000008685.2	chromosome	316143	315306	837	99.2	1.426e-183
B418P	contig_1	316607	315530	1077	renamed_GCF_000008685.2	chromosome	317216	316139	1077	99.4	4.444e-237
B418P	contig_1	317396	316637	759	renamed_GCF_000008685.2	chromosome	318005	317246	759	100.0	1.223e-163
B418P	contig_1	327422	328559	1137	renamed_GCF_000008685.2	chromosome	328031	329165	1137	99.4	3.111e-251
B418P	contig_1	328655	329015	360	renamed_GCF_000008685.2	chromosome	329261	329621	360	100.0	1.609e-77
B418P	contig_1	330146	329036	1110	renamed_GCF_000008685.2	chromosome	330752	329642	1110	98.9	1.212e-248
B418P	contig_1	333001	330196	2805	renamed_GCF_000008685.2	chromosome	333598	330802	2805	99.3	0.0
B418P	contig_1	333918	333021	897	renamed_GCF_000008685.2	chromosome	334515	333618	897	99.6	8.226e-200
B418P	contig_1	334324	335896	1572	renamed_GCF_000008685.2	chromosome	334936	336508	1572	99.8	0.0
B418P	contig_1	337745	339371	1626	renamed_GCF_000008685.2	chromosome	338357	339983	1626	99.6	0.0
B418P	contig_1	339728	340649	921	renamed_GCF_000008685.2	chromosome	340340	341261	921	98.6	3.516e-196
B418P	contig_1	340661	341711	1050	renamed_GCF_000008685.2	chromosome	341273	342323	1050	100.0	1.489e-227
B418P	contig_1	364471	363520	951	renamed_GCF_000008685.2	chromosome	364972	364129	951	98.9	1.288e-186
B418P	contig_1	364994	364505	489	renamed_GCF_000008685.2	chromosome	365603	365114	489	100.0	3.787e-106
B418P	contig_1	366351	365619	732	renamed_GCF_000008685.2	chromosome	366960	366228	732	97.9	6.321e-158
B418P	contig_1	367846	368272	426	renamed_GCF_000008685.2	chromosome	368455	368881	426	92.9	3.139e-81
B418P	contig_1	368275	369418	1143	renamed_GCF_000008685.2	chromosome	368884	370027	1143	99.4	3.521e-242
B418P	contig_1	369417	370404	987	renamed_GCF_000008685.2	chromosome	370026	371013	987	99.3	3.978e-223
B418P	contig_1	370424	372437	2013	renamed_GCF_000008685.2	chromosome	371033	373046	2013	99.1	0.0
B418P	contig_1	394557	393495	1062	renamed_GCF_000008685.2	chromosome	395166	394104	1062	99.7	9.401e-235
B418P	contig_1	395898	394872	1026	renamed_GCF_000008685.2	chromosome	396506	395480	1026	99.7	3.294e-223
B418P	contig_1	396469	395995	474	renamed_GCF_000008685.2	chromosome	397077	396603	474	100.0	4.822e-101
B418P	contig_1	396868	396493	375	renamed_GCF_000008685.2	chromosome	397476	397101	375	100.0	1.385e-81
B418P	contig_1	401069	396935	4134	renamed_GCF_000008685.2	chromosome	401677	397543	4134	99.7	0.0
B418P	contig_1	405009	404634	375	renamed_GCF_000008685.2	chromosome	405617	405242	375	99.1	2.753e-74
B418P	contig_1	405568	405079	489	renamed_GCF_000008685.2	chromosome	406176	405687	489	99.3	2.753e-101
B418P	contig_1	406253	405572	681	renamed_GCF_000008685.2	chromosome	406861	406180	681	99.5	1.335e-149
B418P	contig_1	406684	406252	432	renamed_GCF_000008685.2	chromosome	407292	406860	432	100.0	3.534e-89
B418P	contig_1	407290	406735	555	renamed_GCF_000008685.2	chromosome	407898	407343	555	100.0	5.734e-121
B418P	contig_1	417114	417726	612	renamed_GCF_000008685.2	chromosome	417723	418335	612	99.0	7.572e-136
B418P	contig_1	418897	417778	1119	renamed_GCF_000008685.2	chromosome	419506	418387	1119	99.7	3.957e-254
B418P	contig_1	420774	418893	1881	renamed_GCF_000008685.2	chromosome	421380	419502	1881	99.3	0.0
B418P	contig_1	420948	421578	630	renamed_GCF_000008685.2	chromosome	421553	422183	630	98.0	1.685e-138
B418P	contig_1	422452	423232	780	renamed_GCF_000008685.2	chromosome	423054	423834	780	100.0	3.296e-173
B418P	contig_1	423843	423219	624	renamed_GCF_000008685.2	chromosome	424442	423821	624	99.5	4.527e-135
B418P	contig_1	424090	424948	858	renamed_GCF_000008685.2	chromosome	424693	425551	858	100.0	1.579e-194
B418P	contig_1	424980	426108	1128	renamed_GCF_000008685.2	chromosome	425583	426711	1128	100.0	1.044e-244
B418P	contig_1	470626	469366	1260	renamed_GCF_000008685.2	chromosome	471220	469960	1260	99.0	6.777e-272
B418P	contig_1	489130	489952	822	renamed_GCF_000008685.2	chromosome	489732	490554	822	99.6	6.11e-182
B418P	contig_1	490041	491325	1284	renamed_GCF_000008685.2	chromosome	490643	491927	1284	99.7	1.048e-279
B418P	contig_1	491985	493350	1365	renamed_GCF_000008685.2	chromosome	492587	493952	1365	100.0	1.721e-296
B418P	contig_1	493940	493547	393	renamed_GCF_000008685.2	chromosome	494539	494149	393	99.2	2.252e-79
B418P	contig_1	494431	495616	1185	renamed_GCF_000008685.2	chromosome	495032	496217	1185	100.0	4.832e-263
B418P	contig_1	495666	495978	312	renamed_GCF_000008685.2	chromosome	496267	496579	312	100.0	2.953e-63
B418P	contig_1	496013	496634	621	renamed_GCF_000008685.2	chromosome	496614	497235	621	99.5	8.732e-136
B418P	contig_1	496643	497273	630	renamed_GCF_000008685.2	chromosome	497244	497874	630	100.0	4.528e-136
B418P	contig_1	497293	497590	297	renamed_GCF_000008685.2	chromosome	497894	498191	297	100.0	5.69e-62
B418P	contig_1	497611	498445	834	renamed_GCF_000008685.2	chromosome	498212	499046	834	99.6	4.213e-188
B418P	contig_1	507212	508247	1035	renamed_GCF_000008685.2	chromosome	507813	508848	1035	99.4	2.25e-220
B418P	contig_1	508268	508640	372	renamed_GCF_000008685.2	chromosome	508869	509241	372	99.1	4.349e-77
B418P	contig_1	508712	510245	1533	renamed_GCF_000008685.2	chromosome	509313	510846	1533	100.0	0.0
B418P	contig_1	510234	511023	789	renamed_GCF_000008685.2	chromosome	510835	511624	789	98.8	1.876e-172
B418P	contig_1	512538	511791	747	renamed_GCF_000008685.2	chromosome	513139	512392	747	100.0	7.284e-159
B418P	contig_1	512624	513926	1302	renamed_GCF_000008685.2	chromosome	513225	514527	1302	99.5	3.945e-285
B418P	contig_1	513922	515182	1260	renamed_GCF_000008685.2	chromosome	514523	515783	1260	99.5	2.704e-282
B418P	contig_1	556701	555963	738	renamed_GCF_000008685.2	chromosome	557423	556562	738	84.2	1.47e-149
B418P	contig_1	568536	568797	261	renamed_GCF_000008685.2	chromosome	569277	569538	261	100.0	9.575e-51
B418P	contig_1	568817	570539	1722	renamed_GCF_000008685.2	chromosome	569558	571280	1722	99.8	0.0
B418P	contig_1	570541	571111	570	renamed_GCF_000008685.2	chromosome	571282	571852	570	100.0	1.471e-121
B418P	contig_1	572999	571148	1851	renamed_GCF_000008685.2	chromosome	573740	571889	1851	100.0	0.0
B418P	contig_1	573111	574506	1395	renamed_GCF_000008685.2	chromosome	573852	575247	1395	98.4	3.423e-311
B418P	contig_1	575075	574532	543	renamed_GCF_000008685.2	chromosome	575816	575273	543	98.8	3.433e-116
B418P	contig_1	575785	575239	546	renamed_GCF_000008685.2	chromosome	576499	575980	546	100.0	1.781e-115
B418P	contig_1	576446	575840	606	renamed_GCF_000008685.2	chromosome	577187	576581	606	99.5	1.106e-130
B418P	contig_1	576653	577196	543	renamed_GCF_000008685.2	chromosome	577394	577937	543	99.4	3.433e-116
B418P	contig_1	617809	615661	2148	renamed_GCF_000008685.2	chromosome	618559	616411	2148	99.7	0.0
B418P	contig_1	644848	644383	465	renamed_GCF_000008685.2	chromosome	645601	645136	465	99.3	2.067e-100
B418P	contig_1	644965	645928	963	renamed_GCF_000008685.2	chromosome	645718	646681	963	99.6	1.275e-214
B418P	contig_1	647573	645905	1668	renamed_GCF_000008685.2	chromosome	648254	646658	1668	99.8	0.0
B418P	contig_1	647799	648354	555	renamed_GCF_000008685.2	chromosome	648552	649107	555	99.4	3.12e-119
B418P	contig_1	649634	648416	1218	renamed_GCF_000008685.2	chromosome	650387	649169	1218	99.2	6.716e-265
B418P	contig_1	653038	649660	3378	renamed_GCF_000008685.2	chromosome	653790	650412	3378	99.2	0.0
B418P	contig_1	653134	654097	963	renamed_GCF_000008685.2	chromosome	653886	654849	963	99.6	2.583e-215
B418P	contig_1	654056	656150	2094	renamed_GCF_000008685.2	chromosome	654862	656902	2094	98.6	0.0
B418P	contig_1	658145	658871	726	renamed_GCF_000008685.2	chromosome	658897	659623	726	99.1	3.767e-154
B418P	contig_1	687739	689377	1638	renamed_GCF_000008685.2	chromosome	688489	690127	1638	100.0	0.0
B418P	contig_1	689442	689739	297	renamed_GCF_000008685.2	chromosome	690192	690489	297	100.0	1.037e-63
B418P	contig_1	689752	690049	297	renamed_GCF_000008685.2	chromosome	690481	690799	297	98.9	6.955e-60
B418P	contig_1	690133	691894	1761	renamed_GCF_000008685.2	chromosome	690884	692645	1761	99.3	0.0
B418P	contig_1	691877	692777	900	renamed_GCF_000008685.2	chromosome	692628	693528	900	99.6	4.423e-190
B418P	contig_1	692802	693945	1143	renamed_GCF_000008685.2	chromosome	693553	694696	1143	99.4	9.695e-257
B418P	contig_1	694772	693941	831	renamed_GCF_000008685.2	chromosome	695523	694692	831	99.6	1.298e-183
B418P	contig_1	694870	696004	1134	renamed_GCF_000008685.2	chromosome	695630	696764	1134	98.4	9.239e-256
B418P	contig_1	696677	695990	687	renamed_GCF_000008685.2	chromosome	697437	696750	687	99.5	1.468e-149
B418P	contig_1	728849	729743	894	renamed_GCF_000008685.2	chromosome	729612	730506	894	98.9	1.372e-193
B418P	contig_1	730336	729868	468	renamed_GCF_000008685.2	chromosome	731099	730631	468	97.4	5.314e-99
B418P	contig_1	730420	730957	537	renamed_GCF_000008685.2	chromosome	731183	731720	537	100.0	1.936e-121
B418P	contig_1	731030	733040	2010	renamed_GCF_000008685.2	chromosome	731793	733803	2010	99.1	0.0
B418P	contig_1	733316	734525	1209	renamed_GCF_000008685.2	chromosome	734080	735289	1209	100.0	8.188e-270
B418P	contig_1	734587	735922	1335	renamed_GCF_000008685.2	chromosome	735351	736686	1335	99.7	2.962e-285
B418P	contig_1	735934	736195	261	renamed_GCF_000008685.2	chromosome	736698	736959	261	98.8	3.165e-54
B418P	contig_1	736195	736444	249	renamed_GCF_000008685.2	chromosome	736959	737208	249	100.0	2.148e-48
B418P	contig_1	736447	736948	501	renamed_GCF_000008685.2	chromosome	737211	737712	501	99.3	4.586e-106
B418P	contig_1	736944	737664	720	renamed_GCF_000008685.2	chromosome	737708	738428	720	99.5	4.764e-159
B418P	contig_1	737641	738007	366	renamed_GCF_000008685.2	chromosome	738405	738771	366	100.0	9.695e-76
B418P	contig_1	797244	796314	930	renamed_GCF_000008685.2	chromosome	798048	797118	930	100.0	3.063e-199
B418P	contig_1	798212	797252	960	renamed_GCF_000008685.2	chromosome	799016	798056	960	99.6	2.967e-213
B418P	contig_1	799471	798403	1068	renamed_GCF_000008685.2	chromosome	800275	799207	1068	99.7	8.292e-246
B418P	contig_1	799671	800268	597	renamed_GCF_000008685.2	chromosome	800475	801072	597	99.4	1.402e-126
B418P	contig_1	800206	800974	768	renamed_GCF_000008685.2	chromosome	801118	801778	768	99.0	1.204e-139
B418P	contig_1	801995	801137	858	renamed_GCF_000008685.2	chromosome	802798	801940	858	100.0	3.462e-177
B418P	contig_1	802364	802034	330	renamed_GCF_000008685.2	chromosome	803167	802837	330	100.0	2.178e-69
B418P	contig_1	846642	847491	849	renamed_GCF_000008685.2	chromosome	847490	848339	849	98.2	1.889e-182
B418P	contig_1	861851	862799	948	renamed_GCF_000008685.2	chromosome	862698	863646	948	100.0	4.292e-207
B418P	contig_1	862788	864195	1407	renamed_GCF_000008685.2	chromosome	863635	865042	1407	99.3	1.546e-313
B418P	contig_1	864214	865072	858	renamed_GCF_000008685.2	chromosome	865052	865919	858	99.6	3.329e-186
B418P	contig_1	865068	865611	543	renamed_GCF_000008685.2	chromosome	865915	866458	543	99.4	5.734e-119
B418P	contig_1	865646	865847	201	renamed_GCF_000008685.2	chromosome	866493	866694	201	100.0	2.206e-40
B418P	contig_1	865833	866754	921	renamed_GCF_000008685.2	chromosome	866680	867601	921	99.6	6.858e-206
B418P	contig_1	867267	866895	372	renamed_GCF_000008685.2	chromosome	868114	867742	372	100.0	7.954e-79
B418P	contig_1	867347	867893	546	renamed_GCF_000008685.2	chromosome	868194	868740	546	99.4	4.105e-123
B418P	contig_2	176	674	498	renamed_GCF_000008685.2	cp26	11417	10919	498	99.3	3.972e-107
B418P	contig_2	18769	20125	1356	renamed_GCF_000008685.2	cp26	19321	17965	1356	99.3	9.723e-293
B418P	contig_2	21206	20576	630	renamed_GCF_000008685.2	cp26	16902	17535	630	73.8	2.146e-93
B418P	contig_2	21439	22978	1539	renamed_GCF_000008685.2	cp26	16667	15131	1539	98.6	0.0
B418P	contig_2	23002	24217	1215	renamed_GCF_000008685.2	cp26	15107	13892	1215	98.5	7.027e-264
B418P	contig_2	26096	24503	1593	renamed_GCF_000008685.2	cp26	12013	13606	1593	99.0	0.0
B418P	contig_3	1927	1051	876	renamed_GCF_000008685.2	cp32-3	12823	13699	876	99.6	2.77e-191
B418P	contig_3	2256	1923	333	renamed_GCF_000008685.2	cp32-8	12494	12827	333	100.0	8.424e-72
B418P	contig_3	2831	2285	546	renamed_GCF_000008685.2	cp32-7	11927	12473	546	100.0	8.009e-116
B418P	contig_5	1295	749	546	renamed_GCF_000008685.2	cp32-4	21414	21960	546	100.0	3.273e-117
B418P	contig_5	2101	1345	756	renamed_GCF_000008685.2	cp32-4	20608	21364	756	99.2	8.81e-167
B418P	contig_5	3753	2652	1101	renamed_GCF_000008685.2	cp32-6	19068	20169	1101	95.0	3.187e-236
B418P	contig_5	12642	11949	693	renamed_GCF_000008685.2	cp32-7	26151	26841	693	94.3	8.36e-140
B418P	contig_7	11477	10955	522	renamed_GCF_000008685.2	cp32-7	21521	22076	522	100.0	1.473e-113
B418P	contig_7	13915	12817	1098	renamed_GCF_000008685.2	cp32-7	19116	20214	1098	96.7	1.749e-242
B418P	contig_8	3295	3796	501	renamed_GCF_000008685.2	cp32-4	16496	16997	501	100.0	5.048e-105
B418P	contig_8	7044	7611	567	renamed_GCF_000008685.2	cp32-9	20274	20841	567	98.9	1.602e-128
B418P	contig_8	8383	8944	561	renamed_GCF_000008685.2	cp32-9	21613	22174	561	100.0	6.308e-121
B418P	contig_8	18753	19446	693	renamed_GCF_000008685.2	lp56	35114	35807	693	97.3	1.692e-140
B418P	contig_12	26088	26490	402	renamed_GCF_000008685.2	lp28-2	25979	26390	402	88.0	3.163e-77
B418P	contig_12	28116	28830	714	renamed_GCF_000008685.2	lp28-2	28030	28831	714	87.9	8.759e-143
B418P	contig_13	8549	7919	630	renamed_GCF_000008685.2	lp28-3	18797	19427	630	100.0	1.007e-135
B418P	contig_14	8692	9337	645	renamed_GCF_000008685.2	lp28-4	7182	8538	645	95.3	8.369e-132
B418P	contig_14	13715	14270	555	renamed_GCF_000008685.2	lp28-4	11923	12478	555	100.0	3.559e-126
B418P	contig_14	15056	15629	573	renamed_GCF_000008685.2	lp28-4	13264	13837	573	100.0	2.579e-124
B418P	contig_15	10107	10887	780	renamed_GCF_000008685.2	lp28-2	18827	18029	780	73.6	3.134e-122
B418P	contig_15	12434	13460	1026	renamed_GCF_000008685.2	lp28-2	16482	15456	1026	99.7	8.508e-230
B418P	contig_15	14031	14541	510	renamed_GCF_000008685.2	lp28-2	14885	14375	510	98.8	3.969e-109
B418P	contig_15	15776	16169	393	renamed_GCF_000008685.2	lp28-2	13141	12748	393	99.2	3.389e-83
B418P	contig_16	9916	10474	558	renamed_GCF_000008685.2	lp36	12601	13237	558	98.7	2.195e-98
B418P	contig_16	12211	11671	540	renamed_GCF_000008685.2	lp36	14841	14301	540	100.0	2.234e-120
B418P	contig_16	14750	14954	204	renamed_GCF_000008685.2	lp36	17379	17583	204	100.0	8.441e-43
B418P	contig_17	9132	8856	276	renamed_GCF_000008685.2	lp38	9155	8876	276	97.8	3.31e-56
B418P	contig_17	12029	11291	738	renamed_GCF_000008685.2	lp38	11889	11151	738	98.3	4.772e-162
B418P	contig_17	13574	12584	990	renamed_GCF_000008685.2	lp38	13440	12444	990	98.1	6.042e-219
B418P	contig_17	17518	18301	783	renamed_GCF_000008685.2	lp38	17387	18170	783	99.2	8.433e-172
B418P	contig_17	19443	20139	696	renamed_GCF_000008685.2	lp38	19312	20008	696	100.0	6.303e-152
B418P	contig_1	63908	65147	1239	renamed_GCF_000008685.2	chromosome	64037	65276	1239	99.7	2.817e-278
B418P	contig_1	65161	65623	462	renamed_GCF_000008685.2	chromosome	65290	65752	462	100.0	3.193e-95
B418P	contig_1	67118	69440	2322	renamed_GCF_000008685.2	chromosome	67247	69569	2322	99.0	0.0
B418P	contig_1	103633	102877	756	renamed_GCF_000008685.2	chromosome	103771	103015	756	99.6	2.151e-165
B418P	contig_1	105717	105279	438	renamed_GCF_000008685.2	chromosome	105846	105417	438	99.2	1.748e-89
B418P	contig_1	110904	109536	1368	renamed_GCF_000008685.2	chromosome	111042	109674	1368	100.0	1.976e-295
B418P	contig_1	112200	111750	450	renamed_GCF_000008685.2	chromosome	112338	111888	450	99.3	9.762e-98
B418P	contig_1	124008	122352	1656	renamed_GCF_000008685.2	chromosome	124146	122490	1656	99.2	0.0
B418P	contig_1	125409	124659	750	renamed_GCF_000008685.2	chromosome	125547	124797	750	100.0	1.281e-161
B418P	contig_1	179401	178774	627	renamed_GCF_000008685.2	chromosome	179543	178916	627	99.0	1.402e-131
B418P	contig_1	189717	189156	561	renamed_GCF_000008685.2	chromosome	189859	189298	561	100.0	1.275e-121
B418P	contig_1	190589	191330	741	renamed_GCF_000008685.2	chromosome	190718	191459	741	98.7	8.782e-156
B418P	contig_1	193334	192194	1140	renamed_GCF_000008685.2	chromosome	193463	192323	1140	99.4	2.055e-256
B418P	contig_1	194746	195607	861	renamed_GCF_000008685.2	chromosome	194875	195736	861	97.5	2.076e-183
B418P	contig_1	211186	211954	768	renamed_GCF_000008685.2	chromosome	211300	212068	768	100.0	8.822e-169
B418P	contig_1	216680	217712	1032	renamed_GCF_000008685.2	chromosome	217277	218312	1032	98.2	5.739e-218
B418P	contig_1	219034	218455	579	renamed_GCF_000008685.2	chromosome	219634	219055	579	100.0	8.388e-121
B418P	contig_1	220128	221037	909	renamed_GCF_000008685.2	chromosome	220728	221637	909	99.3	4.638e-191
B418P	contig_1	222578	223361	783	renamed_GCF_000008685.2	chromosome	223178	223961	783	98.8	4.166e-171
B418P	contig_1	289308	288966	342	renamed_GCF_000008685.2	chromosome	289917	289575	342	100.0	1.077e-70
B418P	contig_1	300155	299120	1035	renamed_GCF_000008685.2	chromosome	300764	299729	1035	100.0	3.255e-216
B418P	contig_1	302227	301894	333	renamed_GCF_000008685.2	chromosome	302839	302503	333	99.0	1.253e-67
B418P	contig_1	304511	303164	1347	renamed_GCF_000008685.2	chromosome	305120	303773	1347	100.0	1.016e-290
B418P	contig_1	306707	306014	693	renamed_GCF_000008685.2	chromosome	307317	306624	693	100.0	2.971e-151
B418P	contig_1	318507	317667	840	renamed_GCF_000008685.2	chromosome	319116	318276	840	99.6	1.977e-180
B418P	contig_1	319649	319070	579	renamed_GCF_000008685.2	chromosome	320249	319679	579	98.9	3.43e-122
B418P	contig_1	322237	321430	807	renamed_GCF_000008685.2	chromosome	322846	322039	807	98.8	5.036e-173
B418P	contig_1	323170	322237	933	renamed_GCF_000008685.2	chromosome	323779	322846	933	100.0	1.839e-205
B418P	contig_1	327118	326089	1029	renamed_GCF_000008685.2	chromosome	327757	326698	1029	98.2	9.781e-229
B418P	contig_1	376410	375351	1059	renamed_GCF_000008685.2	chromosome	377019	375960	1059	97.7	8.454e-227
B418P	contig_1	379949	378731	1218	renamed_GCF_000008685.2	chromosome	380558	379340	1218	99.2	2.093e-269
B418P	contig_1	383553	382785	768	renamed_GCF_000008685.2	chromosome	384162	383394	768	99.6	9.689e-168
B418P	contig_1	407772	407592	180	renamed_GCF_000008685.2	chromosome	408380	408200	180	100.0	2.118e-37
B418P	contig_1	409839	408807	1032	renamed_GCF_000008685.2	chromosome	410447	409415	1032	99.4	1.191e-235
B418P	contig_1	412503	413712	1209	renamed_GCF_000008685.2	chromosome	413112	414315	1209	99.7	3.463e-262
B418P	contig_1	416079	416496	417	renamed_GCF_000008685.2	chromosome	416688	417105	417	100.0	1.248e-89
B418P	contig_1	427383	428019	636	renamed_GCF_000008685.2	chromosome	427986	428622	636	99.0	8.334e-139
B418P	contig_1	434500	430015	4485	renamed_GCF_000008685.2	chromosome	435103	430618	4485	99.4	0.0
B418P	contig_1	442643	442082	561	renamed_GCF_000008685.2	chromosome	443248	442687	561	99.4	1.054e-123
B418P	contig_1	484947	485475	528	renamed_GCF_000008685.2	chromosome	485549	486077	528	99.4	2.233e-118
B418P	contig_1	486114	486936	822	renamed_GCF_000008685.2	chromosome	486746	487538	822	99.6	9.243e-169
B418P	contig_1	487623	488370	747	renamed_GCF_000008685.2	chromosome	488225	488972	747	99.5	1.867e-165
B418P	contig_1	488889	489117	228	renamed_GCF_000008685.2	chromosome	489539	489719	228	100.0	1.455e-33
B418P	contig_1	499105	499987	882	renamed_GCF_000008685.2	chromosome	499706	500588	882	97.9	1.81e-188
B418P	contig_1	500613	500868	255	renamed_GCF_000008685.2	chromosome	501214	501469	255	100.0	1.745e-51
B418P	contig_1	501589	502138	549	renamed_GCF_000008685.2	chromosome	502190	502739	549	100.0	1.698e-116
B418P	contig_1	502764	503307	543	renamed_GCF_000008685.2	chromosome	503365	503908	543	100.0	7.636e-116
B418P	contig_1	503696	504194	498	renamed_GCF_000008685.2	chromosome	504297	504795	498	99.3	8.835e-107
B418P	contig_1	504502	504940	438	renamed_GCF_000008685.2	chromosome	505103	505541	438	99.3	5.873e-93
B418P	contig_1	604021	602977	1044	renamed_GCF_000008685.2	chromosome	604769	603725	1044	99.4	1.577e-234
B418P	contig_1	618077	620285	2208	renamed_GCF_000008685.2	chromosome	618827	621035	2208	99.7	0.0
B418P	contig_1	621203	620294	909	renamed_GCF_000008685.2	chromosome	621953	621044	909	98.3	4.467e-200
B418P	contig_1	621254	622697	1443	renamed_GCF_000008685.2	chromosome	622004	623447	1443	98.9	0.0
B418P	contig_1	622700	624257	1557	renamed_GCF_000008685.2	chromosome	623450	625007	1557	98.8	0.0
B418P	contig_1	624256	625510	1254	renamed_GCF_000008685.2	chromosome	625006	626260	1254	100.0	1.925e-276
B418P	contig_1	625535	626288	753	renamed_GCF_000008685.2	chromosome	626285	627038	753	99.2	2.052e-165
B418P	contig_1	628198	626341	1857	renamed_GCF_000008685.2	chromosome	628948	627091	1857	99.5	0.0
B418P	contig_1	629948	628445	1503	renamed_GCF_000008685.2	chromosome	630698	629195	1503	99.8	5e-324
B418P	contig_1	630018	631236	1218	renamed_GCF_000008685.2	chromosome	630795	631986	1218	99.4	4.366e-261
B418P	contig_1	644018	644387	369	renamed_GCF_000008685.2	chromosome	644771	645140	369	100.0	1.529e-79
B418P	contig_1	660763	658891	1872	renamed_GCF_000008685.2	chromosome	661515	659643	1872	99.0	0.0
B418P	contig_1	660853	661777	924	renamed_GCF_000008685.2	chromosome	661605	662529	924	98.6	2.789e-199
B418P	contig_1	662165	661850	315	renamed_GCF_000008685.2	chromosome	662917	662602	315	99.0	2.806e-64
B418P	contig_1	664258	662425	1833	renamed_GCF_000008685.2	chromosome	665011	663178	1833	99.5	0.0
B418P	contig_1	667764	664254	3510	renamed_GCF_000008685.2	chromosome	668517	665007	3510	99.4	0.0
B418P	contig_1	672458	671012	1446	renamed_GCF_000008685.2	chromosome	673167	671766	1446	99.1	2.204e-307
B418P	contig_1	672587	674024	1437	renamed_GCF_000008685.2	chromosome	673341	674778	1437	99.5	0.0
B418P	contig_1	674280	675624	1344	renamed_GCF_000008685.2	chromosome	675034	676378	1344	99.5	1.793e-292
B418P	contig_1	699204	697638	1566	renamed_GCF_000008685.2	chromosome	699965	698399	1566	99.4	0.0
B418P	contig_1	700267	700624	357	renamed_GCF_000008685.2	chromosome	701028	701385	357	100.0	2.301e-81
B418P	contig_1	701063	701513	450	renamed_GCF_000008685.2	chromosome	701824	702274	450	97.9	2.393e-96
B418P	contig_1	702247	703207	960	renamed_GCF_000008685.2	chromosome	703008	703968	960	99.6	6.008e-214
B418P	contig_1	704187	704739	552	renamed_GCF_000008685.2	chromosome	704948	705500	552	98.9	6.015e-120
B418P	contig_1	708510	709911	1401	renamed_GCF_000008685.2	chromosome	709273	710674	1401	99.3	1.003e-308
B418P	contig_1	710447	710888	441	renamed_GCF_000008685.2	chromosome	711210	711651	441	100.0	1.245e-93
B418P	contig_1	712487	711440	1047	renamed_GCF_000008685.2	chromosome	713250	712203	1047	100.0	4.165e-224
B418P	contig_1	714003	713340	663	renamed_GCF_000008685.2	chromosome	714766	714103	663	99.5	6.591e-146
B418P	contig_1	763607	764579	972	renamed_GCF_000008685.2	chromosome	764370	765342	972	100.0	2.973e-215
B418P	contig_1	767301	765969	1332	renamed_GCF_000008685.2	chromosome	768064	766732	1332	98.1	4.353e-289
B418P	contig_1	770800	770398	402	renamed_GCF_000008685.2	chromosome	771563	771161	402	100.0	3.917e-83
B418P	contig_1	775982	776771	789	renamed_GCF_000008685.2	chromosome	776784	777573	789	98.8	4.578e-171
B418P	contig_1	777955	780583	2628	renamed_GCF_000008685.2	chromosome	778757	781385	2628	99.0	0.0
B418P	contig_1	782446	782173	273	renamed_GCF_000008685.2	chromosome	783248	782975	273	100.0	3.858e-54
B418P	contig_1	786057	788160	2103	renamed_GCF_000008685.2	chromosome	786859	788962	2103	99.8	0.0
B418P	contig_1	790004	789143	861	renamed_GCF_000008685.2	chromosome	790807	789946	861	100.0	1.57e-186
B418P	contig_1	791547	792822	1275	renamed_GCF_000008685.2	chromosome	792350	793625	1275	98.1	9.993e-279
B418P	contig_1	807661	807172	489	renamed_GCF_000008685.2	chromosome	808464	807975	489	100.0	6.125e-101
B418P	contig_1	809692	808897	795	renamed_GCF_000008685.2	chromosome	810495	809700	795	100.0	1.877e-173
B418P	contig_1	811585	810703	882	renamed_GCF_000008685.2	chromosome	812388	811506	882	97.6	8.145e-189
B418P	contig_1	813907	812899	1008	renamed_GCF_000008685.2	chromosome	814697	813689	1008	99.4	1.271e-213
B418P	contig_1	815509	814711	798	renamed_GCF_000008685.2	chromosome	816299	815501	798	100.0	1.968e-173
B418P	contig_1	816610	817171	561	renamed_GCF_000008685.2	chromosome	817395	817956	561	98.9	7.919e-127
B418P	contig_1	817819	818131	312	renamed_GCF_000008685.2	chromosome	818604	818916	312	100.0	1.086e-65
B418P	contig_1	818456	818702	246	renamed_GCF_000008685.2	chromosome	819241	819487	246	100.0	8.275e-50
B418P	contig_1	819821	820403	582	renamed_GCF_000008685.2	chromosome	820606	821188	582	98.9	1.106e-126
B418P	contig_1	822024	822318	294	renamed_GCF_000008685.2	chromosome	822809	823103	294	100.0	1.207e-61
B418P	contig_2	7155	6837	318	renamed_GCF_000008685.2	cp26	4481	4757	318	100.0	7.253e-55
B418P	contig_2	9406	10756	1350	renamed_GCF_000008685.2	cp26	2186	836	1350	100.0	7.868e-303
B418P	contig_2	13266	11637	1629	renamed_GCF_000008685.2	cp26	24824	26453	1629	99.8	0.0
B418P	contig_2	14936	15488	552	renamed_GCF_000008685.2	cp26	23154	22602	552	99.4	1.338e-119
B418P	contig_2	16266	16752	486	renamed_GCF_000008685.2	cp26	21833	21338	486	100.0	3.279e-107
B418P	contig_2	17304	18660	1356	renamed_GCF_000008685.2	cp26	20786	19430	1356	98.4	1.168e-290
B418P	contig_3	6932	6503	429	renamed_GCF_000008685.2	cp32-6	7837	8266	429	100.0	5.601e-92
B418P	contig_6	10505	9980	525	renamed_GCF_000008685.2	cp32-6	21519	22098	525	65.2	7.009e-72
B418P	contig_6	16270	15934	336	renamed_GCF_000008685.2	cp32-8	15758	16094	336	100.0	5.348e-69
B418P	contig_6	26276	25886	390	renamed_GCF_000008685.2	cp32-4	5777	6167	390	100.0	3.229e-83
B418P	contig_7	2947	2614	333	renamed_GCF_000008685.2	cp32-3	12494	12827	333	100.0	8.424e-72
B418P	contig_13	9939	9372	567	renamed_GCF_000008685.2	lp28-3	17407	17974	567	99.4	9.584e-126
B418P	contig_13	10876	9931	945	renamed_GCF_000008685.2	lp28-3	16518	17415	945	92.9	1.245e-194
B418P	contig_13	16880	17549	669	renamed_GCF_000008685.2	lp28-3	10516	9847	669	100.0	5.739e-140
B418P	contig_13	26704	30526	3822	renamed_GCF_000008685.2	lp28-3	7728	3891	3822	87.5	0.0
B418P	contig_14	1059	1527	468	renamed_GCF_000008685.2	lp17	329	803	468	50.0	3e-20
B418P	contig_14	1697	2141	444	renamed_GCF_000008685.2	lp28-3	1044	1368	444	82.6	6.903e-51
B418P	contig_14	4023	4839	816	renamed_GCF_000008685.2	lp28-4	2535	3351	816	100.0	8.08e-178
B418P	contig_14	20972	20306	666	renamed_GCF_000008685.2	lp28-4	19183	18517	666	99.5	1.537e-145
B418P	contig_15	6633	9315	2682	renamed_GCF_000008685.2	lp28-2	22259	19619	2682	96.7	0.0
B418P	contig_15	16598	17417	819	renamed_GCF_000008685.2	lp28-2	12319	11500	819	100.0	1.075e-183
B418P	contig_16	786	1074	288	renamed_GCF_000008685.2	lp5	1207	1576	288	81.0	1.004e-46
B418P	contig_17	6095	6869	774	renamed_GCF_000008685.2	lp38	6088	6862	774	98.4	2.47e-158
B418P	contig_17	20131	21361	1230	renamed_GCF_000008685.2	lp38	20000	21230	1230	99.7	7.381e-266
B418P	contig_17	22101	23139	1038	renamed_GCF_000008685.2	lp38	22042	23008	1038	99.3	1.276e-218
B418P	contig_17	26539	25468	1071	renamed_GCF_000008685.2	lp38	26407	25336	1071	95.5	5.513e-225
B418P	contig_17	33714	33417	297	renamed_GCF_000008685.2	lp38	34668	34371	297	100.0	2.824e-61
B418P	contig_18	5647	6520	873	renamed_GCF_000008685.2	lp54	5645	6518	873	100.0	2.408e-192
B418P	contig_18	7210	8245	1035	renamed_GCF_000008685.2	lp54	7208	8243	1035	100.0	8.138e-232
B418P	contig_18	10289	11180	891	renamed_GCF_000008685.2	lp54	10287	11178	891	98.3	2.508e-186
B418P	contig_18	13036	13621	585	renamed_GCF_000008685.2	lp54	12994	13579	585	98.9	4.312e-129
B418P	contig_18	14379	14925	546	renamed_GCF_000008685.2	lp54	14337	14883	546	100.0	1.338e-118
B418P	contig_18	34402	34966	564	renamed_GCF_000008685.2	lp54	34384	34948	564	99.4	3.599e-119
B418P	contig_18	35971	36247	276	renamed_GCF_000008685.2	lp54	35953	36229	276	100.0	3.31e-56
B418P	contig_18	48313	47557	756	renamed_GCF_000008685.2	lp54	47228	46472	756	98.0	1.408e-161
B418P	contig_18	51304	50413	891	renamed_GCF_000008685.2	lp54	51176	50285	891	99.3	9.02e-198
B418P	contig_18	52833	53631	798	renamed_GCF_000008685.2	lp54	52705	53503	798	100.0	3.008e-177
B418P	contig_1	1822	793	1029	renamed_GCF_000008685.2	chromosome	1796	767	1029	99.4	1.177e-226
B418P	contig_1	6336	5280	1056	renamed_GCF_000008685.2	chromosome	6306	5250	1056	99.1	1.902e-234
B418P	contig_1	8345	7487	858	renamed_GCF_000008685.2	chromosome	8315	7457	858	99.6	1.438e-195
B418P	contig_1	9231	10236	1005	renamed_GCF_000008685.2	chromosome	9201	10206	1005	98.8	9.189e-217
B418P	contig_1	10610	11450	840	renamed_GCF_000008685.2	chromosome	10580	11420	840	100.0	7.775e-191
B418P	contig_1	12183	12783	600	renamed_GCF_000008685.2	chromosome	12153	12753	600	98.4	4.974e-130
B418P	contig_1	12775	14758	1983	renamed_GCF_000008685.2	chromosome	12745	14728	1983	99.8	0.0
B418P	contig_1	15752	15374	378	renamed_GCF_000008685.2	chromosome	15716	15344	378	100.0	1.768e-79
B418P	contig_1	16024	16834	810	renamed_GCF_000008685.2	chromosome	15994	16804	810	100.0	1.068e-173
B418P	contig_1	18334	17821	513	renamed_GCF_000008685.2	chromosome	18304	17791	513	99.4	1.872e-109
B418P	contig_1	22611	22017	594	renamed_GCF_000008685.2	chromosome	22739	22145	594	99.4	7.271e-125
B418P	contig_1	22690	23830	1140	renamed_GCF_000008685.2	chromosome	22818	23958	1140	97.6	4.164e-257
B418P	contig_12	261	1155	894	renamed_GCF_000008685.2	lp28-2	115	1009	894	99.3	3.345e-192
B418P	contig_12	2249	2756	507	renamed_GCF_000008685.2	lp56	3622	4108	507	93.1	2.054e-82
B418P	contig_12	4197	3063	1134	renamed_GCF_000008685.2	lp28-3	27445	26977	1134	95.5	7.029e-86
B418P	contig_12	5518	6091	573	renamed_GCF_000008685.2	lp28-2	5377	5950	573	98.4	4.31e-127
B418P	contig_12	6875	7427	552	renamed_GCF_000008685.2	lp28-2	6736	7288	552	97.8	1.472e-118
B418P	contig_12	24594	26064	1470	renamed_GCF_000008685.2	lp28-2	24488	25955	1470	92.6	4.595e-303
B418P	contig_12	26737	27166	429	renamed_GCF_000008685.2	lp28-2	26569	27085	429	94.3	6.173e-91
B418P	contig_12	27198	28026	828	renamed_GCF_000008685.2	lp28-2	27112	27940	828	97.4	1.07e-176
B418P	contig_13	891	1842	951	renamed_GCF_000008685.2	lp28-3	26371	25432	951	89.8	1.008e-180
B418P	contig_13	5876	5126	750	renamed_GCF_000008685.2	lp28-3	21469	22219	750	99.1	6.952e-160
B418P	contig_14	6616	6835	219	renamed_GCF_000008685.2	lp28-4	5127	5346	219	100.0	1.443e-47
B418P	contig_14	12612	13719	1107	renamed_GCF_000008685.2	lp28-4	10814	11927	1107	98.9	2.343e-249
B418P	contig_14	14245	14998	753	renamed_GCF_000008685.2	lp28-4	12453	13206	753	100.0	4.561e-165
B418P	contig_14	17146	18325	1179	renamed_GCF_000008685.2	lp28-4	15351	16530	1179	99.2	5.451e-252
B418P	contig_16	17758	18832	1074	renamed_GCF_000008685.2	lp36	20388	21453	1074	95.7	1.543e-222
B418P	contig_17	11245	10657	588	renamed_GCF_000008685.2	lp38	11105	10517	588	97.9	6.014e-126
B418P	contig_17	12592	12001	591	renamed_GCF_000008685.2	lp38	12452	11861	591	98.9	3.922e-131
B418P	contig_17	16650	17460	810	renamed_GCF_000008685.2	lp38	16519	17329	810	98.8	3.309e-178
B418P	contig_17	18344	19385	1041	renamed_GCF_000008685.2	lp38	18213	19254	1041	99.1	7.428e-234
B418P	contig_17	35294	34679	615	renamed_GCF_000008685.2	lp38	36248	35633	615	98.5	1.541e-128
B418P	contig_17	35677	36013	336	renamed_GCF_000008685.2	lp5	4387	4819	336	51.8	2.184e-30
B418P	contig_18	29411	29786	375	renamed_GCF_000008685.2	lp54	29383	29758	375	100.0	1.685e-79
B418P	contig_18	39423	38178	1245	renamed_GCF_000008685.2	lp54	39405	38160	1245	99.5	5.369e-272
B418P	contig_18	40129	39889	240	renamed_GCF_000008685.2	lp54	40112	39872	240	100.0	3.722e-49
B418P	contig_18	41062	40228	834	renamed_GCF_000008685.2	lp54	41045	40211	834	99.6	1.639e-181
B418P	contig_18	42036	41412	624	renamed_GCF_000008685.2	lp54	42019	41395	624	100.0	3.1e-139
B418P	contig_18	42283	42490	207	renamed_GCF_000008685.2	lp54	42266	42473	207	100.0	9.856e-42
B418P	contig_18	43549	42640	909	renamed_GCF_000008685.2	lp54	43532	42623	909	99.6	5.38e-198
B418P	contig_18	45976	44740	1236	renamed_GCF_000008685.2	lp54	45947	44711	1236	98.7	3.997e-265
B418P	contig_1	59910	58971	939	renamed_GCF_000008685.2	chromosome	60039	59100	939	99.6	9.091e-206
B418P	contig_1	69436	69997	561	renamed_GCF_000008685.2	chromosome	69565	70126	561	100.0	3.775e-118
B418P	contig_1	105293	103625	1668	renamed_GCF_000008685.2	chromosome	105299	103763	1668	100.0	0.0
B418P	contig_1	106756	105745	1011	renamed_GCF_000008685.2	chromosome	106894	105883	1011	100.0	4.14e-218
B418P	contig_1	108032	106835	1197	renamed_GCF_000008685.2	chromosome	108170	106973	1197	99.2	2.049e-257
B418P	contig_1	108168	109533	1365	renamed_GCF_000008685.2	chromosome	108306	109671	1365	99.7	2.146e-311
B418P	contig_1	111429	110907	522	renamed_GCF_000008685.2	chromosome	111567	111045	522	100.0	1.783e-111
B418P	contig_1	111737	111446	291	renamed_GCF_000008685.2	chromosome	111875	111584	291	100.0	1.894e-64
B418P	contig_1	121685	120962	723	renamed_GCF_000008685.2	chromosome	121823	121100	723	99.1	4.138e-161
B418P	contig_1	157914	158331	417	renamed_GCF_000008685.2	chromosome	158075	158474	417	100.0	2.72e-81
B418P	contig_1	171108	171342	234	renamed_GCF_000008685.2	chromosome	171262	171484	234	98.6	1.134e-44
B418P	contig_1	173438	171389	2049	renamed_GCF_000008685.2	chromosome	173535	171531	2049	98.9	0.0
B418P	contig_1	174942	173955	987	renamed_GCF_000008685.2	chromosome	174970	174097	987	97.9	2.044e-187
B418P	contig_1	176832	175926	906	renamed_GCF_000008685.2	chromosome	176974	176068	906	99.0	3.676e-193
B418P	contig_1	178718	177725	993	renamed_GCF_000008685.2	chromosome	178860	177867	993	100.0	4.528e-214
B418P	contig_1	189134	188933	201	renamed_GCF_000008685.2	chromosome	189276	189075	201	98.4	4.922e-40
B418P	contig_1	189934	190588	654	renamed_GCF_000008685.2	chromosome	190186	190717	654	99.4	1.404e-110
B418P	contig_1	192198	191388	810	renamed_GCF_000008685.2	chromosome	192327	191517	810	99.6	2.276e-182
B418P	contig_1	238529	237701	828	renamed_GCF_000008685.2	chromosome	239128	238300	828	99.6	1.027e-185
B418P	contig_1	239651	238544	1107	renamed_GCF_000008685.2	chromosome	240250	239143	1107	99.7	3.718e-244
B418P	contig_1	241690	239683	2007	renamed_GCF_000008685.2	chromosome	242289	240282	2007	99.7	0.0
B418P	contig_1	244114	243343	771	renamed_GCF_000008685.2	chromosome	244713	243942	771	100.0	4.161e-169
B418P	contig_1	255863	258386	2523	renamed_GCF_000008685.2	chromosome	256462	258985	2523	98.8	0.0
B418P	contig_1	263387	265514	2127	renamed_GCF_000008685.2	chromosome	263987	266114	2127	99.2	0.0
B418P	contig_1	266465	266675	210	renamed_GCF_000008685.2	chromosome	267065	267275	210	100.0	4.647e-42
B418P	contig_1	269873	269072	801	renamed_GCF_000008685.2	chromosome	270473	269672	801	99.6	3.29e-168
B418P	contig_1	283256	282089	1167	renamed_GCF_000008685.2	chromosome	283865	282698	1167	100.0	1.172e-258
B418P	contig_1	306008	305060	948	renamed_GCF_000008685.2	chromosome	306615	305670	948	98.7	9.536e-207
B418P	contig_1	307907	306707	1200	renamed_GCF_000008685.2	chromosome	308517	307317	1200	99.7	1.629e-260
B418P	contig_1	319027	318496	531	renamed_GCF_000008685.2	chromosome	319636	319105	531	100.0	1.699e-113
B418P	contig_1	319699	320743	1044	renamed_GCF_000008685.2	chromosome	320308	321352	1044	99.4	3.304e-226
B418P	contig_1	320742	321429	687	renamed_GCF_000008685.2	chromosome	321351	322038	687	100.0	1.336e-150
B418P	contig_1	324627	323166	1461	renamed_GCF_000008685.2	chromosome	325236	323775	1461	99.7	0.0
B418P	contig_1	325679	324626	1053	renamed_GCF_000008685.2	chromosome	326288	325235	1053	99.7	1.991e-233
B418P	contig_1	341722	342595	873	renamed_GCF_000008685.2	chromosome	342334	343207	873	99.6	3.495e-188
B418P	contig_1	342595	343567	972	renamed_GCF_000008685.2	chromosome	343207	344179	972	100.0	3.579e-213
B418P	contig_1	344450	345752	1302	renamed_GCF_000008685.2	chromosome	345062	346364	1302	99.5	2.995e-288
B418P	contig_1	378721	376429	2292	renamed_GCF_000008685.2	chromosome	379258	377038	2292	97.9	0.0
B418P	contig_1	381283	379945	1338	renamed_GCF_000008685.2	chromosome	381892	380554	1338	100.0	1.408e-311
B418P	contig_1	382773	381300	1473	renamed_GCF_000008685.2	chromosome	383382	381909	1473	100.0	0.0
B418P	contig_1	383677	384817	1140	renamed_GCF_000008685.2	chromosome	384286	385426	1140	99.4	1.764e-249
B418P	contig_1	408794	407945	849	renamed_GCF_000008685.2	chromosome	409402	408553	849	100.0	9.834e-190
B418P	contig_1	410177	410837	660	renamed_GCF_000008685.2	chromosome	410786	411446	660	98.6	2.462e-139
B418P	contig_1	412391	410846	1545	renamed_GCF_000008685.2	chromosome	413006	411455	1545	99.4	0.0
B418P	contig_1	415184	413717	1467	renamed_GCF_000008685.2	chromosome	415793	414326	1467	99.1	0.0
B418P	contig_1	415914	415236	678	renamed_GCF_000008685.2	chromosome	416478	415845	678	99.0	1.108e-142
B418P	contig_1	416492	417104	612	renamed_GCF_000008685.2	chromosome	417101	417713	612	100.0	4.975e-132
B418P	contig_1	458920	459220	300	renamed_GCF_000008685.2	chromosome	459524	459824	300	95.9	4.432e-57
B418P	contig_1	471162	470628	534	renamed_GCF_000008685.2	chromosome	471756	471222	534	99.4	1.961e-112
B418P	contig_1	471881	471176	705	renamed_GCF_000008685.2	chromosome	472358	471770	705	99.4	1.099e-121
B418P	contig_1	473962	472810	1152	renamed_GCF_000008685.2	chromosome	474556	473404	1152	99.7	3.808e-260
B418P	contig_1	474018	475008	990	renamed_GCF_000008685.2	chromosome	474612	475602	990	98.4	5.2e-212
B418P	contig_1	477479	475667	1812	renamed_GCF_000008685.2	chromosome	478005	476262	1812	100.0	0.0
B418P	contig_1	481459	480745	714	renamed_GCF_000008685.2	chromosome	482057	481343	714	100.0	3.944e-160
B418P	contig_1	483688	483988	300	renamed_GCF_000008685.2	chromosome	484286	484586	300	100.0	5.976e-62
B418P	contig_1	484154	484664	510	renamed_GCF_000008685.2	chromosome	484756	485266	510	100.0	1.216e-113
B418P	contig_1	485471	486167	696	renamed_GCF_000008685.2	chromosome	486073	486769	696	100.0	2.835e-152
B418P	contig_1	486932	487622	690	renamed_GCF_000008685.2	chromosome	487534	488224	690	99.5	4.749e-154
B418P	contig_1	488380	488893	513	renamed_GCF_000008685.2	chromosome	488982	489495	513	100.0	1.545e-111
B418P	contig_1	498454	498733	279	renamed_GCF_000008685.2	chromosome	499055	499334	279	98.9	3.143e-57
B418P	contig_1	498739	499102	363	renamed_GCF_000008685.2	chromosome	499340	499703	363	100.0	3.407e-78
B418P	contig_1	499991	500408	417	renamed_GCF_000008685.2	chromosome	500592	501009	417	100.0	2.778e-89
B418P	contig_1	500410	500611	201	renamed_GCF_000008685.2	chromosome	501014	501212	201	98.4	1.098e-39
B418P	contig_1	500895	501264	369	renamed_GCF_000008685.2	chromosome	501496	501865	369	99.1	4.571e-76
B418P	contig_1	501278	501584	306	renamed_GCF_000008685.2	chromosome	501879	502185	306	100.0	2.959e-62
B418P	contig_1	502154	502340	186	renamed_GCF_000008685.2	chromosome	502755	502941	186	100.0	7.664e-41
B418P	contig_1	531086	530522	564	renamed_GCF_000008685.2	chromosome	531692	531128	564	100.0	2.704e-122
B418P	contig_1	533695	534550	855	renamed_GCF_000008685.2	chromosome	534300	535155	855	99.2	4.862e-190
B418P	contig_1	534995	534572	423	renamed_GCF_000008685.2	chromosome	535600	535177	423	99.2	2.776e-90
B418P	contig_1	535098	536922	1824	renamed_GCF_000008685.2	chromosome	535703	537527	1824	99.5	0.0
B418P	contig_1	536914	537703	789	renamed_GCF_000008685.2	chromosome	537543	538308	789	99.6	2.994e-167
B418P	contig_1	538670	537722	948	renamed_GCF_000008685.2	chromosome	539275	538327	948	100.0	1.008e-214
B418P	contig_1	542443	543211	768	renamed_GCF_000008685.2	chromosome	543048	543816	768	99.6	4.167e-177
B418P	contig_1	584348	585413	1065	renamed_GCF_000008685.2	chromosome	585079	586156	1065	97.4	4.863e-234
B418P	contig_1	586287	587139	852	renamed_GCF_000008685.2	chromosome	587030	587882	852	99.2	8.554e-192
B418P	contig_1	589465	588940	525	renamed_GCF_000008685.2	chromosome	590208	589683	525	95.4	4.02e-103
B418P	contig_1	589604	590192	588	renamed_GCF_000008685.2	chromosome	590347	590935	588	98.9	4.522e-129
B418P	contig_1	591739	595183	3444	renamed_GCF_000008685.2	chromosome	592445	595931	3444	99.3	0.0
B418P	contig_1	595782	597843	2061	renamed_GCF_000008685.2	chromosome	596530	598591	2061	100.0	0.0
B418P	contig_1	700163	699290	873	renamed_GCF_000008685.2	chromosome	700924	700051	873	99.3	1.433e-189
B418P	contig_1	700633	701044	411	renamed_GCF_000008685.2	chromosome	701394	701805	411	99.2	1.377e-87
B418P	contig_1	702205	701521	684	renamed_GCF_000008685.2	chromosome	702951	702282	684	99.5	1.009e-144
B418P	contig_1	703169	704198	1029	renamed_GCF_000008685.2	chromosome	703960	704959	1029	99.3	3.786e-222
B418P	contig_1	704816	705842	1026	renamed_GCF_000008685.2	chromosome	705579	706605	1026	100.0	2.737e-225
B418P	contig_1	705909	708504	2595	renamed_GCF_000008685.2	chromosome	706672	709267	2595	99.6	0.0
B418P	contig_1	709922	710408	486	renamed_GCF_000008685.2	chromosome	710685	711171	486	100.0	5.304e-102
B418P	contig_1	711444	710928	516	renamed_GCF_000008685.2	chromosome	712207	711691	516	99.4	8.019e-111
B418P	contig_1	713344	712480	864	renamed_GCF_000008685.2	chromosome	714107	713243	864	99.6	5.599e-190
B418P	contig_1	714245	715856	1611	renamed_GCF_000008685.2	chromosome	715008	716619	1611	100.0	0.0
B418P	contig_1	715856	717008	1152	renamed_GCF_000008685.2	chromosome	716619	717771	1152	99.4	6.226e-246
B418P	contig_1	738920	739412	492	renamed_GCF_000008685.2	chromosome	739684	740176	492	99.3	2.164e-104
B418P	contig_1	739475	739658	183	renamed_GCF_000008685.2	chromosome	740239	740422	183	100.0	1.805e-39
B418P	contig_1	739923	740661	738	renamed_GCF_000008685.2	chromosome	740687	741425	738	100.0	4.772e-162
B418P	contig_1	762815	763598	783	renamed_GCF_000008685.2	chromosome	763578	764361	783	100.0	1.874e-171
B418P	contig_1	764609	765953	1344	renamed_GCF_000008685.2	chromosome	765372	766716	1344	99.7	5.964e-305
B418P	contig_1	768707	767315	1392	renamed_GCF_000008685.2	chromosome	769470	768078	1392	99.5	4.522e-290
B418P	contig_1	770376	768783	1593	renamed_GCF_000008685.2	chromosome	771139	769546	1593	99.8	0.0
B418P	contig_1	773566	770806	2760	renamed_GCF_000008685.2	chromosome	774368	771569	2760	98.3	0.0
B418P	contig_1	773874	774660	786	renamed_GCF_000008685.2	chromosome	774676	775462	786	100.0	1.17e-168
B418P	contig_1	775877	774863	1014	renamed_GCF_000008685.2	chromosome	776679	775665	1014	99.7	8.011e-220
B418P	contig_1	776962	777952	990	renamed_GCF_000008685.2	chromosome	777764	778754	990	99.3	7.696e-225
B418P	contig_1	782027	781349	678	renamed_GCF_000008685.2	chromosome	782829	782151	678	98.6	2.577e-150
B418P	contig_1	812436	811635	801	renamed_GCF_000008685.2	chromosome	813239	812438	801	100.0	9.279e-174
B418P	contig_1	812916	812589	327	renamed_GCF_000008685.2	chromosome	813706	813385	327	97.1	1.692e-63
B418P	contig_1	814512	814077	435	renamed_GCF_000008685.2	chromosome	815302	814867	435	100.0	4.611e-95
B418P	contig_1	816412	815521	891	renamed_GCF_000008685.2	chromosome	817160	816311	891	99.6	1.029e-187
B418P	contig_1	817232	817763	531	renamed_GCF_000008685.2	chromosome	818017	818548	531	100.0	1.403e-115
B418P	contig_1	818136	818457	321	renamed_GCF_000008685.2	chromosome	819035	819242	321	97.0	1.267e-41
B418P	contig_1	818756	819743	987	renamed_GCF_000008685.2	chromosome	819541	820528	987	100.0	5.255e-220
B418P	contig_1	820399	821584	1185	renamed_GCF_000008685.2	chromosome	821184	822369	1185	99.7	1.29e-260
B418P	contig_1	821558	821909	351	renamed_GCF_000008685.2	chromosome	822343	822694	351	99.1	1.534e-76
B418P	contig_1	822477	823026	549	renamed_GCF_000008685.2	chromosome	823262	823811	549	97.8	9.24e-115
B418P	contig_1	852926	853994	1068	renamed_GCF_000008685.2	chromosome	853774	854842	1068	100.0	1.362e-231
B418P	contig_1	856657	858067	1410	renamed_GCF_000008685.2	chromosome	857505	858915	1410	99.1	1.662e-304
B418P	contig_1	859263	858090	1173	renamed_GCF_000008685.2	chromosome	860111	858938	1173	98.9	3.437e-256
B418P	contig_1	869176	868660	516	renamed_GCF_000008685.2	chromosome	870023	869507	516	99.4	3.605e-111
B418P	contig_1	871736	869264	2472	renamed_GCF_000008685.2	chromosome	872583	870111	2472	100.0	0.0
B418P	contig_1	874359	875601	1242	renamed_GCF_000008685.2	chromosome	875206	876448	1242	98.5	1.457e-277
B418P	contig_1	878467	879403	936	renamed_GCF_000008685.2	chromosome	879314	880250	936	100.0	3.242e-208
B418P	contig_1	880244	879419	825	renamed_GCF_000008685.2	chromosome	881091	880266	825	98.5	1.716e-179
B418P	contig_1	885600	883380	2220	renamed_GCF_000008685.2	chromosome	886447	884227	2220	99.4	0.0
B418P	contig_1	887335	885622	1713	renamed_GCF_000008685.2	chromosome	888179	886469	1713	98.9	0.0
B418P	contig_2	16726	17233	507	renamed_GCF_000008685.2	cp26	21364	20857	507	100.0	3.123e-111
B418P	contig_3	4442	3800	642	renamed_GCF_000008685.2	cp32-7	10316	10958	642	100.0	3.749e-140
B418P	contig_3	5792	4454	1338	renamed_GCF_000008685.2	cp32-7	8969	10304	1338	97.0	2.207e-280
B418P	contig_3	6488	6032	456	renamed_GCF_000008685.2	cp32-7	8273	8729	456	100.0	8.859e-100
B418P	contig_3	8059	6946	1113	renamed_GCF_000008685.2	cp32-7	6702	7815	1113	98.3	9.945e-243
B418P	contig_3	8609	8039	570	renamed_GCF_000008685.2	cp32-6	6160	6730	570	97.8	2.704e-123
B418P	contig_3	8995	8605	390	renamed_GCF_000008685.2	cp32-6	5774	6164	390	98.4	1.6e-82
B418P	contig_3	9366	8982	384	renamed_GCF_000008685.2	cp32-6	5403	5787	384	100.0	2.931e-83
B418P	contig_4	14542	13552	990	renamed_GCF_000008685.2	cp32-1	18728	17714	990	65.3	5.741e-141
B418P	contig_6	5928	5319	609	renamed_GCF_000008685.2	cp32-3	26707	27298	609	51.0	5.111e-54
B418P	contig_6	11339	10565	774	renamed_GCF_000008685.2	cp32-3	21256	21997	774	62.7	3.607e-102
B418P	contig_6	11881	11314	567	renamed_GCF_000008685.2	cp32-4	20066	20633	567	100.0	2.944e-130
B418P	contig_7	14303	15248	945	renamed_GCF_000008685.2	cp32-3	19228	18286	945	88.9	1.174e-186
B418P	contig_7	16380	15825	555	renamed_GCF_000008685.2	cp32-3	17088	17697	555	91.0	2.485e-113
B418P	contig_8	1076	1889	813	renamed_GCF_000008685.2	cp32-4	14276	15092	813	70.4	1.502e-118
B418P	contig_8	1965	2169	204	renamed_GCF_000008685.2	cp32-7	15221	15425	204	100.0	2.578e-39
B418P	contig_8	10001	11327	1326	renamed_GCF_000008685.2	cp32-7	23134	24460	1326	97.9	4.636e-296
B418P	contig_8	12605	11810	795	renamed_GCF_000008685.2	cp32-4	25435	24640	795	99.2	1.557e-175
B418P	contig_8	13611	14628	1017	renamed_GCF_000008685.2	cp32-1	26795	27932	1017	60.6	2.949e-135
B418P	contig_8	15531	16098	567	renamed_GCF_000008685.2	cp32-3	28235	28874	567	94.1	2.258e-116
B418P	contig_9	5289	4758	531	renamed_GCF_000008685.2	cp9	4377	3852	531	69.19	8.434e-71
B418P	contig_9	5702	5411	291	renamed_GCF_000008685.2	cp9	4788	4503	291	79.1	4.728e-47
B418P	contig_9	6512	6800	288	renamed_GCF_000008685.2	lp21	16548	16227	288	36.6	1.024e-15
B418P	contig_9	7185	7983	798	renamed_GCF_000008685.2	cp9	6973	7771	798	100.0	6.09e-178
B418P	contig_10	600	1599	999	renamed_GCF_000008685.2	lp36	34079	33080	999	98.7	2.692e-212
B418P	contig_10	1853	2840	987	renamed_GCF_000008685.2	lp36	30463	29476	987	98.7	2.847e-218
B418P	contig_10	3104	3926	822	renamed_GCF_000008685.2	lp36	31585	30718	822	47.7	6.087e-67
B418P	contig_10	4028	4934	906	renamed_GCF_000008685.2	lp36	28288	27382	906	96.6	1.079e-189
B418P	contig_10	4966	5290	324	renamed_GCF_000008685.2	lp5	743	1097	324	92.5	2.662e-66
B418P	contig_11	13204	12640	564	renamed_GCF_000008685.2	lp25	13393	12829	564	100.0	4.519e-125
B418P	contig_11	14287	13213	1074	renamed_GCF_000008685.2	lp25	14530	13402	1074	99.4	2.22e-244
B418P	contig_11	15389	14852	537	renamed_GCF_000008685.2	lp25	15545	15041	537	99.4	7.638e-115
B418P	contig_11	22559	21827	732	renamed_GCF_000008685.2	lp25	22677	21945	732	99.1	1.279e-158
B418P	contig_15	9315	10098	783	renamed_GCF_000008685.2	lp28-2	19619	18836	783	80.7	3.91e-146
B418P	contig_15	17426	17855	429	renamed_GCF_000008685.2	lp28-2	11491	11062	429	99.2	1.514e-89
B418P	contig_16	281	659	378	renamed_GCF_000008685.2	lp21	252	618	378	65.6	1.526e-48
B418P	contig_16	29934	31059	1125	renamed_GCF_000008685.2	lp28-1	26996	28073	1125	47.9	6.76e-85
B418P	contig_17	21353	22079	726	renamed_GCF_000008685.2	lp38	21222	21948	726	99.1	1.279e-157
B418P	contig_17	23496	24219	723	renamed_GCF_000008685.2	lp38	32497	33220	723	98.3	3.947e-153
B418P	contig_17	28184	27125	1059	renamed_GCF_000008685.2	lp38	28053	26994	1059	98.0	9.271e-226
B418P	contig_17	34637	33950	687	renamed_GCF_000008685.2	lp38	35591	34904	687	99.1	2.239e-153
B418P	contig_18	6522	7149	627	renamed_GCF_000008685.2	lp54	6520	7147	627	99.0	1.16e-133
B418P	contig_18	8267	8447	180	renamed_GCF_000008685.2	lp54	8265	8445	180	100.0	1.452e-33
B418P	contig_18	8443	8869	426	renamed_GCF_000008685.2	lp54	8441	8867	426	100.0	3.21e-89
B418P	contig_18	9458	10280	822	renamed_GCF_000008685.2	lp54	9456	10278	822	99.2	6.989e-172
B418P	contig_18	13596	14349	753	renamed_GCF_000008685.2	lp54	13554	14307	753	100.0	4.561e-165
B418P	contig_18	15411	15843	432	renamed_GCF_000008685.2	lp54	15369	15801	432	100.0	1.792e-96
B418P	contig_18	16627	16042	585	renamed_GCF_000008685.2	lp54	16576	16000	585	75.4	1.134e-84
B418P	contig_18	35005	35851	846	renamed_GCF_000008685.2	lp54	34987	35833	846	99.2	1.362e-185
B418P	contig_18	36285	36552	267	renamed_GCF_000008685.2	lp54	36255	36534	267	98.8	1.568e-54
B418P	contig_18	49352	48560	792	renamed_GCF_000008685.2	lp54	48267	47475	792	99.6	2.159e-171
B418P	contig_18	50205	49980	225	renamed_GCF_000008685.2	lp54	50077	49852	225	100.0	1.962e-45
B418P	contig_18	51833	52607	774	renamed_GCF_000008685.2	lp54	51705	52479	774	99.6	9.219e-161