QUERY_ID	QUERY_NAME	QUERY_START	QUERY_END	QUERY_LENGTH	REF_ID	REF_NAME	REF_START	REF_END	REF_LENGTH	IDENTITY	EVALUE
UCT32H	contig_1	18315	17802	513	renamed_GCF_000008685.2	chromosome	18304	17791	513	99.4	1.872e-109
UCT32H	contig_1	22592	21998	594	renamed_GCF_000008685.2	chromosome	22739	22145	594	99.4	7.271e-125
UCT32H	contig_1	24549	23817	732	renamed_GCF_000008685.2	chromosome	24696	23964	732	100.0	2.844e-158
UCT32H	contig_1	25476	24549	927	renamed_GCF_000008685.2	chromosome	25623	24696	927	98.0	3.519e-197
UCT32H	contig_1	26251	27301	1050	renamed_GCF_000008685.2	chromosome	26398	27448	1050	100.0	7.794e-235
UCT32H	contig_1	27718	27286	432	renamed_GCF_000008685.2	chromosome	27865	27433	432	100.0	2.641e-92
UCT32H	contig_1	41291	40619	672	renamed_GCF_000008685.2	chromosome	41432	40760	672	100.0	1.856e-144
UCT32H	contig_1	42740	42338	402	renamed_GCF_000008685.2	chromosome	42881	42479	402	100.0	2.405e-88
UCT32H	contig_1	45304	45850	546	renamed_GCF_000008685.2	chromosome	45445	45991	546	100.0	3.273e-117
UCT32H	contig_1	65147	65609	462	renamed_GCF_000008685.2	chromosome	65290	65752	462	100.0	3.193e-95
UCT32H	contig_1	67104	69429	2325	renamed_GCF_000008685.2	chromosome	67247	69569	2325	99.4	0.0
UCT32H	contig_1	80841	81267	426	renamed_GCF_000008685.2	chromosome	80982	81408	426	99.2	2.643e-91
UCT32H	contig_1	83779	82828	951	renamed_GCF_000008685.2	chromosome	83920	82969	951	99.6	3.736e-209
UCT32H	contig_1	86713	85738	975	renamed_GCF_000008685.2	chromosome	86854	85879	975	100.0	4.354e-220
UCT32H	contig_1	89667	89058	609	renamed_GCF_000008685.2	chromosome	89808	89199	609	100.0	1.275e-129
UCT32H	contig_1	93892	93292	600	renamed_GCF_000008685.2	chromosome	94032	93432	600	100.0	1.47e-126
UCT32H	contig_1	96813	94470	2343	renamed_GCF_000008685.2	chromosome	96953	94610	2343	98.8	0.0
UCT32H	contig_1	129989	127283	2706	renamed_GCF_000008685.2	chromosome	130132	127426	2706	99.8	0.0
UCT32H	contig_1	130971	130026	945	renamed_GCF_000008685.2	chromosome	131114	130169	945	100.0	6.888e-210
UCT32H	contig_1	148514	147503	1011	renamed_GCF_000008685.2	chromosome	148659	147648	1011	99.7	2.697e-214
UCT32H	contig_1	150824	152030	1206	renamed_GCF_000008685.2	chromosome	150973	152179	1206	99.7	1.095e-274
UCT32H	contig_1	153537	152925	612	renamed_GCF_000008685.2	chromosome	153686	153074	612	100.0	4.712e-141
UCT32H	contig_1	156251	153551	2700	renamed_GCF_000008685.2	chromosome	156400	153700	2700	100.0	0.0
UCT32H	contig_1	157478	157913	435	renamed_GCF_000008685.2	chromosome	157626	158061	435	99.3	1.372e-91
UCT32H	contig_1	170949	170571	378	renamed_GCF_000008685.2	chromosome	171097	170719	378	98.4	1.768e-79
UCT32H	contig_1	173432	171383	2049	renamed_GCF_000008685.2	chromosome	173535	171531	2049	99.2	0.0
UCT32H	contig_1	176826	175920	906	renamed_GCF_000008685.2	chromosome	176974	176068	906	99.6	1.374e-195
UCT32H	contig_1	178712	177719	993	renamed_GCF_000008685.2	chromosome	178860	177867	993	99.6	2.235e-213
UCT32H	contig_1	189711	189150	561	renamed_GCF_000008685.2	chromosome	189859	189298	561	100.0	1.275e-121
UCT32H	contig_1	190570	191311	741	renamed_GCF_000008685.2	chromosome	190718	191459	741	99.5	3.597e-157
UCT32H	contig_1	193315	192175	1140	renamed_GCF_000008685.2	chromosome	193463	192323	1140	99.7	9.252e-257
UCT32H	contig_1	211152	211920	768	renamed_GCF_000008685.2	chromosome	211300	212068	768	100.0	8.822e-169
UCT32H	contig_1	218768	218114	654	renamed_GCF_000008685.2	chromosome	219078	218424	654	100.0	1.052e-147
UCT32H	contig_1	219489	220329	840	renamed_GCF_000008685.2	chromosome	219799	220639	840	100.0	1.641e-182
UCT32H	contig_1	220418	221327	909	renamed_GCF_000008685.2	chromosome	220728	221637	909	99.3	4.638e-191
UCT32H	contig_1	222868	223651	783	renamed_GCF_000008685.2	chromosome	223178	223961	783	99.2	8.433e-172
UCT32H	contig_1	237319	236911	408	renamed_GCF_000008685.2	chromosome	237629	237221	408	100.0	2.649e-88
UCT32H	contig_1	237916	237658	258	renamed_GCF_000008685.2	chromosome	238226	237968	258	100.0	9.113e-51
UCT32H	contig_1	238818	237990	828	renamed_GCF_000008685.2	chromosome	239128	238300	828	98.9	1.128e-184
UCT32H	contig_1	242127	243693	1566	renamed_GCF_000008685.2	chromosome	242437	244003	1566	98.4	0.0
UCT32H	contig_1	255334	255949	615	renamed_GCF_000008685.2	chromosome	255645	256260	615	99.5	1.275e-130
UCT32H	contig_1	263401	260980	2421	renamed_GCF_000008685.2	chromosome	263712	261291	2421	100.0	0.0
UCT32H	contig_1	265795	266740	945	renamed_GCF_000008685.2	chromosome	266106	267051	945	100.0	6.277e-211
UCT32H	contig_1	272369	270176	2193	renamed_GCF_000008685.2	chromosome	272641	270487	2193	99.8	0.0
UCT32H	contig_1	286787	285668	1119	renamed_GCF_000008685.2	chromosome	287089	285970	1119	100.0	9.957e-244
UCT32H	contig_1	287575	286786	789	renamed_GCF_000008685.2	chromosome	287877	287088	789	100.0	1.783e-164
UCT32H	contig_1	288644	287879	765	renamed_GCF_000008685.2	chromosome	288946	288181	765	100.0	2.478e-165
UCT32H	contig_1	289615	289273	342	renamed_GCF_000008685.2	chromosome	289917	289575	342	100.0	1.077e-70
UCT32H	contig_1	291293	290756	537	renamed_GCF_000008685.2	chromosome	291595	291058	537	100.0	7.638e-115
UCT32H	contig_1	302186	300476	1710	renamed_GCF_000008685.2	chromosome	302489	300779	1710	100.0	0.0
UCT32H	contig_1	303006	302547	459	renamed_GCF_000008685.2	chromosome	303309	302850	459	100.0	4.601e-99
UCT32H	contig_1	304817	303470	1347	renamed_GCF_000008685.2	chromosome	305120	303773	1347	100.0	1.016e-290
UCT32H	contig_1	305358	304809	549	renamed_GCF_000008685.2	chromosome	305661	305112	549	100.0	9.24e-115
UCT32H	contig_1	307014	306321	693	renamed_GCF_000008685.2	chromosome	307317	306624	693	100.0	2.971e-151
UCT32H	contig_1	318814	317974	840	renamed_GCF_000008685.2	chromosome	319116	318276	840	99.6	1.977e-180
UCT32H	contig_1	319956	319377	579	renamed_GCF_000008685.2	chromosome	320249	319679	579	98.9	3.43e-122
UCT32H	contig_1	321049	321736	687	renamed_GCF_000008685.2	chromosome	321351	322038	687	100.0	1.336e-150
UCT32H	contig_1	323477	322544	933	renamed_GCF_000008685.2	chromosome	323779	322846	933	99.6	9.082e-205
UCT32H	contig_1	325986	324933	1053	renamed_GCF_000008685.2	chromosome	326288	325235	1053	99.4	2.184e-232
UCT32H	contig_1	327424	326395	1029	renamed_GCF_000008685.2	chromosome	327757	326698	1029	99.4	1.646e-231
UCT32H	contig_1	342904	343876	972	renamed_GCF_000008685.2	chromosome	343207	344179	972	100.0	3.579e-213
UCT32H	contig_1	557129	556271	858	renamed_GCF_000008685.2	chromosome	557423	556562	858	97.9	4.402e-183
UCT32H	contig_1	557730	557112	618	renamed_GCF_000008685.2	chromosome	558024	557406	618	99.0	1.47e-129
UCT32H	contig_1	560438	557711	2727	renamed_GCF_000008685.2	chromosome	560732	558005	2727	99.7	0.0
UCT32H	contig_1	560833	560434	399	renamed_GCF_000008685.2	chromosome	561127	560728	399	96.2	1.01e-80
UCT32H	contig_1	561242	560822	420	renamed_GCF_000008685.2	chromosome	561554	561116	420	93.0	2.589e-82
UCT32H	contig_1	561631	561250	381	renamed_GCF_000008685.2	chromosome	561943	561562	381	99.2	5.027e-77
UCT32H	contig_1	561872	563855	1983	renamed_GCF_000008685.2	chromosome	562184	564167	1983	99.6	0.0
UCT32H	contig_1	565658	567512	1854	renamed_GCF_000008685.2	chromosome	565954	567823	1854	99.6	0.0
UCT32H	contig_1	567498	567966	468	renamed_GCF_000008685.2	chromosome	567809	568277	468	100.0	1.969e-101
UCT32H	contig_1	577636	577948	312	renamed_GCF_000008685.2	chromosome	577949	578261	312	100.0	5.387e-65
UCT32H	contig_1	577963	580108	2145	renamed_GCF_000008685.2	chromosome	578276	580421	2145	99.7	0.0
UCT32H	contig_1	580172	581330	1158	renamed_GCF_000008685.2	chromosome	580485	581643	1158	100.0	7.971e-253
UCT32H	contig_1	581331	583104	1773	renamed_GCF_000008685.2	chromosome	581644	583417	1773	99.3	0.0
UCT32H	contig_1	583144	583519	375	renamed_GCF_000008685.2	chromosome	583457	583832	375	99.1	1.859e-78
UCT32H	contig_1	584567	583877	690	renamed_GCF_000008685.2	chromosome	584880	584190	690	99.1	4.749e-154
UCT32H	contig_1	584778	585843	1065	renamed_GCF_000008685.2	chromosome	585079	586156	1065	98.0	9.851e-235
UCT32H	contig_1	586717	587569	852	renamed_GCF_000008685.2	chromosome	587030	587882	852	98.5	4.638e-190
UCT32H	contig_1	587752	589354	1602	renamed_GCF_000008685.2	chromosome	588065	589667	1602	99.8	0.0
UCT32H	contig_1	604451	603407	1044	renamed_GCF_000008685.2	chromosome	604769	603725	1044	99.4	1.577e-234
UCT32H	contig_1	606665	604460	2205	renamed_GCF_000008685.2	chromosome	606983	604778	2205	99.5	0.0
UCT32H	contig_1	606819	607617	798	renamed_GCF_000008685.2	chromosome	607137	607935	798	99.6	4.801e-172
UCT32H	contig_1	609588	608742	846	renamed_GCF_000008685.2	chromosome	609906	609060	846	100.0	3.324e-184
UCT32H	contig_1	610875	609624	1251	renamed_GCF_000008685.2	chromosome	611193	609942	1251	98.3	2.071e-266
UCT32H	contig_1	610990	611704	714	renamed_GCF_000008685.2	chromosome	611308	612022	714	99.5	9.633e-159
UCT32H	contig_1	611729	613667	1938	renamed_GCF_000008685.2	chromosome	612047	613985	1938	99.8	0.0
UCT32H	contig_1	615453	613695	1758	renamed_GCF_000008685.2	chromosome	615771	614013	1758	98.9	0.0
UCT32H	contig_1	616072	615445	627	renamed_GCF_000008685.2	chromosome	616390	615763	627	99.0	1.402e-131
UCT32H	contig_1	644452	644821	369	renamed_GCF_000008685.2	chromosome	644771	645140	369	100.0	1.529e-79
UCT32H	contig_1	645282	644817	465	renamed_GCF_000008685.2	chromosome	645601	645136	465	100.0	4.176e-101
UCT32H	contig_1	645399	646362	963	renamed_GCF_000008685.2	chromosome	645718	646681	963	99.6	1.275e-214
UCT32H	contig_1	648007	646339	1668	renamed_GCF_000008685.2	chromosome	648254	646658	1668	99.4	0.0
UCT32H	contig_1	648233	648788	555	renamed_GCF_000008685.2	chromosome	648552	649107	555	99.4	3.12e-119
UCT32H	contig_1	650068	648850	1218	renamed_GCF_000008685.2	chromosome	650387	649169	1218	99.7	6.126e-266
UCT32H	contig_1	653471	650093	3378	renamed_GCF_000008685.2	chromosome	653790	650412	3378	99.8	0.0
UCT32H	contig_1	653567	654530	963	renamed_GCF_000008685.2	chromosome	653886	654849	963	100.0	5.23e-216
UCT32H	contig_1	654489	656583	2094	renamed_GCF_000008685.2	chromosome	654862	656902	2094	99.1	0.0
UCT32H	contig_1	729275	730169	894	renamed_GCF_000008685.2	chromosome	729612	730506	894	98.9	3.048e-193
UCT32H	contig_1	730762	730294	468	renamed_GCF_000008685.2	chromosome	731099	730631	468	98.0	1.073e-99
UCT32H	contig_1	730846	731383	537	renamed_GCF_000008685.2	chromosome	731183	731720	537	100.0	1.936e-121
UCT32H	contig_1	731456	733466	2010	renamed_GCF_000008685.2	chromosome	731793	733803	2010	99.8	0.0
UCT32H	contig_1	733742	734951	1209	renamed_GCF_000008685.2	chromosome	734080	735289	1209	100.0	8.188e-270
UCT32H	contig_1	735013	736348	1335	renamed_GCF_000008685.2	chromosome	735351	736686	1335	99.5	6.578e-285
UCT32H	contig_1	736360	736621	261	renamed_GCF_000008685.2	chromosome	736698	736959	261	100.0	3.165e-54
UCT32H	contig_1	736621	736870	249	renamed_GCF_000008685.2	chromosome	736959	737208	249	100.0	2.148e-48
UCT32H	contig_1	736873	737374	501	renamed_GCF_000008685.2	chromosome	737211	737712	501	98.1	2.269e-105
UCT32H	contig_1	737370	738090	720	renamed_GCF_000008685.2	chromosome	737708	738428	720	99.5	4.764e-159
UCT32H	contig_1	771225	770823	402	renamed_GCF_000008685.2	chromosome	771563	771161	402	100.0	3.917e-83
UCT32H	contig_1	774030	771231	2799	renamed_GCF_000008685.2	chromosome	774368	771569	2799	99.6	0.0
UCT32H	contig_1	774338	775124	786	renamed_GCF_000008685.2	chromosome	774676	775462	786	100.0	1.17e-168
UCT32H	contig_1	776285	775271	1014	renamed_GCF_000008685.2	chromosome	776679	775665	1014	99.7	8.011e-220
UCT32H	contig_1	776390	777179	789	renamed_GCF_000008685.2	chromosome	776784	777573	789	98.4	5.027e-170
UCT32H	contig_1	777370	778360	990	renamed_GCF_000008685.2	chromosome	777764	778754	990	99.6	1.559e-225
UCT32H	contig_1	778363	780991	2628	renamed_GCF_000008685.2	chromosome	778757	781385	2628	98.8	0.0
UCT32H	contig_1	782435	781757	678	renamed_GCF_000008685.2	chromosome	782829	782151	678	99.1	5.213e-151
UCT32H	contig_1	782854	782581	273	renamed_GCF_000008685.2	chromosome	783248	782975	273	100.0	3.858e-54
UCT32H	contig_1	797652	796722	930	renamed_GCF_000008685.2	chromosome	798048	797118	930	100.0	3.063e-199
UCT32H	contig_1	798620	797660	960	renamed_GCF_000008685.2	chromosome	799016	798056	960	99.6	2.967e-213
UCT32H	contig_1	799879	798811	1068	renamed_GCF_000008685.2	chromosome	800275	799207	1068	99.4	9.097e-245
UCT32H	contig_1	800079	800676	597	renamed_GCF_000008685.2	chromosome	800475	801072	597	99.4	1.402e-126
UCT32H	contig_1	800614	801382	768	renamed_GCF_000008685.2	chromosome	801118	801778	768	98.1	1.322e-138
UCT32H	contig_1	802403	801545	858	renamed_GCF_000008685.2	chromosome	802798	801940	858	99.2	3.799e-176
UCT32H	contig_1	802772	802442	330	renamed_GCF_000008685.2	chromosome	803167	802837	330	100.0	2.178e-69
UCT32H	contig_1	814937	814502	435	renamed_GCF_000008685.2	chromosome	815302	814867	435	100.0	4.611e-95
UCT32H	contig_1	815934	815136	798	renamed_GCF_000008685.2	chromosome	816299	815501	798	100.0	1.968e-173
UCT32H	contig_1	816837	815946	891	renamed_GCF_000008685.2	chromosome	817160	816311	891	99.2	1.129e-186
UCT32H	contig_1	817030	817591	561	renamed_GCF_000008685.2	chromosome	817395	817956	561	100.0	3.237e-128
UCT32H	contig_1	817652	818183	531	renamed_GCF_000008685.2	chromosome	818017	818548	531	100.0	1.403e-115
UCT32H	contig_1	818239	818551	312	renamed_GCF_000008685.2	chromosome	818604	818916	312	100.0	1.086e-65
UCT32H	contig_1	818556	818877	321	renamed_GCF_000008685.2	chromosome	819035	819242	321	97.0	1.267e-41
UCT32H	contig_1	818876	819122	246	renamed_GCF_000008685.2	chromosome	819241	819487	246	100.0	8.275e-50
UCT32H	contig_1	819176	820163	987	renamed_GCF_000008685.2	chromosome	819541	820528	987	100.0	5.255e-220
UCT32H	contig_1	820241	820823	582	renamed_GCF_000008685.2	chromosome	820606	821188	582	100.0	9.143e-129
UCT32H	contig_1	847095	847944	849	renamed_GCF_000008685.2	chromosome	847490	848339	849	99.6	1.428e-185
UCT32H	contig_1	848142	848409	267	renamed_GCF_000008685.2	chromosome	848537	848804	267	100.0	3.495e-54
UCT32H	contig_1	848423	850592	2169	renamed_GCF_000008685.2	chromosome	848836	850987	2169	99.8	0.0
UCT32H	contig_1	850598	852119	1521	renamed_GCF_000008685.2	chromosome	850993	852514	1521	99.6	0.0
UCT32H	contig_1	852093	853383	1290	renamed_GCF_000008685.2	chromosome	852488	853778	1290	99.7	1.474e-285
UCT32H	contig_1	853379	854447	1068	renamed_GCF_000008685.2	chromosome	853774	854842	1068	100.0	1.362e-231
UCT32H	contig_1	854473	855601	1128	renamed_GCF_000008685.2	chromosome	854868	855996	1128	99.4	1.292e-259
UCT32H	contig_1	855593	857114	1521	renamed_GCF_000008685.2	chromosome	855988	857509	1521	99.8	0.0
UCT32H	contig_1	857110	858520	1410	renamed_GCF_000008685.2	chromosome	857505	858915	1410	99.3	7.483e-305
UCT32H	contig_1	859716	858543	1173	renamed_GCF_000008685.2	chromosome	860111	858938	1173	99.2	1.547e-256
UCT32H	contig_1	904507	903535	972	renamed_GCF_000008685.2	chromosome	904900	903928	972	99.3	1.264e-207
UCT32H	contig_1	905917	906706	789	renamed_GCF_000008685.2	lp21	2867	3656	789	99.6	6.373e-176
UCT32H	contig_1	916921	917509	588	renamed_GCF_000008685.2	lp21	14647	15235	588	100.0	4.973e-128
UCT32H	contig_1	917622	918087	465	renamed_GCF_000008685.2	lp21	15348	15813	465	99.3	4.176e-101
UCT32H	contig_1	918064	918358	294	renamed_GCF_000008685.2	lp21	15790	16084	294	100.0	2.432e-62
UCT32H	contig_1	918786	918501	285	renamed_GCF_000008685.2	lp21	16548	16227	285	98.9	2.097e-62
UCT32H	contig_1	919159	920152	993	renamed_GCF_000008685.2	lp5	3339	4332	993	100.0	1.858e-215
UCT32H	contig_1	920207	920639	432	renamed_GCF_000008685.2	lp5	4387	4819	432	99.3	2.641e-92
UCT32H	contig_2	646	1132	486	renamed_GCF_000008685.2	lp28-3	28197	27624	486	47.8	4.56e-45
UCT32H	contig_2	1454	1964	510	renamed_GCF_000008685.2	lp54	1460	1970	510	100.0	8.829e-109
UCT32H	contig_2	28040	28958	918	renamed_GCF_000008685.2	lp54	28013	28931	918	99.6	1.041e-200
UCT32H	contig_2	28961	29414	453	renamed_GCF_000008685.2	lp54	28934	29387	453	100.0	2.51e-96
UCT32H	contig_2	29410	29785	375	renamed_GCF_000008685.2	lp54	29383	29758	375	100.0	1.685e-79
UCT32H	contig_2	30120	30660	540	renamed_GCF_000008685.2	lp54	30093	30633	540	100.0	4.969e-120
UCT32H	contig_2	30746	31817	1071	renamed_GCF_000008685.2	lp54	30709	31780	1071	99.4	1.082e-234
UCT32H	contig_2	31816	32239	423	renamed_GCF_000008685.2	lp54	31779	32202	423	100.0	5.086e-92
UCT32H	contig_2	32297	32786	489	renamed_GCF_000008685.2	lp54	32260	32749	489	100.0	3.125e-108
UCT32H	contig_2	32778	32997	219	renamed_GCF_000008685.2	lp54	32741	32960	219	100.0	7.958e-46
UCT32H	contig_2	51863	52637	774	renamed_GCF_000008685.2	lp54	51705	52479	774	100.0	9.219e-161
UCT32H	contig_2	52863	53661	798	renamed_GCF_000008685.2	lp54	52705	53503	798	99.2	6.687e-177
UCT32H	contig_3	2	326	324	renamed_GCF_000008685.2	lp28-3	1044	1368	324	99.0	8.87e-70
UCT32H	contig_3	1940	1217	723	renamed_GCF_000008685.2	lp28-3	2970	2259	723	94.5	2.04e-143
UCT32H	contig_3	6697	2860	3837	renamed_GCF_000008685.2	lp28-3	7728	3891	3837	100.0	0.0
UCT32H	contig_3	7172	6968	204	renamed_GCF_000008685.2	lp36	17379	17583	204	83.5	3.933e-35
UCT32H	contig_3	9485	8816	669	renamed_GCF_000008685.2	lp28-3	10516	9847	669	100.0	5.739e-140
UCT32H	contig_3	50351	50723	372	renamed_GCF_000008685.2	lp5	1207	1576	372	81.29	1.564e-63
UCT32H	contig_5	20868	20289	579	renamed_GCF_000008685.2	cp32-8	22112	22691	579	100.0	3.43e-122
UCT32H	contig_5	22241	21500	741	renamed_GCF_000008685.2	cp32-8	20739	21480	741	99.5	5.003e-162
UCT32H	contig_5	25772	25325	447	renamed_GCF_000008685.2	cp32-8	17204	17651	447	100.0	1.879e-98
UCT32H	contig_5	26432	25877	555	renamed_GCF_000008685.2	cp32-8	16544	17099	555	100.0	3.776e-117
UCT32H	contig_5	26890	26536	354	renamed_GCF_000008685.2	cp32-7	16093	16447	354	100.0	1.459e-77
UCT32H	contig_5	27218	26882	336	renamed_GCF_000008685.2	lp56	19256	19592	336	100.0	5.348e-69
UCT32H	contig_5	27555	27207	348	renamed_GCF_000008685.2	cp32-6	15437	15785	348	99.1	1.964e-73
UCT32H	contig_5	27762	27558	204	renamed_GCF_000008685.2	cp32-1	15214	15418	204	100.0	2.578e-39
UCT32H	contig_5	29266	28660	606	renamed_GCF_000008685.2	cp32-8	13708	14314	606	99.0	1.337e-128
UCT32H	contig_5	30151	29275	876	renamed_GCF_000008685.2	cp32-3	12823	13699	876	100.0	5.609e-192
UCT32H	contig_5	30480	30147	333	renamed_GCF_000008685.2	cp32-8	12494	12827	333	100.0	8.424e-72
UCT32H	contig_6	173	866	693	renamed_GCF_000008685.2	cp32-1	1305	1998	693	100.0	2.582e-144
UCT32H	contig_6	877	1441	564	renamed_GCF_000008685.2	cp32-6	2009	2573	564	99.4	1.105e-123
UCT32H	contig_7	25771	25120	651	renamed_GCF_000008685.2	lp56	20042	20738	651	86.5	4.772e-122
UCT32H	contig_7	26556	26220	336	renamed_GCF_000008685.2	cp32-8	15758	16094	336	100.0	5.348e-69
UCT32H	contig_7	27100	26896	204	renamed_GCF_000008685.2	cp32-7	15221	15425	204	100.0	2.578e-39
UCT32H	contig_7	28604	27998	606	renamed_GCF_000008685.2	cp32-4	13661	14267	606	99.0	1.337e-128
UCT32H	contig_7	29818	29485	333	renamed_GCF_000008685.2	cp32-3	12494	12827	333	100.0	8.424e-72
UCT32H	contig_8	7094	6638	456	renamed_GCF_000008685.2	cp32-1	4941	5397	456	97.3	1.304e-95
UCT32H	contig_10	9380	8612	768	renamed_GCF_000008685.2	cp32-6	2576	3344	768	98.8	8.033e-170
UCT32H	contig_10	10651	9958	693	renamed_GCF_000008685.2	cp32-8	1305	1998	693	100.0	2.582e-144
UCT32H	contig_10	28540	27934	606	renamed_GCF_000008685.2	cp32-1	13708	14314	606	99.0	1.337e-128
UCT32H	contig_10	29425	28549	876	renamed_GCF_000008685.2	cp32-1	12823	13699	876	100.0	5.609e-192
UCT32H	contig_10	29754	29421	333	renamed_GCF_000008685.2	cp32-4	12447	12780	333	100.0	8.424e-72
UCT32H	contig_11	1604	1250	354	renamed_GCF_000008685.2	cp32-3	16083	16437	354	100.0	1.459e-77
UCT32H	contig_11	9407	8951	456	renamed_GCF_000008685.2	cp32-4	8281	8737	456	96.6	1.075e-97
UCT32H	contig_11	11529	10959	570	renamed_GCF_000008685.2	cp32-6	6160	6730	570	98.4	5.468e-124
UCT32H	contig_12	16714	15988	726	renamed_GCF_000008685.2	lp38	21222	21948	726	92.5	2.708e-149
UCT32H	contig_12	17936	16706	1230	renamed_GCF_000008685.2	lp38	20000	21230	1230	94.8	1.685e-256
UCT32H	contig_12	19717	18682	1035	renamed_GCF_000008685.2	lp38	18213	19254	1035	87.8	3.062e-208
UCT32H	contig_12	20536	19759	777	renamed_GCF_000008685.2	lp38	17387	18170	777	83.3	2.326e-142
UCT32H	contig_12	23237	24227	990	renamed_GCF_000008685.2	lp38	13440	12444	990	82.2	3.09e-183
UCT32H	contig_12	24782	25520	738	renamed_GCF_000008685.2	lp38	11889	11151	738	91.8	4.993e-153
UCT32H	contig_13	6398	7151	753	renamed_GCF_000008685.2	lp28-4	21562	20770	753	98.3	1.223e-162
UCT32H	contig_13	8777	9443	666	renamed_GCF_000008685.2	lp28-4	19183	18517	666	99.5	1.537e-145
UCT32H	contig_13	12603	11424	1179	renamed_GCF_000008685.2	lp28-4	15351	16530	1179	99.2	5.451e-252
UCT32H	contig_14	7040	8579	1539	renamed_GCF_000008685.2	cp26	16667	15131	1539	98.0	0.0
UCT32H	contig_14	11697	10104	1593	renamed_GCF_000008685.2	cp26	12013	13606	1593	99.4	0.0
UCT32H	contig_14	12292	12790	498	renamed_GCF_000008685.2	cp26	11417	10919	498	98.1	4.372e-106
UCT32H	contig_14	22959	23403	444	renamed_GCF_000008685.2	cp26	751	307	444	99.3	7.305e-100
UCT32H	contig_14	25384	23755	1629	renamed_GCF_000008685.2	cp26	24824	26453	1629	100.0	0.0
UCT32H	contig_17	8416	7597	819	renamed_GCF_000008685.2	lp28-2	12319	11500	819	100.0	1.075e-183
UCT32H	contig_17	8849	8405	444	renamed_GCF_000008685.2	lp28-2	12752	12308	444	100.0	8.866e-98
UCT32H	contig_17	9592	9253	339	renamed_GCF_000008685.2	lp28-2	13495	13156	339	96.4	2.068e-71
UCT32H	contig_17	11529	10983	546	renamed_GCF_000008685.2	lp28-2	15431	14885	546	99.4	4.794e-113
UCT32H	contig_17	12580	11554	1026	renamed_GCF_000008685.2	lp28-2	16482	15456	1026	99.4	8.508e-230
UCT32H	contig_17	14117	13778	339	renamed_GCF_000008685.2	lp28-2	18019	17680	339	100.0	5.085e-70
UCT32H	contig_17	15717	14934	783	renamed_GCF_000008685.2	lp28-2	19619	18836	783	92.3	1.226e-167
UCT32H	contig_17	18797	18410	387	renamed_GCF_000008685.2	lp28-2	22659	22272	387	72.6	9.831e-63
UCT32H	contig_17	19863	19170	693	renamed_GCF_000008685.2	lp28-2	23725	23032	693	83.4	3.937e-131
UCT32H	contig_18	6233	6917	684	renamed_GCF_000008685.2	lp17	5055	5739	684	99.5	1.274e-150
UCT32H	contig_21	730	1084	354	renamed_GCF_000008685.2	lp5	743	1097	354	99.1	7.983e-76
UCT32H	contig_24	895	691	204	renamed_GCF_000008685.2	lp56	18712	18916	204	100.0	2.578e-39
UCT32H	contig_1	29325	28344	981	renamed_GCF_000008685.2	chromosome	29472	28491	981	100.0	8.047e-223
UCT32H	contig_1	30882	31341	459	renamed_GCF_000008685.2	chromosome	31026	31479	459	99.3	5.582e-97
UCT32H	contig_1	31951	31411	540	renamed_GCF_000008685.2	chromosome	32089	31549	540	100.0	3.274e-116
UCT32H	contig_1	33899	32018	1881	renamed_GCF_000008685.2	chromosome	34037	32156	1881	100.0	0.0
UCT32H	contig_1	35698	33898	1800	renamed_GCF_000008685.2	chromosome	35836	34036	1800	100.0	0.0
UCT32H	contig_1	36471	35718	753	renamed_GCF_000008685.2	chromosome	36609	35856	753	98.0	1.62e-159
UCT32H	contig_1	169251	167730	1521	renamed_GCF_000008685.2	chromosome	169399	167878	1521	99.4	0.0
UCT32H	contig_1	182654	181259	1395	renamed_GCF_000008685.2	chromosome	182802	181407	1395	100.0	4.219e-300
UCT32H	contig_1	186800	187046	246	renamed_GCF_000008685.2	chromosome	186948	187194	246	100.0	9.168e-49
UCT32H	contig_1	188089	187675	414	renamed_GCF_000008685.2	chromosome	188237	187823	414	100.0	2.918e-88
UCT32H	contig_1	202430	200903	1527	renamed_GCF_000008685.2	chromosome	202578	201051	1527	99.6	0.0
UCT32H	contig_1	203988	204924	936	renamed_GCF_000008685.2	chromosome	204136	205072	936	100.0	4.7e-204
UCT32H	contig_1	208472	207935	537	renamed_GCF_000008685.2	chromosome	208581	208083	537	98.7	3.647e-106
UCT32H	contig_1	252847	254620	1773	renamed_GCF_000008685.2	chromosome	253158	254931	1773	99.3	0.0
UCT32H	contig_1	273551	274934	1383	renamed_GCF_000008685.2	chromosome	273856	275236	1383	99.5	1.314e-302
UCT32H	contig_1	276255	276762	507	renamed_GCF_000008685.2	chromosome	276671	277064	507	100.0	6.298e-87
UCT32H	contig_1	278257	276787	1470	renamed_GCF_000008685.2	chromosome	278559	277089	1470	99.7	4.387e-321
UCT32H	contig_1	279078	278775	303	renamed_GCF_000008685.2	chromosome	279380	279077	303	96.0	6.277e-62
UCT32H	contig_1	281491	281011	480	renamed_GCF_000008685.2	chromosome	281793	281313	480	99.3	5.307e-101
UCT32H	contig_1	292124	291341	783	renamed_GCF_000008685.2	chromosome	292426	291643	783	100.0	1.874e-171
UCT32H	contig_1	293127	292902	225	renamed_GCF_000008685.2	chromosome	293429	293204	225	100.0	8.8e-46
UCT32H	contig_1	296117	294938	1179	renamed_GCF_000008685.2	chromosome	296420	295241	1179	98.9	2.863e-259
UCT32H	contig_1	296742	296124	618	renamed_GCF_000008685.2	chromosome	297045	296427	618	99.5	5.47e-132
UCT32H	contig_1	415503	414036	1467	renamed_GCF_000008685.2	chromosome	415793	414326	1467	99.5	0.0
UCT32H	contig_1	416233	415555	678	renamed_GCF_000008685.2	chromosome	416478	415845	678	99.5	1.008e-143
UCT32H	contig_1	416398	416815	417	renamed_GCF_000008685.2	chromosome	416688	417105	417	99.2	1.376e-88
UCT32H	contig_1	426447	427662	1215	renamed_GCF_000008685.2	chromosome	426735	427950	1215	99.7	1.711e-262
UCT32H	contig_1	427698	428334	636	renamed_GCF_000008685.2	chromosome	427986	428622	636	99.5	1.686e-139
UCT32H	contig_1	428357	429386	1029	renamed_GCF_000008685.2	chromosome	428645	429674	1029	99.1	2.098e-237
UCT32H	contig_1	430328	429404	924	renamed_GCF_000008685.2	chromosome	430616	429692	924	98.0	2.542e-200
UCT32H	contig_1	434815	430330	4485	renamed_GCF_000008685.2	chromosome	435103	430618	4485	98.1	0.0
UCT32H	contig_1	442265	441425	840	renamed_GCF_000008685.2	chromosome	442552	441712	840	98.9	7.382e-183
UCT32H	contig_1	442961	442400	561	renamed_GCF_000008685.2	chromosome	443248	442687	561	99.4	1.054e-123
UCT32H	contig_1	469100	466994	2106	renamed_GCF_000008685.2	chromosome	469387	467281	2106	99.7	0.0
UCT32H	contig_1	469378	469102	276	renamed_GCF_000008685.2	chromosome	469665	469389	276	97.8	9.032e-54
UCT32H	contig_1	469684	469390	294	renamed_GCF_000008685.2	chromosome	469971	469677	294	100.0	2.2e-63
UCT32H	contig_1	481767	481053	714	renamed_GCF_000008685.2	chromosome	482057	481343	714	100.0	3.944e-160
UCT32H	contig_1	482309	483992	1683	renamed_GCF_000008685.2	chromosome	482599	484282	1683	99.6	0.0
UCT32H	contig_1	483996	484296	300	renamed_GCF_000008685.2	chromosome	484286	484586	300	98.9	2.966e-61
UCT32H	contig_1	484472	484976	504	renamed_GCF_000008685.2	chromosome	484756	485266	504	99.4	1.338e-111
UCT32H	contig_1	485259	485787	528	renamed_GCF_000008685.2	chromosome	485549	486077	528	100.0	1.004e-118
UCT32H	contig_1	485783	486479	696	renamed_GCF_000008685.2	chromosome	486073	486769	696	100.0	2.835e-152
UCT32H	contig_1	486426	487248	822	renamed_GCF_000008685.2	chromosome	486746	487538	822	99.6	9.243e-169
UCT32H	contig_1	501206	501575	369	renamed_GCF_000008685.2	chromosome	501496	501865	369	99.1	4.571e-76
UCT32H	contig_1	501589	501895	306	renamed_GCF_000008685.2	chromosome	501879	502185	306	100.0	2.959e-62
UCT32H	contig_1	501900	502449	549	renamed_GCF_000008685.2	chromosome	502190	502739	549	99.4	3.776e-116
UCT32H	contig_1	507115	507508	393	renamed_GCF_000008685.2	chromosome	507405	507798	393	100.0	3.073e-84
UCT32H	contig_1	507523	508558	1035	renamed_GCF_000008685.2	chromosome	507813	508848	1035	100.0	4.156e-222
UCT32H	contig_1	508579	508951	372	renamed_GCF_000008685.2	chromosome	508869	509241	372	100.0	8.775e-78
UCT32H	contig_1	509023	510556	1533	renamed_GCF_000008685.2	chromosome	509313	510846	1533	100.0	0.0
UCT32H	contig_1	510545	511334	789	renamed_GCF_000008685.2	chromosome	510835	511624	789	100.0	3.149e-175
UCT32H	contig_1	512849	512102	747	renamed_GCF_000008685.2	chromosome	513139	512392	747	100.0	7.284e-159
UCT32H	contig_1	512935	514237	1302	renamed_GCF_000008685.2	chromosome	513225	514527	1302	99.3	1.946e-284
UCT32H	contig_1	590869	592039	1170	renamed_GCF_000008685.2	chromosome	591187	592357	1170	98.9	5.197e-251
UCT32H	contig_1	595624	596203	579	renamed_GCF_000008685.2	chromosome	595942	596521	579	99.4	1.865e-120
UCT32H	contig_1	599058	598269	789	renamed_GCF_000008685.2	chromosome	599376	598587	789	99.2	5.285e-178
UCT32H	contig_1	600691	602026	1335	renamed_GCF_000008685.2	chromosome	601009	602344	1335	100.0	3.161e-293
UCT32H	contig_1	618241	616093	2148	renamed_GCF_000008685.2	chromosome	618559	616411	2148	99.8	0.0
UCT32H	contig_1	621635	620726	909	renamed_GCF_000008685.2	chromosome	621953	621044	909	99.0	1.832e-201
UCT32H	contig_1	623132	624689	1557	renamed_GCF_000008685.2	chromosome	623450	625007	1557	98.6	0.0
UCT32H	contig_1	625967	626720	753	renamed_GCF_000008685.2	chromosome	626285	627038	753	100.0	9.23e-166
UCT32H	contig_1	628630	626773	1857	renamed_GCF_000008685.2	chromosome	628948	627091	1857	100.0	0.0
UCT32H	contig_1	674714	676058	1344	renamed_GCF_000008685.2	chromosome	675034	676378	1344	99.7	1.793e-292
UCT32H	contig_1	678614	677567	1047	renamed_GCF_000008685.2	chromosome	678938	677891	1047	100.0	5.633e-238
UCT32H	contig_1	680239	679429	810	renamed_GCF_000008685.2	chromosome	680557	679753	810	99.6	5.278e-173
UCT32H	contig_1	682200	681360	840	renamed_GCF_000008685.2	chromosome	682524	681684	840	99.6	3.646e-182
UCT32H	contig_1	683098	684643	1545	renamed_GCF_000008685.2	chromosome	683422	684967	1545	99.8	0.0
UCT32H	contig_1	689869	690166	297	renamed_GCF_000008685.2	chromosome	690192	690489	297	100.0	1.037e-63
UCT32H	contig_1	690561	692322	1761	renamed_GCF_000008685.2	chromosome	690884	692645	1761	99.4	0.0
UCT32H	contig_1	693230	694373	1143	renamed_GCF_000008685.2	chromosome	693553	694696	1143	100.0	3.979e-258
UCT32H	contig_1	695200	694369	831	renamed_GCF_000008685.2	chromosome	695523	694692	831	99.2	6.41e-183
UCT32H	contig_1	728328	729282	954	renamed_GCF_000008685.2	chromosome	728665	729619	954	98.7	7.929e-210
UCT32H	contig_1	738805	739345	540	renamed_GCF_000008685.2	chromosome	739143	739683	540	100.0	2.458e-119
UCT32H	contig_1	739901	740084	183	renamed_GCF_000008685.2	chromosome	740239	740422	183	100.0	1.805e-39
UCT32H	contig_1	740349	741087	738	renamed_GCF_000008685.2	chromosome	740687	741425	738	100.0	4.772e-162
UCT32H	contig_1	742405	744178	1773	renamed_GCF_000008685.2	chromosome	742743	744516	1773	99.3	0.0
UCT32H	contig_1	744183	744507	324	renamed_GCF_000008685.2	chromosome	744521	744845	324	100.0	1.32e-65
UCT32H	contig_1	759248	759878	630	renamed_GCF_000008685.2	chromosome	759585	760215	630	99.5	1.853e-137
UCT32H	contig_1	763241	764024	783	renamed_GCF_000008685.2	chromosome	763578	764361	783	99.6	1.874e-171
UCT32H	contig_1	765035	766379	1344	renamed_GCF_000008685.2	chromosome	765372	766716	1344	100.0	2.685e-305
UCT32H	contig_1	866100	866301	201	renamed_GCF_000008685.2	chromosome	866493	866694	201	100.0	2.206e-40
UCT32H	contig_1	867721	867349	372	renamed_GCF_000008685.2	chromosome	868114	867742	372	99.1	1.771e-78
UCT32H	contig_1	889931	892784	2853	renamed_GCF_000008685.2	chromosome	890321	893174	2853	99.5	0.0
UCT32H	contig_1	896734	896188	546	renamed_GCF_000008685.2	chromosome	897127	896578	546	97.7	8.009e-116
UCT32H	contig_1	898927	897310	1617	renamed_GCF_000008685.2	chromosome	899320	897703	1617	99.6	0.0
UCT32H	contig_1	899105	900338	1233	renamed_GCF_000008685.2	chromosome	899498	900731	1233	100.0	1.522e-275
UCT32H	contig_1	900405	901389	984	renamed_GCF_000008685.2	chromosome	900798	901782	984	100.0	5.014e-220
UCT32H	contig_2	2888	2039	849	renamed_GCF_000008685.2	lp54	2893	2044	849	99.2	6.426e-186
UCT32H	contig_2	5134	4660	474	renamed_GCF_000008685.2	lp54	5140	4666	474	96.8	1.577e-96
UCT32H	contig_2	27416	28025	609	renamed_GCF_000008685.2	lp54	27389	27998	609	100.0	2.346e-131
UCT32H	contig_2	35024	35870	846	renamed_GCF_000008685.2	lp54	34987	35833	846	99.2	3.028e-185
UCT32H	contig_2	36304	36571	267	renamed_GCF_000008685.2	lp54	36255	36534	267	96.5	1.736e-53
UCT32H	contig_2	39442	38197	1245	renamed_GCF_000008685.2	lp54	39405	38160	1245	98.5	3.184e-269
UCT32H	contig_2	41084	40250	834	renamed_GCF_000008685.2	lp54	41045	40211	834	98.9	1.8e-180
UCT32H	contig_2	42058	41434	624	renamed_GCF_000008685.2	lp54	42019	41395	624	100.0	3.1e-139
UCT32H	contig_3	15488	16433	945	renamed_GCF_000008685.2	lp28-3	16518	17415	945	94.5	4.657e-197
UCT32H	contig_3	16964	17720	756	renamed_GCF_000008685.2	lp28-3	17946	18702	756	100.0	8.81e-167
UCT32H	contig_3	17815	18445	630	renamed_GCF_000008685.2	lp28-3	18797	19427	630	100.0	1.007e-135
UCT32H	contig_5	3375	3138	237	renamed_GCF_000008685.2	cp32-7	8725	8962	237	97.4	1.95e-47
UCT32H	contig_5	10797	10104	693	renamed_GCF_000008685.2	cp32-3	1305	1998	693	100.0	2.582e-144
UCT32H	contig_5	13455	12102	1353	renamed_GCF_000008685.2	cp32-7	29447	30800	1353	98.8	1.524e-304
UCT32H	contig_5	14018	13451	567	renamed_GCF_000008685.2	cp32-1	28834	29401	567	95.7	2.258e-116
UCT32H	contig_5	16057	14920	1137	renamed_GCF_000008685.2	cp32-1	26795	27932	1137	100.0	3.741e-249
UCT32H	contig_6	4271	4655	384	renamed_GCF_000008685.2	cp32-6	5403	5787	384	100.0	2.931e-83
UCT32H	contig_6	4642	5032	390	renamed_GCF_000008685.2	cp32-6	5774	6164	390	99.2	3.229e-83
UCT32H	contig_7	5895	5505	390	renamed_GCF_000008685.2	cp32-7	5766	6156	390	99.2	3.229e-83
UCT32H	contig_7	16569	17346	777	renamed_GCF_000008685.2	lp56	29506	28729	777	97.6	2.057e-169
UCT32H	contig_7	17777	17351	426	renamed_GCF_000008685.2	cp32-4	24209	24635	426	98.5	8.877e-95
UCT32H	contig_7	23593	24541	948	renamed_GCF_000008685.2	lp56	22479	21531	948	98.0	5.463e-213
UCT32H	contig_7	25015	24577	438	renamed_GCF_000008685.2	cp32-3	17802	18249	438	80.0	6.169e-76
UCT32H	contig_9	3845	4391	546	renamed_GCF_000008685.2	cp32-4	21414	21960	546	100.0	3.273e-117
UCT32H	contig_9	17110	17566	456	renamed_GCF_000008685.2	cp32-6	4948	5404	456	99.3	5.32e-97
UCT32H	contig_9	18322	18889	567	renamed_GCF_000008685.2	cp32-9	6169	6736	567	99.4	4.74e-125
UCT32H	contig_9	18869	19982	1113	renamed_GCF_000008685.2	cp32-4	6710	7823	1113	98.9	1.837e-244
UCT32H	contig_10	22978	21880	1098	renamed_GCF_000008685.2	cp32-7	19116	20214	1098	98.3	1.326e-245
UCT32H	contig_10	24992	24380	612	renamed_GCF_000008685.2	lp56	20843	21455	612	88.6	4.774e-124
UCT32H	contig_10	25706	25097	609	renamed_GCF_000008685.2	cp32-3	17088	17697	609	100.0	2.836e-129
UCT32H	contig_11	2476	2272	204	renamed_GCF_000008685.2	cp32-3	15211	15415	204	100.0	2.578e-39
UCT32H	contig_12	28639	27553	1086	renamed_GCF_000008685.2	lp38	26407	25336	1086	71.9	9.594e-160
UCT32H	contig_13	293	1187	894	renamed_GCF_000008685.2	lp36	187	1081	894	98.6	8.951e-190
UCT32H	contig_13	5029	5866	837	renamed_GCF_000008685.2	lp28-4	22931	22094	837	98.9	7.731e-182
UCT32H	contig_13	23251	23032	219	renamed_GCF_000008685.2	lp28-4	5127	5346	219	100.0	1.443e-47
UCT32H	contig_14	13609	13060	549	renamed_GCF_000008685.2	cp26	10103	10652	549	99.4	1.544e-117
UCT32H	contig_16	10113	9492	621	renamed_GCF_000008685.2	lp25	10187	9566	621	99.0	3.249e-138
UCT32H	contig_16	11752	11170	582	renamed_GCF_000008685.2	lp25	12079	11497	582	98.9	1.106e-126
UCT32H	contig_16	13066	12502	564	renamed_GCF_000008685.2	lp25	13393	12829	564	94.6	2.975e-121
UCT32H	contig_16	15233	14729	504	renamed_GCF_000008685.2	lp25	15545	15041	504	94.0	7.29e-110
UCT32H	contig_17	22122	22515	393	renamed_GCF_000008685.2	lp28-2	25979	26390	393	83.8	4.469e-72
UCT32H	contig_17	23262	24171	909	renamed_GCF_000008685.2	lp28-2	28030	28831	909	70.8	7.319e-125
UCT32H	contig_20	1541	2114	573	renamed_GCF_000008685.2	cp32-7	22087	22660	573	100.0	7.629e-121
UCT32H	contig_30	736	352	384	renamed_GCF_000008685.2	cp32-9	5412	5796	384	100.0	2.931e-83
UCT32H	contig_1	1806	777	1029	renamed_GCF_000008685.2	chromosome	1796	767	1029	100.0	4.829e-228
UCT32H	contig_1	6317	5261	1056	renamed_GCF_000008685.2	chromosome	6306	5250	1056	99.4	3.853e-235
UCT32H	contig_1	8326	7468	858	renamed_GCF_000008685.2	chromosome	8315	7457	858	100.0	6.472e-196
UCT32H	contig_1	9212	10217	1005	renamed_GCF_000008685.2	chromosome	9201	10206	1005	99.4	1.861e-217
UCT32H	contig_1	11431	12172	741	renamed_GCF_000008685.2	chromosome	11420	12161	741	99.1	4.555e-163
UCT32H	contig_1	46238	45869	369	renamed_GCF_000008685.2	chromosome	46379	46010	369	100.0	3.085e-80
UCT32H	contig_1	47763	48465	702	renamed_GCF_000008685.2	chromosome	47916	48606	702	99.1	1.109e-146
UCT32H	contig_1	49199	49871	672	renamed_GCF_000008685.2	chromosome	49340	50012	672	100.0	9.591e-152
UCT32H	contig_1	51109	50347	762	renamed_GCF_000008685.2	chromosome	51251	50489	762	99.2	1.282e-163
UCT32H	contig_1	53319	52311	1008	renamed_GCF_000008685.2	chromosome	53461	52453	1008	99.7	1.478e-220
UCT32H	contig_1	56138	55358	780	renamed_GCF_000008685.2	chromosome	56280	55500	780	99.6	1.628e-172
UCT32H	contig_1	57116	57833	717	renamed_GCF_000008685.2	chromosome	57258	57975	717	98.7	3.592e-153
UCT32H	contig_1	59896	58957	939	renamed_GCF_000008685.2	chromosome	60039	59100	939	99.3	9.091e-206
UCT32H	contig_1	60390	59892	498	renamed_GCF_000008685.2	chromosome	60533	60035	498	98.7	8.026e-108
UCT32H	contig_1	98675	100064	1389	renamed_GCF_000008685.2	chromosome	98816	100205	1389	99.5	1.169e-313
UCT32H	contig_1	101198	100604	594	renamed_GCF_000008685.2	chromosome	101339	100745	594	100.0	6.255e-135
UCT32H	contig_1	114461	112766	1695	renamed_GCF_000008685.2	chromosome	114603	112908	1695	100.0	0.0
UCT32H	contig_1	116664	115362	1302	renamed_GCF_000008685.2	chromosome	116806	115504	1302	98.3	5.194e-282
UCT32H	contig_1	118787	118232	555	renamed_GCF_000008685.2	chromosome	118929	118374	555	99.4	3.776e-117
UCT32H	contig_1	120939	120660	279	renamed_GCF_000008685.2	chromosome	121082	120803	279	96.7	3.477e-56
UCT32H	contig_1	122348	121736	612	renamed_GCF_000008685.2	chromosome	122491	121879	612	97.0	9.656e-125
UCT32H	contig_1	124003	122347	1656	renamed_GCF_000008685.2	chromosome	124146	122490	1656	99.2	0.0
UCT32H	contig_1	124671	124005	666	renamed_GCF_000008685.2	chromosome	124814	124148	666	100.0	8.347e-144
UCT32H	contig_1	174936	173949	987	renamed_GCF_000008685.2	chromosome	174970	174097	987	99.6	1.701e-189
UCT32H	contig_1	177705	176829	876	renamed_GCF_000008685.2	chromosome	177853	176977	876	100.0	9.427e-195
UCT32H	contig_1	179395	178768	627	renamed_GCF_000008685.2	chromosome	179543	178916	627	98.0	7.618e-130
UCT32H	contig_1	189128	188927	201	renamed_GCF_000008685.2	chromosome	189276	189075	201	98.4	4.922e-40
UCT32H	contig_1	189915	190569	654	renamed_GCF_000008685.2	chromosome	190186	190717	654	99.4	1.404e-110
UCT32H	contig_1	192179	191369	810	renamed_GCF_000008685.2	chromosome	192327	191517	810	99.6	1.125e-181
UCT32H	contig_1	194727	195588	861	renamed_GCF_000008685.2	chromosome	194875	195736	861	98.9	3.489e-186
UCT32H	contig_1	195544	197548	2004	renamed_GCF_000008685.2	chromosome	195692	197696	2004	99.7	0.0
UCT32H	contig_1	215116	216949	1833	renamed_GCF_000008685.2	chromosome	215426	217259	1833	99.6	0.0
UCT32H	contig_1	216970	218002	1032	renamed_GCF_000008685.2	chromosome	217277	218312	1032	99.1	2.355e-219
UCT32H	contig_1	266754	266964	210	renamed_GCF_000008685.2	chromosome	267065	267275	210	100.0	4.647e-42
UCT32H	contig_1	270162	269361	801	renamed_GCF_000008685.2	chromosome	270473	269672	801	99.6	3.29e-168
UCT32H	contig_1	283563	282396	1167	renamed_GCF_000008685.2	chromosome	283865	282698	1167	100.0	1.172e-258
UCT32H	contig_1	285657	283566	2091	renamed_GCF_000008685.2	chromosome	285962	283868	2091	99.4	0.0
UCT32H	contig_1	287871	287607	264	renamed_GCF_000008685.2	chromosome	288173	287909	264	100.0	2.025e-51
UCT32H	contig_1	289281	288654	627	renamed_GCF_000008685.2	chromosome	289583	288956	627	99.5	3.117e-131
UCT32H	contig_1	290719	289660	1059	renamed_GCF_000008685.2	chromosome	291021	289962	1059	100.0	3.164e-229
UCT32H	contig_1	300461	299426	1035	renamed_GCF_000008685.2	chromosome	300764	299729	1035	100.0	3.255e-216
UCT32H	contig_1	302536	302200	336	renamed_GCF_000008685.2	chromosome	302839	302503	336	98.1	1.315e-67
UCT32H	contig_1	303437	303029	408	renamed_GCF_000008685.2	chromosome	303740	303332	408	99.2	2.649e-88
UCT32H	contig_1	346998	346557	441	renamed_GCF_000008685.2	chromosome	347301	346860	441	100.0	1.706e-98
UCT32H	contig_1	347857	347047	810	renamed_GCF_000008685.2	chromosome	348160	347350	810	99.6	4.196e-184
UCT32H	contig_1	349307	347849	1458	renamed_GCF_000008685.2	chromosome	349610	348152	1458	99.5	5e-324
UCT32H	contig_1	350745	349296	1449	renamed_GCF_000008685.2	chromosome	351045	349599	1449	99.7	6.4e-322
UCT32H	contig_1	351028	350752	276	renamed_GCF_000008685.2	chromosome	351331	351055	276	98.9	1.819e-54
UCT32H	contig_1	364777	363826	951	renamed_GCF_000008685.2	chromosome	364972	364129	951	99.2	5.797e-187
UCT32H	contig_1	365301	364812	489	renamed_GCF_000008685.2	chromosome	365603	365114	489	100.0	3.787e-106
UCT32H	contig_1	366658	365926	732	renamed_GCF_000008685.2	chromosome	366960	366228	732	98.7	5.755e-159
UCT32H	contig_1	390039	388674	1365	renamed_GCF_000008685.2	chromosome	390341	388976	1365	99.3	3.579e-288
UCT32H	contig_1	391517	390092	1425	renamed_GCF_000008685.2	chromosome	391819	390391	1425	99.5	0.0
UCT32H	contig_1	392655	391629	1026	renamed_GCF_000008685.2	chromosome	392957	391931	1026	99.4	6.082e-225
UCT32H	contig_1	393761	392741	1020	renamed_GCF_000008685.2	chromosome	394063	393043	1020	100.0	6.665e-223
UCT32H	contig_1	394864	393802	1062	renamed_GCF_000008685.2	chromosome	395166	394104	1062	99.7	9.401e-235
UCT32H	contig_1	396206	395180	1026	renamed_GCF_000008685.2	chromosome	396506	395480	1026	100.0	3.003e-224
UCT32H	contig_1	396777	396303	474	renamed_GCF_000008685.2	chromosome	397077	396603	474	100.0	4.822e-101
UCT32H	contig_1	397176	396801	375	renamed_GCF_000008685.2	chromosome	397476	397101	375	100.0	1.385e-81
UCT32H	contig_1	401377	397243	4134	renamed_GCF_000008685.2	chromosome	401677	397543	4134	99.8	0.0
UCT32H	contig_1	422767	423547	780	renamed_GCF_000008685.2	chromosome	423054	423834	780	99.6	1.628e-172
UCT32H	contig_1	424158	423534	624	renamed_GCF_000008685.2	chromosome	424442	423821	624	99.5	4.527e-135
UCT32H	contig_1	424405	425263	858	renamed_GCF_000008685.2	chromosome	424693	425551	858	100.0	1.579e-194
UCT32H	contig_1	425295	426423	1128	renamed_GCF_000008685.2	chromosome	425583	426711	1128	99.7	5.155e-244
UCT32H	contig_1	448305	447915	390	renamed_GCF_000008685.2	chromosome	448591	448201	390	100.0	7.926e-82
UCT32H	contig_1	448418	449024	606	renamed_GCF_000008685.2	chromosome	448707	449310	606	99.5	2.46e-130
UCT32H	contig_1	449132	449885	753	renamed_GCF_000008685.2	chromosome	449418	450171	753	100.0	3.278e-160
UCT32H	contig_1	451635	450852	783	renamed_GCF_000008685.2	chromosome	451921	451138	783	99.2	5.024e-169
UCT32H	contig_1	494742	495927	1185	renamed_GCF_000008685.2	chromosome	495032	496217	1185	100.0	4.832e-263
UCT32H	contig_1	495977	496289	312	renamed_GCF_000008685.2	chromosome	496267	496579	312	100.0	2.953e-63
UCT32H	contig_1	496324	496945	621	renamed_GCF_000008685.2	chromosome	496614	497235	621	100.0	8.732e-136
UCT32H	contig_1	496954	497584	630	renamed_GCF_000008685.2	chromosome	497244	497874	630	100.0	4.528e-136
UCT32H	contig_1	497604	497901	297	renamed_GCF_000008685.2	chromosome	497894	498191	297	100.0	5.69e-62
UCT32H	contig_1	502441	502651	210	renamed_GCF_000008685.2	chromosome	502755	502941	210	100.0	1.151e-40
UCT32H	contig_1	502660	503059	399	renamed_GCF_000008685.2	chromosome	502950	503349	399	100.0	3.071e-85
UCT32H	contig_1	503075	503618	543	renamed_GCF_000008685.2	chromosome	503365	503908	543	100.0	7.636e-116
UCT32H	contig_1	503635	503995	360	renamed_GCF_000008685.2	chromosome	503925	504285	360	99.1	4.361e-75
UCT32H	contig_1	504007	504505	498	renamed_GCF_000008685.2	chromosome	504297	504795	498	99.3	1.965e-106
UCT32H	contig_1	528900	527805	1095	renamed_GCF_000008685.2	chromosome	529198	528103	1095	99.7	8.741e-250
UCT32H	contig_1	530807	528899	1908	renamed_GCF_000008685.2	chromosome	531105	529197	1908	100.0	0.0
UCT32H	contig_1	531394	530830	564	renamed_GCF_000008685.2	chromosome	531692	531128	564	100.0	2.704e-122
UCT32H	contig_1	534003	534858	855	renamed_GCF_000008685.2	chromosome	534300	535155	855	99.6	9.843e-191
UCT32H	contig_1	535303	534880	423	renamed_GCF_000008685.2	chromosome	535600	535177	423	100.0	5.606e-91
UCT32H	contig_1	535406	537230	1824	renamed_GCF_000008685.2	chromosome	535703	537527	1824	99.5	0.0
UCT32H	contig_1	537222	538011	789	renamed_GCF_000008685.2	chromosome	537543	538308	789	98.8	3.287e-166
UCT32H	contig_1	538978	538030	948	renamed_GCF_000008685.2	chromosome	539275	538327	948	99.3	2.459e-213
UCT32H	contig_8	13222	11869	1353	renamed_GCF_000008685.2	cp32-3	28870	30223	1353	99.1	1.524e-304
UCT32H	contig_8	23619	24567	948	renamed_GCF_000008685.2	cp32-6	18680	17732	948	99.0	9.187e-216
UCT32H	contig_8	27254	27050	204	renamed_GCF_000008685.2	cp32-8	15214	15418	204	100.0	2.578e-39
UCT32H	contig_9	24405	24738	333	renamed_GCF_000008685.2	cp32-9	12592	12925	333	100.0	1.876e-71
UCT32H	contig_9	27122	27326	204	renamed_GCF_000008685.2	cp32-9	15311	15515	204	100.0	2.578e-39
UCT32H	contig_11	25195	24658	537	renamed_GCF_000008685.2	cp32-3	22592	23183	537	90.3	2.263e-111
UCT32H	contig_11	27073	26506	567	renamed_GCF_000008685.2	cp32-4	20066	20633	567	100.0	2.944e-130
UCT32H	contig_11	28572	29586	1014	renamed_GCF_000008685.2	cp32-1	18728	17714	1014	99.7	7.051e-230
UCT32H	contig_12	15965	14927	1038	renamed_GCF_000008685.2	lp38	22042	23008	1038	88.7	1.356e-200
UCT32H	contig_12	18624	17928	696	renamed_GCF_000008685.2	lp38	19312	20008	696	94.3	1.108e-145
UCT32H	contig_12	21398	20588	810	renamed_GCF_000008685.2	lp38	16519	17329	810	86.2	2.571e-155
UCT32H	contig_12	24219	24810	591	renamed_GCF_000008685.2	lp38	12452	11861	591	89.6	1.347e-117
UCT32H	contig_15	22494	23679	1185	renamed_GCF_000008685.2	chromosome	908406	909591	1185	100.0	8.142e-266
UCT32H	contig_16	23730	22860	870	renamed_GCF_000008685.2	lp28-2	1046	1928	870	97.5	3.038e-189
UCT32H	contig_17	7588	7159	429	renamed_GCF_000008685.2	lp28-2	11491	11062	429	99.2	1.514e-89
UCT32H	contig_17	9238	8845	393	renamed_GCF_000008685.2	lp28-2	13141	12748	393	99.2	3.389e-83
UCT32H	contig_17	10438	9604	834	renamed_GCF_000008685.2	lp28-2	14341	13507	834	97.1	3.643e-181
UCT32H	contig_18	20763	20493	270	renamed_GCF_000008685.2	lp17	14069	14339	270	100.0	1.489e-55
UCT32H	contig_19	9130	8797	333	renamed_GCF_000008685.2	cp32-6	12513	12846	333	100.0	8.424e-72
UCT32H	contig_19	12680	11390	1290	renamed_GCF_000008685.2	cp32-4	8977	10273	1290	81.49	7.054e-224
UCT32H	contig_24	351	15	336	renamed_GCF_000008685.2	cp32-9	15855	16191	336	100.0	5.348e-69
UCT32H	contig_1	106753	105742	1011	renamed_GCF_000008685.2	chromosome	106894	105883	1011	100.0	4.14e-218
UCT32H	contig_1	108165	109530	1365	renamed_GCF_000008685.2	chromosome	108306	109671	1365	100.0	4.349e-312
UCT32H	contig_1	111426	110904	522	renamed_GCF_000008685.2	chromosome	111567	111045	522	100.0	1.783e-111
UCT32H	contig_1	112196	111746	450	renamed_GCF_000008685.2	chromosome	112338	111888	450	99.3	9.762e-98
UCT32H	contig_1	133831	135721	1890	renamed_GCF_000008685.2	chromosome	133974	135864	1890	99.2	0.0
UCT32H	contig_1	138598	138286	312	renamed_GCF_000008685.2	chromosome	138745	138433	312	99.0	2.189e-66
UCT32H	contig_1	142787	141833	954	renamed_GCF_000008685.2	chromosome	142932	141978	954	99.0	1.826e-200
UCT32H	contig_1	145313	144440	873	renamed_GCF_000008685.2	chromosome	145458	144585	873	98.9	1.511e-197
UCT32H	contig_1	159219	159894	675	renamed_GCF_000008685.2	chromosome	159367	160042	675	98.6	4.754e-143
UCT32H	contig_1	202701	203940	1239	renamed_GCF_000008685.2	chromosome	202849	204088	1239	100.0	5.514e-262
UCT32H	contig_1	204924	205896	972	renamed_GCF_000008685.2	chromosome	205174	206044	972	99.6	3.289e-188
UCT32H	contig_1	206381	207932	1551	renamed_GCF_000008685.2	chromosome	206528	208106	1551	99.8	0.0
UCT32H	contig_1	224475	223653	822	renamed_GCF_000008685.2	chromosome	224785	223963	822	100.0	3.638e-179
UCT32H	contig_1	227517	226299	1218	renamed_GCF_000008685.2	chromosome	227827	226609	1218	99.7	3.023e-265
UCT32H	contig_1	228906	229914	1008	renamed_GCF_000008685.2	chromosome	229216	230224	1008	99.4	2.993e-221
UCT32H	contig_1	231310	232012	702	renamed_GCF_000008685.2	chromosome	231620	232322	702	100.0	1.161e-154
UCT32H	contig_1	245069	244466	603	renamed_GCF_000008685.2	chromosome	245382	244776	603	99.5	7.936e-134
UCT32H	contig_1	294477	293148	1329	renamed_GCF_000008685.2	chromosome	294780	293451	1329	99.5	2.627e-294
UCT32H	contig_1	294925	294481	444	renamed_GCF_000008685.2	chromosome	295228	294784	444	98.6	1.306e-93
UCT32H	contig_1	297166	296734	432	renamed_GCF_000008685.2	chromosome	297469	297037	432	99.3	2.176e-94
UCT32H	contig_1	299412	298491	921	renamed_GCF_000008685.2	chromosome	299715	298794	921	99.6	2.293e-192
UCT32H	contig_1	310220	309476	744	renamed_GCF_000008685.2	chromosome	310523	309779	744	99.5	1.166e-161
UCT32H	contig_1	312412	311356	1056	renamed_GCF_000008685.2	chromosome	312715	311659	1056	100.0	1.239e-230
UCT32H	contig_1	313821	312429	1392	renamed_GCF_000008685.2	chromosome	314123	312728	1392	100.0	1.047e-306
UCT32H	contig_1	315012	314121	891	renamed_GCF_000008685.2	chromosome	315314	314423	891	99.6	4.455e-197
UCT32H	contig_1	316914	315837	1077	renamed_GCF_000008685.2	chromosome	317216	316139	1077	99.7	9.003e-238
UCT32H	contig_1	327728	328865	1137	renamed_GCF_000008685.2	chromosome	328031	329165	1137	99.7	1.4e-251
UCT32H	contig_1	552847	553498	651	renamed_GCF_000008685.2	chromosome	553138	553789	651	99.5	3.256e-143
UCT32H	contig_1	553700	554921	1221	renamed_GCF_000008685.2	chromosome	553991	555212	1221	100.0	5.34e-268
UCT32H	contig_1	554924	556289	1365	renamed_GCF_000008685.2	chromosome	555215	556580	1365	99.1	1.676e-305
UCT32H	contig_1	567958	568828	870	renamed_GCF_000008685.2	chromosome	568269	569139	870	100.0	1.737e-195
UCT32H	contig_1	568965	569226	261	renamed_GCF_000008685.2	chromosome	569277	569538	261	100.0	9.575e-51
UCT32H	contig_1	569246	570968	1722	renamed_GCF_000008685.2	chromosome	569558	571280	1722	99.8	0.0
UCT32H	contig_1	570970	571540	570	renamed_GCF_000008685.2	chromosome	571282	571852	570	100.0	1.471e-121
UCT32H	contig_1	573428	571577	1851	renamed_GCF_000008685.2	chromosome	573740	571889	1851	100.0	0.0
UCT32H	contig_1	573540	574935	1395	renamed_GCF_000008685.2	chromosome	573852	575247	1395	99.3	1.406e-312
UCT32H	contig_1	618509	620717	2208	renamed_GCF_000008685.2	chromosome	618827	621035	2208	99.8	0.0
UCT32H	contig_1	621686	623129	1443	renamed_GCF_000008685.2	chromosome	622004	623447	1443	99.1	0.0
UCT32H	contig_1	624688	625942	1254	renamed_GCF_000008685.2	chromosome	625006	626260	1254	100.0	1.925e-276
UCT32H	contig_1	630380	628877	1503	renamed_GCF_000008685.2	chromosome	630698	629195	1503	100.0	0.0
UCT32H	contig_1	631672	632164	492	renamed_GCF_000008685.2	chromosome	631990	632482	492	100.0	1.786e-106
UCT32H	contig_1	632166	634146	1980	renamed_GCF_000008685.2	chromosome	632484	634464	1980	99.2	0.0
UCT32H	contig_1	636273	637638	1365	renamed_GCF_000008685.2	chromosome	636592	637957	1365	99.3	1.721e-296
UCT32H	contig_1	638260	639553	1293	renamed_GCF_000008685.2	chromosome	638579	639872	1293	99.5	1.544e-285
UCT32H	contig_1	641969	642122	153	renamed_GCF_000008685.2	chromosome	642288	642441	153	98.0	2.814e-30
UCT32H	contig_1	644331	642975	1356	renamed_GCF_000008685.2	chromosome	644650	643294	1356	99.5	1.919e-302
UCT32H	contig_1	688166	689804	1638	renamed_GCF_000008685.2	chromosome	688489	690127	1638	100.0	0.0
UCT32H	contig_1	690179	690476	297	renamed_GCF_000008685.2	chromosome	690481	690799	297	98.9	6.955e-60
UCT32H	contig_1	692305	693205	900	renamed_GCF_000008685.2	chromosome	692628	693528	900	99.6	4.423e-190
UCT32H	contig_1	695298	696432	1134	renamed_GCF_000008685.2	chromosome	695630	696764	1134	99.2	3.457e-258
UCT32H	contig_1	697253	698000	747	renamed_GCF_000008685.2	chromosome	697585	698332	747	100.0	1.547e-167
UCT32H	contig_1	700592	699719	873	renamed_GCF_000008685.2	chromosome	700924	700051	873	99.3	1.433e-189
UCT32H	contig_1	701062	701473	411	renamed_GCF_000008685.2	chromosome	701394	701805	411	98.5	1.377e-87
UCT32H	contig_1	702634	701950	684	renamed_GCF_000008685.2	chromosome	702951	702282	684	99.5	1.009e-144
UCT32H	contig_1	702676	703636	960	renamed_GCF_000008685.2	chromosome	703008	703968	960	100.0	6.008e-214
UCT32H	contig_1	716285	717437	1152	renamed_GCF_000008685.2	chromosome	716619	717771	1152	100.0	1.261e-246
UCT32H	contig_1	764033	765005	972	renamed_GCF_000008685.2	chromosome	764370	765342	972	99.3	7.249e-214
UCT32H	contig_1	767727	766395	1332	renamed_GCF_000008685.2	chromosome	768064	766732	1332	98.6	1.788e-290
UCT32H	contig_1	831363	830589	774	renamed_GCF_000008685.2	chromosome	831563	830954	774	99.5	5.119e-133
UCT32H	contig_1	835695	838161	2466	renamed_GCF_000008685.2	chromosome	836060	838526	2466	99.6	0.0
UCT32H	contig_1	838878	841467	2589	renamed_GCF_000008685.2	chromosome	839243	841832	2589	99.5	0.0
UCT32H	contig_1	842186	842624	438	renamed_GCF_000008685.2	chromosome	842500	842989	438	98.6	2.908e-92
UCT32H	contig_1	844088	846707	2619	renamed_GCF_000008685.2	chromosome	844453	847102	2619	97.7	0.0
UCT32H	contig_1	860045	861380	1335	renamed_GCF_000008685.2	chromosome	860439	861774	1335	99.3	1.013e-288
UCT32H	contig_1	863242	864649	1407	renamed_GCF_000008685.2	chromosome	863635	865042	1407	99.5	3.133e-314
UCT32H	contig_2	20744	20939	195	renamed_GCF_000008685.2	lp54	20717	20912	195	100.0	2.214e-39
UCT32H	contig_2	23300	21710	1590	renamed_GCF_000008685.2	lp54	23273	21683	1590	99.6	0.0
UCT32H	contig_2	25479	26721	1242	renamed_GCF_000008685.2	lp54	25467	26694	1242	99.7	3.651e-267
UCT32H	contig_2	34421	34985	564	renamed_GCF_000008685.2	lp54	34384	34948	564	99.4	3.599e-119
UCT32H	contig_2	35990	36266	276	renamed_GCF_000008685.2	lp54	35953	36229	276	100.0	3.31e-56
UCT32H	contig_2	40151	39911	240	renamed_GCF_000008685.2	lp54	40112	39872	240	100.0	3.722e-49
UCT32H	contig_3	16425	16992	567	renamed_GCF_000008685.2	lp28-3	17407	17974	567	99.4	9.584e-126
UCT32H	contig_3	20487	21237	750	renamed_GCF_000008685.2	lp28-3	21469	22219	750	100.0	6.33e-161
UCT32H	contig_3	26463	25995	468	renamed_GCF_000008685.2	lp28-3	27445	26977	468	98.7	2.979e-105
UCT32H	contig_3	41839	40192	1647	renamed_GCF_000008685.2	lp36	10300	11947	1647	99.8	0.0
UCT32H	contig_3	43281	43977	696	renamed_GCF_000008685.2	lp36	8859	8163	696	97.8	8.359e-149
UCT32H	contig_3	45769	45493	276	renamed_GCF_000008685.2	lp36	6365	6650	276	98.9	6.026e-58
UCT32H	contig_6	3816	4272	456	renamed_GCF_000008685.2	cp32-7	4940	5396	456	97.3	1.304e-95
UCT32H	contig_6	11355	11688	333	renamed_GCF_000008685.2	cp32-1	12494	12827	333	100.0	8.424e-72
UCT32H	contig_7	2691	1380	1311	renamed_GCF_000008685.2	cp32-7	8969	10304	1311	81.0	4.301e-233
UCT32H	contig_9	16131	17091	960	renamed_GCF_000008685.2	cp32-6	3969	4929	960	100.0	6.008e-214
UCT32H	contig_9	17936	18326	390	renamed_GCF_000008685.2	cp32-9	5783	6173	390	100.0	3.229e-83
UCT32H	contig_9	20893	21130	237	renamed_GCF_000008685.2	cp32-6	8733	8970	237	97.4	8.748e-48
UCT32H	contig_9	29141	29570	429	renamed_GCF_000008685.2	cp32-9	17301	17730	429	75.7	2.858e-66
UCT32H	contig_11	4864	3985	879	renamed_GCF_000008685.2	cp32-7	12831	13710	879	96.2	1.027e-185
UCT32H	contig_11	6743	5801	942	renamed_GCF_000008685.2	cp32-7	10961	11903	942	97.7	3.561e-208
UCT32H	contig_11	19605	19038	567	renamed_GCF_000008685.2	cp32-7	28884	29451	567	100.0	5.734e-123
UCT32H	contig_11	21580	22357	777	renamed_GCF_000008685.2	cp32-3	26276	25499	777	98.8	7.674e-172
UCT32H	contig_12	30044	29807	237	renamed_GCF_000008685.2	lp28-2	29618	28853	237	71.0	1.432e-27
UCT32H	contig_14	19914	21237	1323	renamed_GCF_000008685.2	cp26	3798	2475	1323	99.5	7.001e-291
UCT32H	contig_16	7349	6830	519	renamed_GCF_000008685.2	lp28-4	26359	26914	519	91.3	2.191e-100
UCT32H	contig_16	10632	10125	507	renamed_GCF_000008685.2	lp25	10694	10199	507	96.3	1.122e-105
UCT32H	contig_16	12527	11768	759	renamed_GCF_000008685.2	lp25	12854	12095	759	98.4	5.504e-164
UCT32H	contig_16	14161	13075	1086	renamed_GCF_000008685.2	lp25	14530	13402	1086	93.0	2.375e-228
UCT32H	contig_19	16896	17673	777	renamed_GCF_000008685.2	cp32-8	25951	25174	777	93.7	3.284e-164
UCT32H	contig_20	1008	1530	522	renamed_GCF_000008685.2	cp32-7	21521	22076	522	100.0	1.473e-113
UCT32H	contig_20	2501	3827	1326	renamed_GCF_000008685.2	cp32-7	23134	24460	1326	99.0	3.52e-299
UCT32H	contig_1	98	662	564	renamed_GCF_000008685.2	chromosome	104	677	564	96.2	6.014e-122
UCT32H	contig_1	3405	5199	1794	renamed_GCF_000008685.2	chromosome	3418	5188	1794	99.4	0.0
UCT32H	contig_1	7408	6319	1089	renamed_GCF_000008685.2	chromosome	7397	6308	1089	99.7	9.025e-240
UCT32H	contig_1	8437	9208	771	renamed_GCF_000008685.2	chromosome	8426	9197	771	100.0	1.781e-161
UCT32H	contig_1	10213	10588	375	renamed_GCF_000008685.2	chromosome	10202	10577	375	99.1	8.349e-79
UCT32H	contig_1	10591	11431	840	renamed_GCF_000008685.2	chromosome	10580	11420	840	100.0	7.775e-191
UCT32H	contig_1	12164	12764	600	renamed_GCF_000008685.2	chromosome	12153	12753	600	98.9	1.006e-130
UCT32H	contig_1	15356	14735	621	renamed_GCF_000008685.2	chromosome	15345	14724	621	100.0	3.249e-138
UCT32H	contig_1	15855	16815	960	renamed_GCF_000008685.2	chromosome	15994	16804	960	98.5	5.872e-171
UCT32H	contig_1	47025	47700	675	renamed_GCF_000008685.2	chromosome	47166	47841	675	98.6	2.138e-143
UCT32H	contig_1	49118	48461	657	renamed_GCF_000008685.2	chromosome	49259	48602	657	98.1	5.738e-138
UCT32H	contig_1	50332	49969	363	renamed_GCF_000008685.2	chromosome	50474	50111	363	100.0	4.578e-75
UCT32H	contig_1	52292	51110	1182	renamed_GCF_000008685.2	chromosome	52434	51252	1182	99.4	1.623e-257
UCT32H	contig_1	55362	53391	1971	renamed_GCF_000008685.2	chromosome	55504	53533	1971	99.6	0.0
UCT32H	contig_1	56606	56138	468	renamed_GCF_000008685.2	chromosome	56748	56280	468	99.3	1.969e-101
UCT32H	contig_1	57043	56689	354	renamed_GCF_000008685.2	chromosome	57185	56831	354	99.1	6.554e-78
UCT32H	contig_1	58894	57886	1008	renamed_GCF_000008685.2	chromosome	58982	58028	1008	99.0	1.313e-204
UCT32H	contig_1	61114	60424	690	renamed_GCF_000008685.2	chromosome	61257	60567	690	98.6	3.759e-148
UCT32H	contig_1	63894	65133	1239	renamed_GCF_000008685.2	chromosome	64037	65276	1239	99.5	1.39e-277
UCT32H	contig_1	98640	97722	918	renamed_GCF_000008685.2	chromosome	98648	97862	918	99.2	2.343e-174
UCT32H	contig_1	100086	100608	522	renamed_GCF_000008685.2	chromosome	100227	100749	522	100.0	2.976e-114
UCT32H	contig_1	102808	101383	1425	renamed_GCF_000008685.2	chromosome	102949	101524	1425	100.0	1.009e-312
UCT32H	contig_1	112627	112207	420	renamed_GCF_000008685.2	chromosome	112769	112349	420	99.2	1.444e-88
UCT32H	contig_1	114664	115366	702	renamed_GCF_000008685.2	chromosome	114806	115508	702	100.0	2.35e-155
UCT32H	contig_1	118228	117535	693	renamed_GCF_000008685.2	chromosome	118370	117677	693	98.2	1.337e-151
UCT32H	contig_1	119661	118821	840	renamed_GCF_000008685.2	chromosome	119803	118963	840	97.1	3.15e-175
UCT32H	contig_1	120447	119664	783	renamed_GCF_000008685.2	chromosome	120589	119806	783	99.6	5.024e-169
UCT32H	contig_1	121680	120957	723	renamed_GCF_000008685.2	chromosome	121823	121100	723	98.7	4.546e-160
UCT32H	contig_1	125404	124654	750	renamed_GCF_000008685.2	chromosome	125547	124797	750	100.0	1.281e-161
UCT32H	contig_1	705245	706271	1026	renamed_GCF_000008685.2	chromosome	705579	706605	1026	100.0	2.737e-225
UCT32H	contig_1	706338	708933	2595	renamed_GCF_000008685.2	chromosome	706672	709267	2595	99.4	0.0
UCT32H	contig_1	708939	710340	1401	renamed_GCF_000008685.2	chromosome	709273	710674	1401	98.2	2.931e-305
UCT32H	contig_1	710351	710837	486	renamed_GCF_000008685.2	chromosome	710685	711171	486	100.0	5.304e-102
UCT32H	contig_1	710876	711317	441	renamed_GCF_000008685.2	chromosome	711210	711651	441	100.0	1.245e-93
UCT32H	contig_1	711873	711357	516	renamed_GCF_000008685.2	chromosome	712207	711691	516	99.4	8.019e-111
UCT32H	contig_1	712916	711869	1047	renamed_GCF_000008685.2	chromosome	713250	712203	1047	100.0	4.165e-224
UCT32H	contig_1	713773	712909	864	renamed_GCF_000008685.2	chromosome	714107	713243	864	100.0	1.134e-190
UCT32H	contig_1	714432	713769	663	renamed_GCF_000008685.2	chromosome	714766	714103	663	98.1	3.581e-144
UCT32H	contig_1	714674	716285	1611	renamed_GCF_000008685.2	chromosome	715008	716619	1611	99.8	0.0
UCT32H	contig_1	747785	749681	1896	renamed_GCF_000008685.2	chromosome	748122	750018	1896	100.0	0.0
UCT32H	contig_1	749693	750452	759	renamed_GCF_000008685.2	chromosome	750030	750789	759	100.0	2.255e-165
UCT32H	contig_1	750853	751822	969	renamed_GCF_000008685.2	chromosome	751190	752159	969	100.0	4.772e-218
UCT32H	contig_1	751832	752882	1050	renamed_GCF_000008685.2	chromosome	752169	753219	1050	100.0	6.109e-229
UCT32H	contig_1	752885	753731	846	renamed_GCF_000008685.2	chromosome	753291	754068	846	99.6	1.473e-167
UCT32H	contig_1	753730	754213	483	renamed_GCF_000008685.2	chromosome	754067	754550	483	99.3	6.952e-107
UCT32H	contig_1	754212	756012	1800	renamed_GCF_000008685.2	chromosome	754636	756349	1800	100.0	0.0
UCT32H	contig_1	756016	757333	1317	renamed_GCF_000008685.2	chromosome	756353	757670	1317	99.7	1.293e-291
UCT32H	contig_1	782995	784627	1632	renamed_GCF_000008685.2	chromosome	783389	785021	1632	99.8	0.0
UCT32H	contig_1	784662	786360	1698	renamed_GCF_000008685.2	chromosome	785056	786754	1698	99.4	0.0
UCT32H	contig_1	786465	788568	2103	renamed_GCF_000008685.2	chromosome	786859	788962	2103	99.4	0.0
UCT32H	contig_1	788924	789542	618	renamed_GCF_000008685.2	chromosome	789302	789938	618	99.5	3.406e-137
UCT32H	contig_1	790411	789550	861	renamed_GCF_000008685.2	chromosome	790807	789946	861	100.0	1.57e-186
UCT32H	contig_1	791391	790410	981	renamed_GCF_000008685.2	chromosome	791787	790806	981	99.6	2.843e-217
UCT32H	contig_1	791856	791397	459	renamed_GCF_000008685.2	chromosome	792252	791793	459	98.6	5.582e-97
UCT32H	contig_1	791954	793229	1275	renamed_GCF_000008685.2	chromosome	792350	793625	1275	98.1	4.931e-278
UCT32H	contig_1	794459	793445	1014	renamed_GCF_000008685.2	chromosome	794855	793841	1014	98.8	2.27e-225
UCT32H	contig_1	806528	805379	1149	renamed_GCF_000008685.2	chromosome	806923	805774	1149	99.7	5.42e-247
UCT32H	contig_1	807571	806524	1047	renamed_GCF_000008685.2	chromosome	807966	806919	1047	100.0	5.315e-230
UCT32H	contig_1	808069	807580	489	renamed_GCF_000008685.2	chromosome	808464	807975	489	100.0	6.125e-101
UCT32H	contig_1	809157	808065	1092	renamed_GCF_000008685.2	chromosome	809552	808460	1092	99.7	8.623e-241
UCT32H	contig_1	810100	809305	795	renamed_GCF_000008685.2	chromosome	810495	809700	795	100.0	1.877e-173
UCT32H	contig_1	811115	810074	1041	renamed_GCF_000008685.2	chromosome	811510	810469	1041	100.0	2.778e-236
UCT32H	contig_1	811993	811111	882	renamed_GCF_000008685.2	chromosome	812388	811506	882	99.6	5.614e-193
UCT32H	contig_1	812844	812043	801	renamed_GCF_000008685.2	chromosome	813239	812438	801	100.0	9.279e-174
UCT32H	contig_1	813341	812996	345	renamed_GCF_000008685.2	chromosome	813706	813385	345	92.0	6.146e-61
UCT32H	contig_1	814332	813324	1008	renamed_GCF_000008685.2	chromosome	814697	813689	1008	99.4	2.823e-213
UCT32H	contig_1	820819	822004	1185	renamed_GCF_000008685.2	chromosome	821184	822369	1185	99.7	1.177e-261
UCT32H	contig_1	821978	822329	351	renamed_GCF_000008685.2	chromosome	822343	822694	351	99.1	1.534e-76
UCT32H	contig_1	822444	822738	294	renamed_GCF_000008685.2	chromosome	822809	823103	294	100.0	1.207e-61
UCT32H	contig_1	822897	823446	549	renamed_GCF_000008685.2	chromosome	823262	823811	549	98.3	4.154e-115
UCT32H	contig_1	823450	824017	567	renamed_GCF_000008685.2	chromosome	823815	824382	567	100.0	1.275e-122
UCT32H	contig_1	824016	825339	1323	renamed_GCF_000008685.2	chromosome	824381	825704	1323	100.0	8.966e-297
UCT32H	contig_1	825335	827255	1920	renamed_GCF_000008685.2	chromosome	825700	827620	1920	100.0	0.0
UCT32H	contig_1	827265	828747	1482	renamed_GCF_000008685.2	chromosome	827630	829112	1482	98.9	0.0
UCT32H	contig_1	828852	829956	1104	renamed_GCF_000008685.2	chromosome	829217	830321	1104	99.1	5.448e-248
UCT32H	contig_1	830576	829952	624	renamed_GCF_000008685.2	chromosome	830941	830317	624	98.5	1.394e-139
UCT32H	contig_1	869122	868339	783	renamed_GCF_000008685.2	chromosome	869380	868732	783	99.5	1.931e-145
UCT32H	contig_1	869630	869114	516	renamed_GCF_000008685.2	chromosome	870023	869507	516	100.0	1.621e-111
UCT32H	contig_1	872190	869718	2472	renamed_GCF_000008685.2	chromosome	872583	870111	2472	100.0	0.0
UCT32H	contig_1	874739	872192	2547	renamed_GCF_000008685.2	chromosome	875132	872585	2547	100.0	0.0
UCT32H	contig_1	874813	876055	1242	renamed_GCF_000008685.2	chromosome	875206	876448	1242	98.3	3.236e-277
UCT32H	contig_1	876035	878888	2853	renamed_GCF_000008685.2	chromosome	876491	879281	2853	99.3	0.0
UCT32H	contig_1	878921	879857	936	renamed_GCF_000008685.2	chromosome	879314	880250	936	99.6	1.601e-207
UCT32H	contig_1	880698	879873	825	renamed_GCF_000008685.2	chromosome	881091	880266	825	99.6	6.405e-182
UCT32H	contig_1	883820	880691	3129	renamed_GCF_000008685.2	chromosome	884213	881084	3129	99.7	0.0
UCT32H	contig_1	886054	883834	2220	renamed_GCF_000008685.2	chromosome	886447	884227	2220	98.5	0.0
UCT32H	contig_2	9450	10272	822	renamed_GCF_000008685.2	lp54	9456	10278	822	99.6	1.415e-172
UCT32H	contig_2	10281	11172	891	renamed_GCF_000008685.2	lp54	10287	11178	891	99.6	2.083e-188
UCT32H	contig_2	13044	13629	585	renamed_GCF_000008685.2	lp54	12994	13579	585	100.0	1.763e-130
UCT32H	contig_2	13604	14357	753	renamed_GCF_000008685.2	lp54	13554	14307	753	100.0	4.561e-165
UCT32H	contig_2	14387	14933	546	renamed_GCF_000008685.2	lp54	14337	14883	546	100.0	1.338e-118
UCT32H	contig_2	15419	15851	432	renamed_GCF_000008685.2	lp54	15369	15801	432	97.2	9.777e-95
UCT32H	contig_2	16648	16084	564	renamed_GCF_000008685.2	lp54	16576	16000	564	91.8	3.333e-103
UCT32H	contig_2	17331	16767	564	renamed_GCF_000008685.2	lp54	17259	16695	564	99.4	2.368e-115
UCT32H	contig_2	42305	42512	207	renamed_GCF_000008685.2	lp54	42266	42473	207	100.0	9.856e-42
UCT32H	contig_2	43571	42662	909	renamed_GCF_000008685.2	lp54	43532	42623	909	99.6	5.38e-198
UCT32H	contig_2	44584	43735	849	renamed_GCF_000008685.2	lp54	44533	43684	849	100.0	7.054e-185
UCT32H	contig_2	45998	44762	1236	renamed_GCF_000008685.2	lp54	45947	44711	1236	99.2	3.647e-266
UCT32H	contig_2	48335	47579	756	renamed_GCF_000008685.2	lp54	47228	46472	756	98.0	2.849e-162
UCT32H	contig_2	49376	48584	792	renamed_GCF_000008685.2	lp54	48267	47475	792	99.2	5.269e-170
UCT32H	contig_2	50235	50010	225	renamed_GCF_000008685.2	lp54	50077	49852	225	97.2	1.083e-43
UCT32H	contig_2	51334	50443	891	renamed_GCF_000008685.2	lp54	51176	50285	891	98.9	4.455e-197
UCT32H	contig_3	27334	28183	849	renamed_GCF_000008685.2	lp36	35443	34594	849	98.2	2.634e-187
UCT32H	contig_3	29125	29467	342	renamed_GCF_000008685.2	lp28-3	8017	8431	342	61.5	0.0002439
UCT32H	contig_3	31228	30934	294	renamed_GCF_000008685.2	lp28-1	10895	10697	294	98.4	2.041e-40
UCT32H	contig_3	32033	31859	174	renamed_GCF_000008685.2	lp36	22293	22467	174	92.9	1.178e-34
UCT32H	contig_3	32416	32194	222	renamed_GCF_000008685.2	lp36	21911	22133	222	100.0	1.866e-45
UCT32H	contig_3	33966	32874	1092	renamed_GCF_000008685.2	lp36	20388	21453	1092	96.9	5.792e-228
UCT32H	contig_3	35866	35254	612	renamed_GCF_000008685.2	lp36	16274	16886	612	100.0	9.153e-134
UCT32H	contig_3	36379	37306	927	renamed_GCF_000008685.2	lp36	15760	14833	927	99.6	1.39e-207
UCT32H	contig_3	37298	37838	540	renamed_GCF_000008685.2	lp36	14841	14301	540	100.0	2.234e-120
UCT32H	contig_3	37813	38563	750	renamed_GCF_000008685.2	lp36	14326	13576	750	100.0	1.062e-163
UCT32H	contig_5	5399	4286	1113	renamed_GCF_000008685.2	lp56	10170	11283	1113	96.4	1.311e-239
UCT32H	contig_5	6706	6322	384	renamed_GCF_000008685.2	cp32-7	5395	5779	384	100.0	2.931e-83
UCT32H	contig_5	7161	6705	456	renamed_GCF_000008685.2	cp32-8	4941	5397	456	97.3	1.304e-95
UCT32H	contig_5	9528	8763	765	renamed_GCF_000008685.2	cp32-7	2573	3338	765	100.0	3.139e-171
UCT32H	contig_6	14617	14953	336	renamed_GCF_000008685.2	cp32-4	15710	16046	336	100.0	5.348e-69
UCT32H	contig_6	15913	15436	477	renamed_GCF_000008685.2	cp32-6	17075	16592	477	73.1	1.666e-71
UCT32H	contig_6	16084	16525	441	renamed_GCF_000008685.2	cp32-6	17246	17696	441	83.4	5.327e-78
UCT32H	contig_6	20408	20969	561	renamed_GCF_000008685.2	cp9	1891	2452	561	63.4	1.387e-78
UCT32H	contig_6	27028	27568	540	renamed_GCF_000008685.2	cp32-8	28250	28790	540	100.0	1.472e-116
UCT32H	contig_6	28310	29663	1353	renamed_GCF_000008685.2	cp32-8	29532	30885	1353	99.1	3.386e-304
UCT32H	contig_7	9652	9094	558	renamed_GCF_000008685.2	cp32-7	2009	2567	558	100.0	1.105e-122
UCT32H	contig_7	11597	10373	1224	renamed_GCF_000008685.2	cp32-6	65	1289	1224	100.0	2.096e-270
UCT32H	contig_7	13578	13011	567	renamed_GCF_000008685.2	cp32-8	28969	29536	567	95.7	2.258e-116
UCT32H	contig_8	10025	9467	558	renamed_GCF_000008685.2	cp32-1	2010	2568	558	100.0	1.105e-122
UCT32H	contig_8	13785	13218	567	renamed_GCF_000008685.2	cp32-3	28235	28874	567	93.0	1.228e-114
UCT32H	contig_8	26710	26374	336	renamed_GCF_000008685.2	cp32-6	15774	16110	336	100.0	5.348e-69
UCT32H	contig_8	27047	26699	348	renamed_GCF_000008685.2	cp32-1	15421	15769	348	99.1	4.373e-73
UCT32H	contig_9	26233	27046	813	renamed_GCF_000008685.2	cp32-8	14323	15139	813	59.9	7.62e-100
UCT32H	contig_10	7007	6551	456	renamed_GCF_000008685.2	cp32-3	4941	5397	456	97.3	1.304e-95
UCT32H	contig_11	11915	11525	390	renamed_GCF_000008685.2	cp32-4	5777	6167	390	100.0	3.229e-83
UCT32H	contig_11	13720	12760	960	renamed_GCF_000008685.2	lp56	7432	8392	960	100.0	6.008e-214
UCT32H	contig_11	25750	25207	543	renamed_GCF_000008685.2	cp32-1	21560	22118	543	64.0	6.304e-76
UCT32H	contig_11	26531	25790	741	renamed_GCF_000008685.2	cp32-3	21256	21997	741	100.0	5.003e-162
UCT32H	contig_11	28183	27082	1101	renamed_GCF_000008685.2	cp32-1	19113	20214	1101	95.0	4.897e-240
UCT32H	contig_13	14693	14120	573	renamed_GCF_000008685.2	lp28-4	13264	13837	573	100.0	2.579e-124
UCT32H	contig_13	15504	14751	753	renamed_GCF_000008685.2	lp28-4	12453	13206	753	100.0	4.561e-165
UCT32H	contig_13	16034	15479	555	renamed_GCF_000008685.2	lp28-4	11923	12478	555	100.0	3.559e-126
UCT32H	contig_13	17137	16030	1107	renamed_GCF_000008685.2	lp28-4	10814	11927	1107	98.9	2.343e-249
UCT32H	contig_13	21175	19414	1761	renamed_GCF_000008685.2	lp28-4	7182	8538	1761	76.9	1.689e-274
UCT32H	contig_14	1797	1101	696	renamed_GCF_000008685.2	cp26	21897	22593	696	99.5	6.925e-151
UCT32H	contig_14	1870	2356	486	renamed_GCF_000008685.2	cp26	21833	21338	486	100.0	3.279e-107
UCT32H	contig_14	2330	2837	507	renamed_GCF_000008685.2	cp26	21364	20857	507	100.0	3.123e-111
UCT32H	contig_14	2908	4264	1356	renamed_GCF_000008685.2	cp26	20786	19430	1356	98.6	2.16e-292
UCT32H	contig_14	6809	6173	636	renamed_GCF_000008685.2	cp26	16902	17535	636	78.1	2.717e-100
UCT32H	contig_15	12621	13689	1068	renamed_GCF_000008685.2	lp28-1	15451	14350	1068	96.0	6.722e-231
UCT32H	contig_15	14280	15045	765	renamed_GCF_000008685.2	lp28-1	13793	13028	765	99.6	1.871e-168
UCT32H	contig_16	20200	19471	729	renamed_GCF_000008685.2	lp25	22677	21945	729	84.3	2.816e-132
UCT32H	contig_16	22685	22181	504	renamed_GCF_000008685.2	lp56	3622	4108	504	93.0	3.962e-83
UCT32H	contig_16	24673	23779	894	renamed_GCF_000008685.2	lp28-2	115	1009	894	99.3	3.345e-192
UCT32H	contig_18	9454	10567	1113	renamed_GCF_000008685.2	lp17	8266	9379	1113	93.7	5.062e-233
UCT32H	contig_18	12596	11933	663	renamed_GCF_000008685.2	lp17	11646	10983	663	100.0	1.005e-149
UCT32H	contig_19	9714	9159	555	renamed_GCF_000008685.2	cp32-6	11929	12484	555	98.3	1.698e-117
UCT32H	contig_19	10682	9731	951	renamed_GCF_000008685.2	cp32-6	10961	11912	951	99.0	1.16e-213
UCT32H	contig_19	11369	10685	684	renamed_GCF_000008685.2	lp56	13754	14438	684	95.5	5.476e-143
UCT32H	contig_1	39497	37994	1503	renamed_GCF_000008685.2	chromosome	39638	38135	1503	99.8	0.0
UCT32H	contig_1	70032	71079	1047	renamed_GCF_000008685.2	chromosome	70141	71219	1047	99.7	6.395e-228
UCT32H	contig_1	75632	76313	681	renamed_GCF_000008685.2	chromosome	75773	76454	681	100.0	3.584e-147
UCT32H	contig_1	78868	77569	1299	renamed_GCF_000008685.2	chromosome	79009	77710	1299	99.7	4.127e-284
UCT32H	contig_1	79211	78860	351	renamed_GCF_000008685.2	chromosome	79322	79001	351	99.0	3.732e-67
UCT32H	contig_1	103630	102874	756	renamed_GCF_000008685.2	chromosome	103771	103015	756	99.6	2.151e-165
UCT32H	contig_1	105705	105276	429	renamed_GCF_000008685.2	chromosome	105846	105417	429	98.5	1.668e-88
UCT32H	contig_1	108029	106832	1197	renamed_GCF_000008685.2	chromosome	108170	106973	1197	99.7	1.869e-258
UCT32H	contig_1	110901	109533	1368	renamed_GCF_000008685.2	chromosome	111042	109674	1368	100.0	1.976e-295
UCT32H	contig_1	111733	111442	291	renamed_GCF_000008685.2	chromosome	111875	111584	291	100.0	1.894e-64
UCT32H	contig_1	133699	132328	1371	renamed_GCF_000008685.2	chromosome	133842	132471	1371	100.0	2.422e-302
UCT32H	contig_1	137623	135730	1893	renamed_GCF_000008685.2	chromosome	137766	135873	1893	99.6	0.0
UCT32H	contig_1	144034	142798	1236	renamed_GCF_000008685.2	chromosome	144230	142943	1236	99.5	6.15e-269
UCT32H	contig_1	146225	145325	900	renamed_GCF_000008685.2	chromosome	146370	145470	900	100.0	6.779e-194
UCT32H	contig_1	158479	159196	717	renamed_GCF_000008685.2	chromosome	158627	159344	717	97.0	3.592e-153
UCT32H	contig_1	159941	161060	1119	renamed_GCF_000008685.2	chromosome	160089	161208	1119	99.7	1.16e-250
UCT32H	contig_1	164672	162923	1749	renamed_GCF_000008685.2	chromosome	164820	163071	1749	99.1	0.0
UCT32H	contig_1	167611	165766	1845	renamed_GCF_000008685.2	chromosome	167759	165914	1845	99.1	0.0
UCT32H	contig_1	226300	224515	1785	renamed_GCF_000008685.2	chromosome	226610	224825	1785	99.4	0.0
UCT32H	contig_1	228211	227503	708	renamed_GCF_000008685.2	chromosome	228521	227813	708	100.0	8.763e-159
UCT32H	contig_1	231181	229903	1278	renamed_GCF_000008685.2	chromosome	231491	230213	1278	99.7	4.58e-288
UCT32H	contig_1	232027	234943	2916	renamed_GCF_000008685.2	chromosome	232337	235253	2916	99.8	0.0
UCT32H	contig_1	245478	246243	765	renamed_GCF_000008685.2	chromosome	245789	246554	765	100.0	7.663e-170
UCT32H	contig_1	248215	249778	1563	renamed_GCF_000008685.2	chromosome	248505	250089	1563	99.8	0.0
UCT32H	contig_1	250900	250345	555	renamed_GCF_000008685.2	chromosome	251211	250656	555	99.4	1.543e-118
UCT32H	contig_1	251926	250900	1026	renamed_GCF_000008685.2	chromosome	252237	251211	1026	99.4	1.351e-224
UCT32H	contig_1	298473	297162	1311	renamed_GCF_000008685.2	chromosome	298776	297465	1311	99.5	1.7e-287
UCT32H	contig_1	309477	308235	1242	renamed_GCF_000008685.2	chromosome	309780	308538	1242	100.0	1.368e-269
UCT32H	contig_1	311350	310255	1095	renamed_GCF_000008685.2	chromosome	311617	310558	1095	99.4	1.229e-228
UCT32H	contig_1	314125	313843	282	renamed_GCF_000008685.2	chromosome	314427	314145	282	100.0	2.699e-59
UCT32H	contig_1	315841	315004	837	renamed_GCF_000008685.2	chromosome	316143	315306	837	99.6	1.426e-183
UCT32H	contig_1	317703	316944	759	renamed_GCF_000008685.2	chromosome	318005	317246	759	100.0	1.223e-163
UCT32H	contig_1	328961	329321	360	renamed_GCF_000008685.2	chromosome	329261	329621	360	100.0	1.609e-77
UCT32H	contig_1	333307	330502	2805	renamed_GCF_000008685.2	chromosome	333598	330802	2805	99.6	0.0
UCT32H	contig_1	334645	336217	1572	renamed_GCF_000008685.2	chromosome	334936	336508	1572	99.6	0.0
UCT32H	contig_1	338054	339680	1626	renamed_GCF_000008685.2	chromosome	338357	339983	1626	99.8	0.0
UCT32H	contig_1	340037	340958	921	renamed_GCF_000008685.2	chromosome	340340	341261	921	98.6	3.516e-196
UCT32H	contig_1	340970	342020	1050	renamed_GCF_000008685.2	chromosome	341273	342323	1050	100.0	1.489e-227
UCT32H	contig_1	353137	351037	2100	renamed_GCF_000008685.2	chromosome	353437	351340	2100	98.1	0.0
UCT32H	contig_1	354333	353136	1197	renamed_GCF_000008685.2	chromosome	354636	353439	1197	100.0	5.312e-264
UCT32H	contig_1	354995	354344	651	renamed_GCF_000008685.2	chromosome	355298	354647	651	100.0	1.769e-141
UCT32H	contig_1	355187	356606	1419	renamed_GCF_000008685.2	chromosome	355490	356909	1419	99.5	1.551e-315
UCT32H	contig_1	356703	358137	1434	renamed_GCF_000008685.2	chromosome	357006	358440	1434	99.7	4.764e-314
UCT32H	contig_1	358154	358895	741	renamed_GCF_000008685.2	chromosome	358457	359198	741	99.5	4.555e-163
UCT32H	contig_1	359192	358913	279	renamed_GCF_000008685.2	chromosome	359495	359216	279	98.9	6.331e-58
UCT32H	contig_1	360775	359209	1566	renamed_GCF_000008685.2	chromosome	361078	359512	1566	99.6	0.0
UCT32H	contig_1	360896	362018	1122	renamed_GCF_000008685.2	chromosome	361187	362321	1122	99.4	1.215e-250
UCT32H	contig_1	363814	362014	1800	renamed_GCF_000008685.2	chromosome	364117	362317	1800	99.8	0.0
UCT32H	contig_1	373849	373264	585	renamed_GCF_000008685.2	chromosome	374151	373566	585	99.4	4.742e-128
UCT32H	contig_1	373974	375351	1377	renamed_GCF_000008685.2	chromosome	374276	375653	1377	99.7	6.3e-310
UCT32H	contig_1	375358	375637	279	renamed_GCF_000008685.2	chromosome	375660	375939	279	100.0	3.143e-57
UCT32H	contig_1	376717	375658	1059	renamed_GCF_000008685.2	chromosome	377019	375960	1059	98.0	1.713e-227
UCT32H	contig_1	379028	376736	2292	renamed_GCF_000008685.2	chromosome	379258	377038	2292	98.2	0.0
UCT32H	contig_1	380256	379038	1218	renamed_GCF_000008685.2	chromosome	380558	379340	1218	99.2	2.093e-269
UCT32H	contig_1	381590	380252	1338	renamed_GCF_000008685.2	chromosome	381892	380554	1338	100.0	1.408e-311
UCT32H	contig_1	383080	381607	1473	renamed_GCF_000008685.2	chromosome	383382	381909	1473	100.0	0.0
UCT32H	contig_1	383860	383092	768	renamed_GCF_000008685.2	chromosome	384162	383394	768	99.6	9.689e-168
UCT32H	contig_1	383984	385124	1140	renamed_GCF_000008685.2	chromosome	384286	385426	1140	99.4	1.764e-249
UCT32H	contig_1	407792	407621	171	renamed_GCF_000008685.2	chromosome	408092	407921	171	100.0	1.118e-34
UCT32H	contig_1	408090	407910	180	renamed_GCF_000008685.2	chromosome	408380	408200	180	100.0	2.118e-37
UCT32H	contig_1	409112	408263	849	renamed_GCF_000008685.2	chromosome	409402	408553	849	99.6	2.186e-189
UCT32H	contig_1	410157	409125	1032	renamed_GCF_000008685.2	chromosome	410447	409415	1032	97.3	8.518e-231
UCT32H	contig_1	410496	411156	660	renamed_GCF_000008685.2	chromosome	410786	411446	660	98.1	2.462e-139
UCT32H	contig_1	412710	411165	1545	renamed_GCF_000008685.2	chromosome	413006	411455	1545	99.2	0.0
UCT32H	contig_1	412822	414025	1203	renamed_GCF_000008685.2	chromosome	413112	414315	1203	99.2	7.009e-262
UCT32H	contig_1	446588	446039	549	renamed_GCF_000008685.2	chromosome	446875	446326	549	98.9	2.344e-121
UCT32H	contig_1	447399	446682	717	renamed_GCF_000008685.2	chromosome	447736	446968	717	99.1	3.946e-152
UCT32H	contig_1	447568	447886	318	renamed_GCF_000008685.2	chromosome	447854	448172	318	98.0	4.406e-68
UCT32H	contig_1	459629	459785	156	renamed_GCF_000008685.2	chromosome	459915	460071	156	100.0	2.965e-30
UCT32H	contig_1	459765	460125	360	renamed_GCF_000008685.2	chromosome	460051	460411	360	99.1	5.311e-73
UCT32H	contig_1	461758	462487	729	renamed_GCF_000008685.2	chromosome	462044	462773	729	98.7	1.34e-157
UCT32H	contig_1	462532	463600	1068	renamed_GCF_000008685.2	chromosome	462818	463886	1068	99.7	9.979e-244
UCT32H	contig_1	463766	464846	1080	renamed_GCF_000008685.2	chromosome	464052	465132	1080	99.7	2.027e-246
UCT32H	contig_1	466991	465230	1761	renamed_GCF_000008685.2	chromosome	467278	465517	1761	99.4	0.0
UCT32H	contig_1	487244	487934	690	renamed_GCF_000008685.2	chromosome	487534	488224	690	99.5	4.749e-154
UCT32H	contig_1	487935	488682	747	renamed_GCF_000008685.2	chromosome	488225	488972	747	100.0	3.778e-166
UCT32H	contig_1	488692	489205	513	renamed_GCF_000008685.2	chromosome	488982	489495	513	100.0	1.545e-111
UCT32H	contig_1	497922	498756	834	renamed_GCF_000008685.2	chromosome	498212	499046	834	100.0	1.895e-188
UCT32H	contig_1	498765	499044	279	renamed_GCF_000008685.2	chromosome	499055	499334	279	100.0	1.411e-57
UCT32H	contig_1	499050	499413	363	renamed_GCF_000008685.2	chromosome	499340	499703	363	100.0	3.407e-78
UCT32H	contig_1	499416	500298	882	renamed_GCF_000008685.2	chromosome	499706	500588	882	100.0	1.248e-192
UCT32H	contig_1	500302	500719	417	renamed_GCF_000008685.2	chromosome	500592	501009	417	100.0	2.778e-89
UCT32H	contig_1	500721	500922	201	renamed_GCF_000008685.2	chromosome	501014	501212	201	98.4	1.098e-39
UCT32H	contig_1	500924	501179	255	renamed_GCF_000008685.2	chromosome	501214	501469	255	100.0	1.745e-51
UCT32H	contig_1	630450	631668	1218	renamed_GCF_000008685.2	chromosome	630795	631986	1218	99.4	4.366e-261
UCT32H	contig_1	634262	635693	1431	renamed_GCF_000008685.2	chromosome	634580	636011	1431	95.3	9.45e-306
UCT32H	contig_1	637643	638237	594	renamed_GCF_000008685.2	chromosome	637971	638556	594	99.4	7.271e-125
UCT32H	contig_1	639521	641930	2409	renamed_GCF_000008685.2	chromosome	639858	642249	2409	99.4	0.0
UCT32H	contig_1	642807	642180	627	renamed_GCF_000008685.2	chromosome	643126	642499	627	100.0	8.735e-137
UCT32H	contig_1	658578	659304	726	renamed_GCF_000008685.2	chromosome	658897	659623	726	100.0	3.429e-155
UCT32H	contig_1	661196	659324	1872	renamed_GCF_000008685.2	chromosome	661515	659643	1872	99.1	0.0
UCT32H	contig_1	662598	662283	315	renamed_GCF_000008685.2	chromosome	662917	662602	315	99.0	2.806e-64
UCT32H	contig_1	672892	671446	1446	renamed_GCF_000008685.2	chromosome	673167	671766	1446	99.1	2.204e-307
UCT32H	contig_1	697105	696418	687	renamed_GCF_000008685.2	chromosome	697437	696750	687	100.0	2.97e-150
UCT32H	contig_1	699633	698067	1566	renamed_GCF_000008685.2	chromosome	699965	698399	1566	99.6	0.0
UCT32H	contig_1	700696	701053	357	renamed_GCF_000008685.2	chromosome	701028	701385	357	99.1	2.301e-81
UCT32H	contig_1	701492	701942	450	renamed_GCF_000008685.2	chromosome	701824	702274	450	99.3	2.172e-97
UCT32H	contig_1	703598	704627	1029	renamed_GCF_000008685.2	chromosome	703960	704959	1029	98.7	4.152e-221
UCT32H	contig_1	704616	705168	552	renamed_GCF_000008685.2	chromosome	704948	705500	552	96.1	1.619e-117
UCT32H	contig_1	717408	718335	927	renamed_GCF_000008685.2	chromosome	717742	718669	927	100.0	3.519e-197
UCT32H	contig_1	720781	722683	1902	renamed_GCF_000008685.2	chromosome	721118	723020	1902	99.8	0.0
UCT32H	contig_1	723886	725110	1224	renamed_GCF_000008685.2	chromosome	724223	725447	1224	100.0	3.222e-274
UCT32H	contig_1	726147	727416	1269	renamed_GCF_000008685.2	chromosome	726457	727753	1269	99.7	1.845e-279
UCT32H	contig_1	769133	767741	1392	renamed_GCF_000008685.2	chromosome	769470	768078	1392	100.0	1.696e-292
UCT32H	contig_1	770801	769208	1593	renamed_GCF_000008685.2	chromosome	771139	769546	1593	99.0	0.0
UCT32H	contig_1	838181	838715	534	renamed_GCF_000008685.2	chromosome	838546	839080	534	100.0	7.282e-115
UCT32H	contig_1	841468	842086	618	renamed_GCF_000008685.2	chromosome	841833	842451	618	100.0	1.393e-138
UCT32H	contig_1	842637	844086	1449	renamed_GCF_000008685.2	chromosome	843002	844451	1449	99.5	1.877e-318
UCT32H	contig_1	846730	847093	363	renamed_GCF_000008685.2	chromosome	847125	847488	363	99.1	5.052e-74
UCT32H	contig_1	862305	863253	948	renamed_GCF_000008685.2	chromosome	862698	863646	948	100.0	4.292e-207
UCT32H	contig_1	864659	865526	867	renamed_GCF_000008685.2	chromosome	865052	865919	867	99.6	3.181e-188
UCT32H	contig_2	5307	5643	336	renamed_GCF_000008685.2	lp54	5313	5649	336	100.0	1.784e-72
UCT32H	contig_2	6514	7141	627	renamed_GCF_000008685.2	lp54	6520	7147	627	99.0	1.16e-133
UCT32H	contig_2	7202	8237	1035	renamed_GCF_000008685.2	lp54	7208	8243	1035	100.0	8.138e-232
UCT32H	contig_2	8435	8861	426	renamed_GCF_000008685.2	lp54	8441	8867	426	100.0	3.21e-89
UCT32H	contig_2	18199	18793	594	renamed_GCF_000008685.2	lp54	18127	18721	594	99.4	7.271e-125
UCT32H	contig_2	18796	20149	1353	renamed_GCF_000008685.2	lp54	18724	20077	1353	99.7	3.386e-304
UCT32H	contig_2	21113	21653	540	renamed_GCF_000008685.2	lp54	21086	21626	540	97.7	2.373e-111
UCT32H	contig_2	23803	24442	639	renamed_GCF_000008685.2	lp54	23776	24415	639	98.1	1.541e-132
UCT32H	contig_2	24524	25130	606	renamed_GCF_000008685.2	lp54	24497	25103	606	99.0	1.616e-126
UCT32H	contig_3	21697	21973	276	renamed_GCF_000008685.2	lp28-3	22677	22953	276	100.0	6.026e-58
UCT32H	contig_3	25318	24451	867	renamed_GCF_000008685.2	lp28-3	26371	25432	867	99.6	1.571e-187
UCT32H	contig_3	26786	27338	552	renamed_GCF_000008685.2	lp56	855	1407	552	96.7	3.6e-117
UCT32H	contig_3	39538	38902	636	renamed_GCF_000008685.2	lp36	12601	13237	636	99.5	7.582e-140
UCT32H	contig_3	42768	42363	405	renamed_GCF_000008685.2	lp36	9372	9999	405	99.1	1.226e-79
UCT32H	contig_3	46103	46856	753	renamed_GCF_000008685.2	lp36	6040	5287	753	99.6	3.6e-159
UCT32H	contig_5	1808	1166	642	renamed_GCF_000008685.2	cp32-7	10316	10958	642	96.2	1.337e-134
UCT32H	contig_6	10780	11326	546	renamed_GCF_000008685.2	cp32-8	11919	12465	546	95.5	5.802e-111
UCT32H	contig_6	14073	14277	204	renamed_GCF_000008685.2	cp32-4	15166	15370	204	100.0	2.578e-39
UCT32H	contig_8	4208	3779	429	renamed_GCF_000008685.2	lp56	11296	11725	429	100.0	5.601e-92
UCT32H	contig_8	6268	5878	390	renamed_GCF_000008685.2	cp32-1	5767	6157	390	100.0	3.229e-83
UCT32H	contig_8	16056	15432	624	renamed_GCF_000008685.2	cp32-3	26707	27298	624	54.2	6.274e-63
UCT32H	contig_8	19072	17746	1326	renamed_GCF_000008685.2	cp32-6	23240	24566	1326	98.1	1.904e-297
UCT32H	contig_8	20796	20217	579	renamed_GCF_000008685.2	cp32-6	21519	22098	579	100.0	5.735e-125
UCT32H	contig_8	22137	21570	567	renamed_GCF_000008685.2	lp56	23975	24542	567	98.9	1.602e-128
UCT32H	contig_10	11891	10667	1224	renamed_GCF_000008685.2	cp32-1	65	1289	1224	100.0	2.096e-270
UCT32H	contig_10	15940	15238	702	renamed_GCF_000008685.2	cp32-7	26151	26841	702	81.59	3.385e-117
UCT32H	contig_10	17579	17153	426	renamed_GCF_000008685.2	cp32-7	24512	24938	426	100.0	8.056e-96
UCT32H	contig_11	16384	15691	693	renamed_GCF_000008685.2	cp32-6	1305	1998	693	99.1	5.741e-144
UCT32H	contig_11	19042	17689	1353	renamed_GCF_000008685.2	cp32-6	28485	29838	1353	99.7	1.39e-305
UCT32H	contig_11	20314	19786	528	renamed_GCF_000008685.2	cp32-4	27675	28203	528	89.7	7.744e-105
UCT32H	contig_11	22788	22362	426	renamed_GCF_000008685.2	cp32-3	25068	25494	426	98.5	3.989e-95
UCT32H	contig_12	7898	7091	807	renamed_GCF_000008685.2	lp56	2743	3496	807	56.1	5.821e-84
UCT32H	contig_12	25565	26159	594	renamed_GCF_000008685.2	lp38	11105	10517	594	89.3	1.877e-114
UCT32H	contig_14	14438	13676	762	renamed_GCF_000008685.2	cp26	9274	10036	762	98.8	5.77e-164
UCT32H	contig_14	15877	14947	930	renamed_GCF_000008685.2	cp26	7835	8765	930	97.7	1.145e-201
UCT32H	contig_14	18944	17846	1098	renamed_GCF_000008685.2	cp26	4768	5866	1098	100.0	2.035e-249
UCT32H	contig_14	19629	19281	348	renamed_GCF_000008685.2	cp26	4083	4431	348	99.1	5.329e-71
UCT32H	contig_19	1283	716	567	renamed_GCF_000008685.2	cp32-9	20274	20841	567	98.4	1.762e-127
UCT32H	contig_19	2394	1293	1101	renamed_GCF_000008685.2	cp32-9	19163	20264	1101	98.3	2.566e-247
UCT32H	contig_19	5541	5187	354	renamed_GCF_000008685.2	lp56	19584	19938	354	100.0	1.459e-77
UCT32H	contig_19	6413	6209	204	renamed_GCF_000008685.2	cp32-6	15230	15434	204	100.0	2.578e-39
UCT32H	contig_19	16466	15908	558	renamed_GCF_000008685.2	cp32-9	26209	26770	558	85.0	3.671e-101
UCT32H	contig_19	21116	20555	561	renamed_GCF_000008685.2	cp32-9	21613	22174	561	100.0	6.308e-121
UCT32H	contig_20	219	969	750	renamed_GCF_000008685.2	cp32-7	20765	21515	750	100.0	2.593e-162
UCT32H	contig_1	12756	14739	1983	renamed_GCF_000008685.2	chromosome	12745	14728	1983	99.8	0.0
UCT32H	contig_1	15733	15355	378	renamed_GCF_000008685.2	chromosome	15716	15344	378	99.1	3.937e-79
UCT32H	contig_1	21954	20910	1044	renamed_GCF_000008685.2	chromosome	22101	21057	1044	100.0	6.693e-227
UCT32H	contig_1	22671	23811	1140	renamed_GCF_000008685.2	chromosome	22818	23958	1140	97.0	1.113e-254
UCT32H	contig_1	25605	26244	639	renamed_GCF_000008685.2	chromosome	25752	26391	639	99.5	1.211e-143
UCT32H	contig_1	28343	27707	636	renamed_GCF_000008685.2	chromosome	28490	27854	636	100.0	8.334e-139
UCT32H	contig_1	42342	41301	1041	renamed_GCF_000008685.2	chromosome	42483	41442	1041	99.4	2.178e-230
UCT32H	contig_1	45213	42765	2448	renamed_GCF_000008685.2	chromosome	45354	42906	2448	99.7	0.0
UCT32H	contig_1	63003	63885	882	renamed_GCF_000008685.2	chromosome	63146	64028	882	99.6	6.762e-191
UCT32H	contig_1	69425	69986	561	renamed_GCF_000008685.2	chromosome	69565	70126	561	100.0	3.775e-118
UCT32H	contig_1	81263	82799	1536	renamed_GCF_000008685.2	chromosome	81404	82940	1536	100.0	0.0
UCT32H	contig_1	85579	83899	1680	renamed_GCF_000008685.2	chromosome	85720	84040	1680	100.0	0.0
UCT32H	contig_1	87219	86784	435	renamed_GCF_000008685.2	chromosome	87360	86925	435	100.0	2.772e-92
UCT32H	contig_1	90974	89669	1305	renamed_GCF_000008685.2	chromosome	91115	89810	1305	100.0	2.863e-289
UCT32H	contig_1	93283	92737	546	renamed_GCF_000008685.2	chromosome	93423	92877	546	97.7	1.472e-117
UCT32H	contig_1	94465	94078	387	renamed_GCF_000008685.2	chromosome	94605	94218	387	100.0	1.031e-86
UCT32H	contig_1	97726	96802	924	renamed_GCF_000008685.2	chromosome	97866	96942	924	99.3	8.657e-204
UCT32H	contig_1	126158	125390	768	renamed_GCF_000008685.2	chromosome	126301	125533	768	99.2	8.033e-170
UCT32H	contig_1	127270	126172	1098	renamed_GCF_000008685.2	chromosome	127413	126315	1098	100.0	1.369e-236
UCT32H	contig_1	131154	132282	1128	renamed_GCF_000008685.2	chromosome	131297	132425	1128	99.4	1.93e-246
UCT32H	contig_1	147350	146231	1119	renamed_GCF_000008685.2	chromosome	147495	146376	1119	100.0	3.727e-246
UCT32H	contig_1	152056	152863	807	renamed_GCF_000008685.2	chromosome	152205	153012	807	100.0	9.769e-183
UCT32H	contig_1	156313	157450	1137	renamed_GCF_000008685.2	chromosome	156461	157598	1137	100.0	1.164e-253
UCT32H	contig_1	157909	158326	417	renamed_GCF_000008685.2	chromosome	158075	158474	417	100.0	2.72e-81
UCT32H	contig_1	171102	171336	234	renamed_GCF_000008685.2	chromosome	171262	171484	234	97.2	1.134e-44
UCT32H	contig_1	173968	173380	588	renamed_GCF_000008685.2	chromosome	174116	173528	588	99.4	1.682e-131
UCT32H	contig_1	219324	218745	579	renamed_GCF_000008685.2	chromosome	219634	219055	579	100.0	8.388e-121
UCT32H	contig_1	221323	222868	1545	renamed_GCF_000008685.2	chromosome	221741	223178	1545	98.3	8.416e-309
UCT32H	contig_1	235224	234978	246	renamed_GCF_000008685.2	chromosome	235534	235288	246	98.7	3.025e-52
UCT32H	contig_1	236832	235284	1548	renamed_GCF_000008685.2	chromosome	237142	235594	1548	99.8	0.0
UCT32H	contig_1	237646	237319	327	renamed_GCF_000008685.2	chromosome	237956	237629	327	99.0	4.183e-70
UCT32H	contig_1	239940	238833	1107	renamed_GCF_000008685.2	chromosome	240250	239143	1107	99.7	3.718e-244
UCT32H	contig_1	241979	239972	2007	renamed_GCF_000008685.2	chromosome	242289	240282	2007	99.4	0.0
UCT32H	contig_1	244403	243632	771	renamed_GCF_000008685.2	chromosome	244713	243942	771	100.0	4.161e-169
UCT32H	contig_1	256151	258674	2523	renamed_GCF_000008685.2	chromosome	256462	258985	2523	98.9	0.0
UCT32H	contig_1	263676	265803	2127	renamed_GCF_000008685.2	chromosome	263987	266114	2127	99.4	0.0
UCT32H	contig_1	306315	305367	948	renamed_GCF_000008685.2	chromosome	306615	305670	948	99.6	1.604e-209
UCT32H	contig_1	308214	307014	1200	renamed_GCF_000008685.2	chromosome	308517	307317	1200	100.0	3.302e-261
UCT32H	contig_1	319334	318803	531	renamed_GCF_000008685.2	chromosome	319636	319105	531	100.0	1.699e-113
UCT32H	contig_1	320006	321050	1044	renamed_GCF_000008685.2	chromosome	320308	321352	1044	99.4	3.304e-226
UCT32H	contig_1	322544	321737	807	renamed_GCF_000008685.2	chromosome	322846	322039	807	99.6	2.064e-174
UCT32H	contig_1	324934	323473	1461	renamed_GCF_000008685.2	chromosome	325236	323775	1461	99.7	0.0
UCT32H	contig_1	342031	342904	873	renamed_GCF_000008685.2	chromosome	342334	343207	873	99.6	7.766e-188
UCT32H	contig_1	344759	346061	1302	renamed_GCF_000008685.2	chromosome	345062	346364	1302	99.3	3.283e-287
UCT32H	contig_1	346538	346127	411	renamed_GCF_000008685.2	chromosome	346841	346430	411	100.0	6.821e-87
UCT32H	contig_1	368153	368579	426	renamed_GCF_000008685.2	chromosome	368455	368881	426	98.5	9.562e-86
UCT32H	contig_1	368582	369725	1143	renamed_GCF_000008685.2	chromosome	368884	370027	1143	99.4	7.822e-242
UCT32H	contig_1	369724	370711	987	renamed_GCF_000008685.2	chromosome	370026	371013	987	99.6	8.057e-224
UCT32H	contig_1	370731	372744	2013	renamed_GCF_000008685.2	chromosome	371033	373046	2013	99.7	0.0
UCT32H	contig_1	372837	373218	381	renamed_GCF_000008685.2	chromosome	373139	373520	381	100.0	1.683e-80
UCT32H	contig_1	385146	385860	714	renamed_GCF_000008685.2	chromosome	385448	386162	714	100.0	3.427e-153
UCT32H	contig_1	385856	387035	1179	renamed_GCF_000008685.2	chromosome	386158	387337	1179	99.7	9.776e-263
UCT32H	contig_1	387031	387505	474	renamed_GCF_000008685.2	chromosome	387333	387807	474	100.0	1.339e-106
UCT32H	contig_1	388178	387515	663	renamed_GCF_000008685.2	chromosome	388480	387817	663	99.5	1.104e-148
UCT32H	contig_1	388624	388204	420	renamed_GCF_000008685.2	chromosome	388926	388506	420	100.0	9.787e-93
UCT32H	contig_1	405317	404942	375	renamed_GCF_000008685.2	chromosome	405617	405242	375	99.1	2.753e-74
UCT32H	contig_1	405876	405387	489	renamed_GCF_000008685.2	chromosome	406176	405687	489	99.3	6.125e-101
UCT32H	contig_1	406561	405880	681	renamed_GCF_000008685.2	chromosome	406861	406180	681	100.0	2.702e-150
UCT32H	contig_1	406992	406560	432	renamed_GCF_000008685.2	chromosome	407292	406860	432	99.3	1.75e-88
UCT32H	contig_1	407598	407043	555	renamed_GCF_000008685.2	chromosome	407898	407343	555	99.4	1.275e-120
UCT32H	contig_1	416811	417423	612	renamed_GCF_000008685.2	chromosome	417101	417713	612	100.0	4.975e-132
UCT32H	contig_1	417433	418045	612	renamed_GCF_000008685.2	chromosome	417723	418335	612	98.5	3.744e-135
UCT32H	contig_1	419216	418097	1119	renamed_GCF_000008685.2	chromosome	419506	418387	1119	99.4	1.781e-254
UCT32H	contig_1	421090	419212	1878	renamed_GCF_000008685.2	chromosome	421380	419502	1878	99.5	0.0
UCT32H	contig_1	421263	421893	630	renamed_GCF_000008685.2	chromosome	421553	422183	630	98.5	1.533e-139
UCT32H	contig_1	454186	451753	2433	renamed_GCF_000008685.2	chromosome	454472	452039	2433	100.0	0.0
UCT32H	contig_1	456102	454197	1905	renamed_GCF_000008685.2	chromosome	456388	454483	1905	99.8	0.0
UCT32H	contig_1	456289	457750	1461	renamed_GCF_000008685.2	chromosome	456575	458036	1461	99.5	0.0
UCT32H	contig_1	457990	459148	1158	renamed_GCF_000008685.2	chromosome	458276	459434	1158	99.7	1.225e-256
UCT32H	contig_1	459238	459538	300	renamed_GCF_000008685.2	chromosome	459524	459824	300	95.9	4.432e-57
UCT32H	contig_1	470933	469673	1260	renamed_GCF_000008685.2	chromosome	471220	469960	1260	100.0	2.539e-274
UCT32H	contig_1	471469	470935	534	renamed_GCF_000008685.2	chromosome	471756	471222	534	100.0	8.816e-113
UCT32H	contig_1	472188	471483	705	renamed_GCF_000008685.2	chromosome	472358	471770	705	99.4	1.099e-121
UCT32H	contig_1	472278	473121	843	renamed_GCF_000008685.2	chromosome	472565	473408	843	100.0	5.328e-187
UCT32H	contig_1	474269	473117	1152	renamed_GCF_000008685.2	chromosome	474556	473404	1152	100.0	7.714e-261
UCT32H	contig_1	474325	475315	990	renamed_GCF_000008685.2	chromosome	474612	475602	990	99.6	3.939e-215
UCT32H	contig_1	475318	475924	606	renamed_GCF_000008685.2	chromosome	475605	476211	606	100.0	1.006e-131
UCT32H	contig_1	477787	475975	1812	renamed_GCF_000008685.2	chromosome	478005	476262	1812	99.4	0.0
UCT32H	contig_1	479418	480729	1311	renamed_GCF_000008685.2	chromosome	479708	481019	1311	99.7	3.671e-296
UCT32H	contig_1	489201	489429	228	renamed_GCF_000008685.2	chromosome	489539	489719	228	100.0	1.455e-33
UCT32H	contig_1	489442	490264	822	renamed_GCF_000008685.2	chromosome	489732	490554	822	98.9	1.491e-180
UCT32H	contig_1	490353	491637	1284	renamed_GCF_000008685.2	chromosome	490643	491927	1284	100.0	9.564e-281
UCT32H	contig_1	492297	493662	1365	renamed_GCF_000008685.2	chromosome	492587	493952	1365	100.0	1.721e-296
UCT32H	contig_1	494252	493859	393	renamed_GCF_000008685.2	chromosome	494539	494149	393	100.0	4.545e-80
UCT32H	contig_1	504508	504814	306	renamed_GCF_000008685.2	chromosome	504798	505104	306	99.0	3.271e-61
UCT32H	contig_1	504813	505251	438	renamed_GCF_000008685.2	chromosome	505103	505541	438	100.0	1.186e-93
UCT32H	contig_1	505263	506568	1305	renamed_GCF_000008685.2	chromosome	505553	506858	1305	100.0	4.133e-285
UCT32H	contig_1	506580	506694	114	renamed_GCF_000008685.2	chromosome	506864	506984	114	100.0	7.638e-22
UCT32H	contig_1	506711	507089	378	renamed_GCF_000008685.2	chromosome	507001	507379	378	100.0	8.763e-79
UCT32H	contig_1	516195	522696	6501	renamed_GCF_000008685.2	chromosome	516492	522993	6501	99.3	0.0
UCT32H	contig_1	524256	525957	1701	renamed_GCF_000008685.2	chromosome	524553	526254	1701	99.1	0.0
UCT32H	contig_1	541965	542727	762	renamed_GCF_000008685.2	chromosome	542262	543024	762	99.2	1.347e-171
UCT32H	contig_1	542751	543519	768	renamed_GCF_000008685.2	chromosome	543048	543816	768	99.6	4.167e-177
UCT32H	contig_1	543534	544308	774	renamed_GCF_000008685.2	chromosome	543831	544605	774	99.6	1.962e-169
UCT32H	contig_7	30393	29847	546	renamed_GCF_000008685.2	cp32-3	11919	12465	546	95.5	5.802e-111
UCT32H	contig_11	1102	784	318	renamed_GCF_000008685.2	cp32-3	16585	16903	318	100.0	2.414e-66
UCT32H	contig_11	1932	1596	336	renamed_GCF_000008685.2	cp32-3	15755	16091	336	100.0	5.348e-69
UCT32H	contig_11	12286	11902	384	renamed_GCF_000008685.2	cp32-4	5406	5790	384	100.0	2.931e-83
UCT32H	contig_14	4373	5729	1356	renamed_GCF_000008685.2	cp26	19321	17965	1356	99.5	4.378e-293
UCT32H	contig_14	8603	9818	1215	renamed_GCF_000008685.2	cp26	15107	13892	1215	97.7	4.167e-261
UCT32H	contig_14	21524	22874	1350	renamed_GCF_000008685.2	cp26	2186	836	1350	98.8	9.453e-301
UCT32H	contig_14	23665	23386	279	renamed_GCF_000008685.2	cp26	45	324	279	98.9	5.175e-60
UCT32H	contig_14	26153	25709	444	renamed_GCF_000008685.2	cp26	23254	24499	444	96.5	6.466e-93
UCT32H	contig_15	2735	4721	1986	renamed_GCF_000008685.2	lp28-1	26996	28073	1986	50.5	2.968e-45
UCT32H	contig_15	13744	14305	561	renamed_GCF_000008685.2	lp28-1	14329	13768	561	98.9	4.739e-124
UCT32H	contig_15	15081	15633	552	renamed_GCF_000008685.2	lp28-1	12992	12440	552	97.8	3.273e-118
UCT32H	contig_17	10983	10473	510	renamed_GCF_000008685.2	lp28-2	14885	14375	510	97.6	2.379e-106
UCT32H	contig_17	13782	12591	1191	renamed_GCF_000008685.2	lp28-2	17684	16493	1191	99.7	6.781e-269
UCT32H	contig_17	14925	14127	798	renamed_GCF_000008685.2	lp28-2	18827	18029	798	93.2	2.604e-170
UCT32H	contig_17	18399	15717	2682	renamed_GCF_000008685.2	lp28-2	22259	19619	2682	97.5	0.0
UCT32H	contig_17	19171	18799	372	renamed_GCF_000008685.2	lp28-2	23033	22658	372	80.4	3.483e-63
UCT32H	contig_17	20269	19855	414	renamed_GCF_000008685.2	lp28-2	24108	23721	414	55.6	1.931e-43
UCT32H	contig_18	7641	7062	579	renamed_GCF_000008685.2	lp17	6452	5873	579	99.4	1.16e-125
UCT32H	contig_18	8972	9299	327	renamed_GCF_000008685.2	lp17	7784	8111	327	99.0	2.291e-68
UCT32H	contig_18	11077	10783	294	renamed_GCF_000008685.2	lp17	9980	9590	294	95.8	5.989e-61
UCT32H	contig_18	14376	15117	741	renamed_GCF_000008685.2	lp17	13338	14079	741	100.0	7.64e-166
UCT32H	contig_27	651	225	426	renamed_GCF_000008685.2	lp56	52608	52134	426	97.7	4.735e-85
UCT32H	contig_1	29395	30877	1482	renamed_GCF_000008685.2	chromosome	29542	31015	1482	98.1	0.0
UCT32H	contig_1	39684	40536	852	renamed_GCF_000008685.2	chromosome	39825	40677	852	99.6	5.092e-189
UCT32H	contig_1	71060	72470	1410	renamed_GCF_000008685.2	chromosome	71200	72610	1410	99.5	1.263e-307
UCT32H	contig_1	72506	73352	846	renamed_GCF_000008685.2	chromosome	72646	73492	846	99.2	6.38e-177
UCT32H	contig_1	76309	77560	1251	renamed_GCF_000008685.2	chromosome	76450	77701	1251	99.7	8.508e-268
UCT32H	contig_1	79363	80632	1269	renamed_GCF_000008685.2	chromosome	79504	80773	1269	100.0	1.4e-282
UCT32H	contig_1	105290	103622	1668	renamed_GCF_000008685.2	chromosome	105299	103763	1668	99.8	0.0
UCT32H	contig_1	162653	161051	1602	renamed_GCF_000008685.2	chromosome	162801	161199	1602	99.8	0.0
UCT32H	contig_1	162729	162897	168	renamed_GCF_000008685.2	chromosome	162877	163045	168	100.0	5.294e-34
UCT32H	contig_1	165739	164752	987	renamed_GCF_000008685.2	chromosome	165887	164900	987	99.6	2.948e-209
UCT32H	contig_1	169390	170560	1170	renamed_GCF_000008685.2	chromosome	169562	170708	1170	99.7	6.062e-258
UCT32H	contig_1	181257	179391	1866	renamed_GCF_000008685.2	chromosome	181405	179539	1866	99.6	0.0
UCT32H	contig_1	182737	183232	495	renamed_GCF_000008685.2	chromosome	182885	183380	495	100.0	9.271e-106
UCT32H	contig_1	186405	186798	393	renamed_GCF_000008685.2	chromosome	186553	186946	393	100.0	5.626e-86
UCT32H	contig_1	187683	187029	654	renamed_GCF_000008685.2	chromosome	187831	187177	654	100.0	1.397e-144
UCT32H	contig_1	188346	188085	261	renamed_GCF_000008685.2	chromosome	188494	188233	261	98.8	1.572e-53
UCT32H	contig_1	200902	199816	1086	renamed_GCF_000008685.2	chromosome	201050	199964	1086	99.4	6.528e-243
UCT32H	contig_1	246285	247791	1506	renamed_GCF_000008685.2	chromosome	246596	248102	1506	100.0	0.0
UCT32H	contig_1	250359	249864	495	renamed_GCF_000008685.2	chromosome	250670	250175	495	100.0	5.051e-104
UCT32H	contig_1	252122	252728	606	renamed_GCF_000008685.2	chromosome	252433	253039	606	100.0	4.115e-133
UCT32H	contig_1	254633	255338	705	renamed_GCF_000008685.2	chromosome	254944	255649	705	100.0	7.263e-152
UCT32H	contig_1	273345	272322	1023	renamed_GCF_000008685.2	chromosome	273647	272633	1023	98.5	8.403e-221
UCT32H	contig_1	276194	274940	1254	renamed_GCF_000008685.2	chromosome	276496	275242	1254	99.5	5.471e-282
UCT32H	contig_1	278756	278234	522	renamed_GCF_000008685.2	chromosome	279058	278536	522	100.0	3.966e-111
UCT32H	contig_1	281009	279104	1905	renamed_GCF_000008685.2	chromosome	281311	279406	1905	100.0	0.0
UCT32H	contig_1	282385	281497	888	renamed_GCF_000008685.2	chromosome	282687	281799	888	99.6	8.945e-189
UCT32H	contig_1	292906	292123	783	renamed_GCF_000008685.2	chromosome	293208	292425	783	99.6	6.057e-167
UCT32H	contig_1	330452	329342	1110	renamed_GCF_000008685.2	chromosome	330752	329642	1110	100.0	1.105e-249
UCT32H	contig_1	334224	333327	897	renamed_GCF_000008685.2	chromosome	334515	333618	897	100.0	1.666e-200
UCT32H	contig_1	514233	515493	1260	renamed_GCF_000008685.2	chromosome	514523	515783	1260	98.3	1.758e-278
UCT32H	contig_1	544288	547090	2802	renamed_GCF_000008685.2	chromosome	544585	547387	2802	98.8	0.0
UCT32H	contig_1	548193	547548	645	renamed_GCF_000008685.2	chromosome	548490	547845	645	100.0	1.056e-137
UCT32H	contig_1	548588	548189	399	renamed_GCF_000008685.2	chromosome	548885	548486	399	99.2	3.385e-84
UCT32H	contig_1	549321	548622	699	renamed_GCF_000008685.2	chromosome	549618	548919	699	100.0	1.058e-146
UCT32H	contig_1	551426	549344	2082	renamed_GCF_000008685.2	chromosome	551723	549641	2082	100.0	0.0
UCT32H	contig_1	575504	574961	543	renamed_GCF_000008685.2	chromosome	575816	575273	543	100.0	3.121e-117
UCT32H	contig_1	576214	575668	546	renamed_GCF_000008685.2	chromosome	576499	575980	546	100.0	1.781e-115
UCT32H	contig_1	576875	576269	606	renamed_GCF_000008685.2	chromosome	577187	576581	606	99.5	4.975e-131
UCT32H	contig_1	577081	577624	543	renamed_GCF_000008685.2	chromosome	577394	577937	543	100.0	3.121e-117
UCT32H	contig_1	589895	589370	525	renamed_GCF_000008685.2	chromosome	590208	589683	525	97.7	3.018e-106
UCT32H	contig_1	590034	590622	588	renamed_GCF_000008685.2	chromosome	590347	590935	588	99.4	4.112e-130
UCT32H	contig_1	592169	595613	3444	renamed_GCF_000008685.2	chromosome	592445	595931	3444	99.6	0.0
UCT32H	contig_1	596212	598273	2061	renamed_GCF_000008685.2	chromosome	596530	598591	2061	100.0	0.0
UCT32H	contig_1	599176	600526	1350	renamed_GCF_000008685.2	chromosome	599494	600844	1350	100.0	3.989e-293
UCT32H	contig_1	602055	603411	1356	renamed_GCF_000008685.2	chromosome	602373	603729	1356	99.3	5.612e-299
UCT32H	contig_1	661286	662210	924	renamed_GCF_000008685.2	chromosome	661605	662529	924	99.6	1.144e-200
UCT32H	contig_1	664692	662859	1833	renamed_GCF_000008685.2	chromosome	665011	663178	1833	100.0	0.0
UCT32H	contig_1	668198	664688	3510	renamed_GCF_000008685.2	chromosome	668517	665007	3510	99.4	0.0
UCT32H	contig_1	673021	674458	1437	renamed_GCF_000008685.2	chromosome	673341	674778	1437	99.3	0.0
UCT32H	contig_1	676147	677536	1389	renamed_GCF_000008685.2	chromosome	676471	677860	1389	100.0	1.442e-302
UCT32H	contig_1	679426	678634	792	renamed_GCF_000008685.2	chromosome	679750	678958	792	99.2	7.656e-166
UCT32H	contig_1	681282	680238	1044	renamed_GCF_000008685.2	chromosome	681606	680562	1044	100.0	8.539e-233
UCT32H	contig_1	682354	683053	699	renamed_GCF_000008685.2	chromosome	682678	683377	699	100.0	1.337e-152
UCT32H	contig_1	685657	684673	984	renamed_GCF_000008685.2	chromosome	685980	684996	984	99.3	1.874e-222
UCT32H	contig_1	686184	685653	531	renamed_GCF_000008685.2	chromosome	686507	685976	531	100.0	1.053e-118
UCT32H	contig_1	718492	720751	2259	renamed_GCF_000008685.2	chromosome	718826	721088	2259	99.7	0.0
UCT32H	contig_1	723793	722725	1068	renamed_GCF_000008685.2	chromosome	724130	723062	1068	100.0	3.402e-247
UCT32H	contig_1	725093	726158	1065	renamed_GCF_000008685.2	chromosome	725430	726495	1065	100.0	4.042e-236
UCT32H	contig_1	727399	728338	939	renamed_GCF_000008685.2	chromosome	727736	728675	939	100.0	1.678e-207
UCT32H	contig_1	738067	738433	366	renamed_GCF_000008685.2	chromosome	738405	738771	366	100.0	9.695e-76
UCT32H	contig_1	739346	739838	492	renamed_GCF_000008685.2	chromosome	739684	740176	492	99.3	2.164e-104
UCT32H	contig_1	740107	740350	243	renamed_GCF_000008685.2	chromosome	740445	740688	243	100.0	1.755e-49
UCT32H	contig_1	742290	741057	1233	renamed_GCF_000008685.2	chromosome	742628	741395	1233	99.2	4.064e-273
UCT32H	contig_1	744963	745995	1032	renamed_GCF_000008685.2	chromosome	745301	746333	1032	98.8	6.089e-226
UCT32H	contig_1	759864	761310	1446	renamed_GCF_000008685.2	chromosome	760225	761647	1446	99.1	5.737e-314
UCT32H	contig_1	865522	866065	543	renamed_GCF_000008685.2	chromosome	865915	866458	543	98.8	6.309e-118
UCT32H	contig_1	866287	867208	921	renamed_GCF_000008685.2	chromosome	866680	867601	921	99.3	3.387e-205
UCT32H	contig_1	867801	868347	546	renamed_GCF_000008685.2	chromosome	868194	868740	546	100.0	1.846e-123
UCT32H	contig_1	887789	886076	1713	renamed_GCF_000008685.2	chromosome	888179	886469	1713	99.1	0.0
UCT32H	contig_1	892738	896179	3441	renamed_GCF_000008685.2	chromosome	893128	896569	3441	98.4	0.0
UCT32H	contig_1	897302	896702	600	renamed_GCF_000008685.2	chromosome	897695	897095	600	99.4	6.881e-135
UCT32H	contig_1	901440	902865	1425	renamed_GCF_000008685.2	chromosome	901833	903258	1425	99.7	2.69e-310
UCT32H	contig_2	4251	2997	1254	renamed_GCF_000008685.2	lp54	4256	3002	1254	100.0	3.245e-279
UCT32H	contig_2	5639	6512	873	renamed_GCF_000008685.2	lp54	5645	6518	873	99.3	2.643e-191
UCT32H	contig_2	8259	8439	180	renamed_GCF_000008685.2	lp54	8265	8445	180	100.0	1.452e-33
UCT32H	contig_5	10092	9534	558	renamed_GCF_000008685.2	cp32-3	2010	2568	558	100.0	1.105e-122
UCT32H	contig_5	12037	10813	1224	renamed_GCF_000008685.2	cp32-8	65	1289	1224	100.0	2.096e-270
UCT32H	contig_5	16606	16084	522	renamed_GCF_000008685.2	cp32-8	26381	26903	522	100.0	1.338e-114
UCT32H	contig_6	2240	2816	576	renamed_GCF_000008685.2	lp56	6835	7411	576	99.4	1.005e-126
UCT32H	contig_7	7700	6740	960	renamed_GCF_000008685.2	cp32-1	3962	4922	960	99.3	3.255e-212
UCT32H	contig_7	23196	22098	1098	renamed_GCF_000008685.2	cp32-6	19068	20169	1098	96.1	6.759e-236
UCT32H	contig_8	3764	3308	456	renamed_GCF_000008685.2	cp32-7	8273	8729	456	97.3	4.83e-98
UCT32H	contig_8	5335	4222	1113	renamed_GCF_000008685.2	cp32-1	6700	7813	1113	98.1	9.945e-243
UCT32H	contig_8	6639	6255	384	renamed_GCF_000008685.2	lp56	8866	9250	384	100.0	2.931e-83
UCT32H	contig_8	15321	14811	510	renamed_GCF_000008685.2	cp32-3	27409	27919	510	96.4	1.177e-105
UCT32H	contig_8	17694	17268	426	renamed_GCF_000008685.2	cp32-6	24618	25044	426	99.2	1.793e-95
UCT32H	contig_8	20214	19545	669	renamed_GCF_000008685.2	cp32-6	22101	22770	669	100.0	2.138e-142
UCT32H	contig_8	21595	20845	750	renamed_GCF_000008685.2	cp32-6	20720	21470	750	99.5	9.67e-165
UCT32H	contig_9	1390	2488	1098	renamed_GCF_000008685.2	cp32-4	18959	20057	1098	97.8	6.545e-245
UCT32H	contig_9	3039	3795	756	renamed_GCF_000008685.2	cp32-4	20608	21364	756	98.8	4.353e-166
UCT32H	contig_10	14444	15137	693	renamed_GCF_000008685.2	cp32-6	27745	27076	693	27.6	2.503e-09
UCT32H	contig_10	16371	17148	777	renamed_GCF_000008685.2	cp32-7	25720	24943	777	100.0	1.414e-173
UCT32H	contig_10	21871	21304	567	renamed_GCF_000008685.2	cp32-3	20714	21281	567	99.4	6.547e-130
UCT32H	contig_10	23353	24304	951	renamed_GCF_000008685.2	cp32-3	19228	18286	951	88.3	7.644e-184
UCT32H	contig_10	26164	25810	354	renamed_GCF_000008685.2	cp32-6	16102	16456	354	100.0	1.459e-77
UCT32H	contig_13	3935	4802	867	renamed_GCF_000008685.2	lp28-4	25089	24222	867	96.1	1.236e-181
UCT32H	contig_13	25844	25028	816	renamed_GCF_000008685.2	lp28-4	2535	3351	816	100.0	8.08e-178
UCT32H	contig_14	540	1092	552	renamed_GCF_000008685.2	cp26	23154	22602	552	100.0	6.015e-120
UCT32H	contig_14	17036	15998	1038	renamed_GCF_000008685.2	cp26	6676	7714	1038	99.4	4.211e-231
UCT32H	contig_14	19273	18955	318	renamed_GCF_000008685.2	cp26	4481	4757	318	97.8	1.616e-54
UCT32H	contig_17	20580	22098	1518	renamed_GCF_000008685.2	lp28-2	24488	25955	1518	64.8	6.276e-200
UCT32H	contig_17	22666	23203	537	renamed_GCF_000008685.2	lp28-2	26569	27085	537	52.2	3.419e-56
UCT32H	contig_19	5083	4615	468	renamed_GCF_000008685.2	cp32-4	16496	16997	468	91.5	4.26e-93
UCT32H	contig_21	252	633	381	renamed_GCF_000008685.2	lp28-4	173	608	381	68.0	3.224e-49
UCT32H	contig_32	71	647	576	renamed_GCF_000008685.2	cp32-7	16551	17139	576	91.2	4.184e-111