QUERY_ID	QUERY_NAME	QUERY_START	QUERY_END	QUERY_LENGTH	REF_ID	REF_NAME	REF_START	REF_END	REF_LENGTH	IDENTITY	EVALUE
UNY990P	contig_1	37703	37160	543	renamed_GCF_000008685.2	chromosome	865915	866458	543	98.3	6.941e-117
UNY990P	contig_1	38557	37699	858	renamed_GCF_000008685.2	chromosome	865052	865919	858	99.6	3.329e-186
UNY990P	contig_1	40920	39972	948	renamed_GCF_000008685.2	chromosome	862698	863646	948	100.0	4.292e-207
UNY990P	contig_1	56500	56137	363	renamed_GCF_000008685.2	chromosome	847125	847488	363	100.0	2.269e-74
UNY990P	contig_1	60560	59111	1449	renamed_GCF_000008685.2	chromosome	843002	844451	1449	99.5	8.451e-319
UNY990P	contig_1	61729	61111	618	renamed_GCF_000008685.2	chromosome	841833	842451	618	100.0	1.393e-138
UNY990P	contig_1	65016	64482	534	renamed_GCF_000008685.2	chromosome	838546	839080	534	100.0	7.282e-115
UNY990P	contig_1	82956	82374	582	renamed_GCF_000008685.2	chromosome	820606	821188	582	100.0	9.143e-129
UNY990P	contig_1	84321	84075	246	renamed_GCF_000008685.2	chromosome	819241	819487	246	100.0	8.275e-50
UNY990P	contig_1	126804	126015	789	renamed_GCF_000008685.2	chromosome	776784	777573	789	99.2	2.06e-171
UNY990P	contig_1	128912	128126	786	renamed_GCF_000008685.2	chromosome	774676	775462	786	100.0	1.17e-168
UNY990P	contig_1	132025	132427	402	renamed_GCF_000008685.2	chromosome	771563	771161	402	100.0	3.917e-83
UNY990P	contig_1	149038	147238	1800	renamed_GCF_000008685.2	chromosome	754636	756349	1800	99.8	0.0
UNY990P	contig_1	150365	149519	846	renamed_GCF_000008685.2	chromosome	753291	754068	846	98.8	3.591e-166
UNY990P	contig_1	152397	151428	969	renamed_GCF_000008685.2	chromosome	751190	752159	969	99.6	1.06e-217
UNY990P	contig_1	155465	153569	1896	renamed_GCF_000008685.2	chromosome	748122	750018	1896	99.6	0.0
UNY990P	contig_1	165879	165159	720	renamed_GCF_000008685.2	chromosome	737708	738428	720	100.0	9.639e-160
UNY990P	contig_1	166889	166628	261	renamed_GCF_000008685.2	chromosome	736698	736959	261	100.0	3.165e-54
UNY990P	contig_1	169507	168298	1209	renamed_GCF_000008685.2	chromosome	734080	735289	1209	100.0	8.188e-270
UNY990P	contig_1	215093	213455	1638	renamed_GCF_000008685.2	chromosome	688489	690127	1638	100.0	0.0
UNY990P	contig_1	217075	217606	531	renamed_GCF_000008685.2	chromosome	686507	685976	531	100.0	1.053e-118
UNY990P	contig_1	220161	218616	1545	renamed_GCF_000008685.2	chromosome	683422	684967	1545	100.0	0.0
UNY990P	contig_1	221059	221899	840	renamed_GCF_000008685.2	chromosome	682524	681684	840	100.0	1.641e-182
UNY990P	contig_1	223020	223830	810	renamed_GCF_000008685.2	chromosome	680557	679753	810	99.2	5.794e-172
UNY990P	contig_1	224644	225691	1047	renamed_GCF_000008685.2	chromosome	678938	677891	1047	98.8	3.051e-236
UNY990P	contig_1	248778	246684	2094	renamed_GCF_000008685.2	chromosome	654862	656902	2094	98.8	0.0
UNY990P	contig_1	253199	254417	1218	renamed_GCF_000008685.2	chromosome	650387	649169	1218	100.0	2.758e-266
UNY990P	contig_1	255260	256928	1668	renamed_GCF_000008685.2	chromosome	648254	646658	1668	99.8	0.0
UNY990P	contig_1	406194	405564	630	renamed_GCF_000008685.2	chromosome	497244	497874	630	100.0	4.528e-136
UNY990P	contig_1	406824	406203	621	renamed_GCF_000008685.2	chromosome	496614	497235	621	100.0	8.732e-136
UNY990P	contig_1	407171	406859	312	renamed_GCF_000008685.2	chromosome	496267	496579	312	100.0	2.953e-63
UNY990P	contig_1	408406	407221	1185	renamed_GCF_000008685.2	chromosome	495032	496217	1185	100.0	4.832e-263
UNY990P	contig_1	408896	409289	393	renamed_GCF_000008685.2	chromosome	494539	494149	393	99.2	2.252e-79
UNY990P	contig_1	410851	409486	1365	renamed_GCF_000008685.2	chromosome	492587	493952	1365	100.0	1.721e-296
UNY990P	contig_1	412794	411510	1284	renamed_GCF_000008685.2	chromosome	490643	491927	1284	99.5	2.329e-279
UNY990P	contig_1	413705	412883	822	renamed_GCF_000008685.2	chromosome	489732	490554	822	99.2	6.708e-181
UNY990P	contig_1	413946	413718	228	renamed_GCF_000008685.2	chromosome	489539	489719	228	98.3	7.248e-33
UNY990P	contig_1	423729	422418	1311	renamed_GCF_000008685.2	chromosome	479708	481019	1311	100.0	7.438e-297
UNY990P	contig_1	425360	427172	1812	renamed_GCF_000008685.2	chromosome	478005	476262	1812	99.4	0.0
UNY990P	contig_1	427828	427222	606	renamed_GCF_000008685.2	chromosome	475605	476211	606	99.5	2.237e-131
UNY990P	contig_1	428821	427831	990	renamed_GCF_000008685.2	chromosome	474612	475602	990	99.6	8.752e-215
UNY990P	contig_1	428877	430029	1152	renamed_GCF_000008685.2	chromosome	474556	473404	1152	99.7	3.808e-260
UNY990P	contig_1	430868	430025	843	renamed_GCF_000008685.2	chromosome	472565	473408	843	98.9	2.632e-186
UNY990P	contig_1	430958	431663	705	renamed_GCF_000008685.2	chromosome	472358	471770	705	98.9	1.099e-121
UNY990P	contig_1	431677	432211	534	renamed_GCF_000008685.2	chromosome	471756	471222	534	99.4	1.961e-112
UNY990P	contig_1	432213	433473	1260	renamed_GCF_000008685.2	chromosome	471220	469960	1260	99.7	1.253e-273
UNY990P	contig_1	443909	443609	300	renamed_GCF_000008685.2	chromosome	459524	459824	300	97.9	1.627e-59
UNY990P	contig_1	445157	443999	1158	renamed_GCF_000008685.2	chromosome	458276	459434	1158	100.0	2.482e-257
UNY990P	contig_1	446858	445397	1461	renamed_GCF_000008685.2	chromosome	456575	458036	1461	99.5	0.0
UNY990P	contig_1	447045	448950	1905	renamed_GCF_000008685.2	chromosome	456388	454483	1905	99.8	0.0
UNY990P	contig_1	448961	451394	2433	renamed_GCF_000008685.2	chromosome	454472	452039	2433	99.7	0.0
UNY990P	contig_1	451512	452295	783	renamed_GCF_000008685.2	chromosome	451921	451138	783	100.0	1.017e-169
UNY990P	contig_1	454015	453262	753	renamed_GCF_000008685.2	chromosome	449418	450171	753	100.0	3.278e-160
UNY990P	contig_1	454729	454123	606	renamed_GCF_000008685.2	chromosome	448707	449310	606	99.5	2.46e-130
UNY990P	contig_1	454842	455232	390	renamed_GCF_000008685.2	chromosome	448591	448201	390	100.0	7.926e-82
UNY990P	contig_1	477858	476730	1128	renamed_GCF_000008685.2	chromosome	425583	426711	1128	99.7	5.155e-244
UNY990P	contig_1	478748	477890	858	renamed_GCF_000008685.2	chromosome	424693	425551	858	100.0	1.579e-194
UNY990P	contig_1	478995	479613	618	renamed_GCF_000008685.2	chromosome	424442	423821	618	99.0	1.106e-132
UNY990P	contig_1	480387	479607	780	renamed_GCF_000008685.2	chromosome	423054	423834	780	99.6	1.628e-172
UNY990P	contig_1	481891	481261	630	renamed_GCF_000008685.2	chromosome	421553	422183	630	99.0	3.101e-140
UNY990P	contig_1	482064	483942	1878	renamed_GCF_000008685.2	chromosome	421380	419502	1878	99.2	0.0
UNY990P	contig_1	483938	485057	1119	renamed_GCF_000008685.2	chromosome	419506	418387	1119	99.7	3.957e-254
UNY990P	contig_1	485721	485109	612	renamed_GCF_000008685.2	chromosome	417723	418335	612	99.5	1.531e-136
UNY990P	contig_1	486343	485731	612	renamed_GCF_000008685.2	chromosome	417101	417713	612	100.0	4.975e-132
UNY990P	contig_1	495546	496101	555	renamed_GCF_000008685.2	chromosome	407898	407343	555	100.0	5.734e-121
UNY990P	contig_1	496152	496584	432	renamed_GCF_000008685.2	chromosome	407292	406860	432	100.0	3.534e-89
UNY990P	contig_1	496583	497264	681	renamed_GCF_000008685.2	chromosome	406861	406180	681	100.0	2.702e-150
UNY990P	contig_1	497268	497757	489	renamed_GCF_000008685.2	chromosome	406176	405687	489	99.3	2.753e-101
UNY990P	contig_1	497827	498202	375	renamed_GCF_000008685.2	chromosome	405617	405242	375	99.1	2.753e-74
UNY990P	contig_1	501767	505901	4134	renamed_GCF_000008685.2	chromosome	401677	397543	4134	99.7	0.0
UNY990P	contig_1	505968	506343	375	renamed_GCF_000008685.2	chromosome	397476	397101	375	100.0	1.385e-81
UNY990P	contig_1	506367	506841	474	renamed_GCF_000008685.2	chromosome	397077	396603	474	100.0	4.822e-101
UNY990P	contig_1	506938	507964	1026	renamed_GCF_000008685.2	chromosome	396506	395480	1026	99.7	6.672e-224
UNY990P	contig_1	519160	518020	1140	renamed_GCF_000008685.2	chromosome	384286	385426	1140	100.0	7.242e-251
UNY990P	contig_1	542247	541125	1122	renamed_GCF_000008685.2	chromosome	361187	362321	1122	99.4	5.47e-251
UNY990P	contig_1	542368	543934	1566	renamed_GCF_000008685.2	chromosome	361078	359512	1566	100.0	0.0
UNY990P	contig_1	543951	544230	279	renamed_GCF_000008685.2	chromosome	359495	359216	279	97.8	3.143e-57
UNY990P	contig_1	544989	544248	741	renamed_GCF_000008685.2	chromosome	358457	359198	741	99.1	1.013e-162
UNY990P	contig_1	546440	545006	1434	renamed_GCF_000008685.2	chromosome	357006	358440	1434	99.7	4.764e-314
UNY990P	contig_1	547956	546537	1419	renamed_GCF_000008685.2	chromosome	355490	356909	1419	99.7	6.982e-316
UNY990P	contig_1	548148	548799	651	renamed_GCF_000008685.2	chromosome	355298	354647	651	100.0	1.769e-141
UNY990P	contig_1	548810	550010	1200	renamed_GCF_000008685.2	chromosome	354636	353439	1200	98.9	1.486e-261
UNY990P	contig_1	550009	552109	2100	renamed_GCF_000008685.2	chromosome	353437	351340	2100	96.9	0.0
UNY990P	contig_1	562176	561126	1050	renamed_GCF_000008685.2	chromosome	341273	342323	1050	100.0	1.489e-227
UNY990P	contig_1	586223	587300	1077	renamed_GCF_000008685.2	chromosome	317216	316139	1077	99.4	9.875e-237
UNY990P	contig_1	587296	588133	837	renamed_GCF_000008685.2	chromosome	316143	315306	837	99.6	1.426e-183
UNY990P	contig_1	588125	589016	891	renamed_GCF_000008685.2	chromosome	315314	314423	891	99.3	2.2e-196
UNY990P	contig_1	589012	589294	282	renamed_GCF_000008685.2	chromosome	314427	314145	282	100.0	2.699e-59
UNY990P	contig_1	589316	590708	1392	renamed_GCF_000008685.2	chromosome	314123	312728	1392	99.1	6.205e-304
UNY990P	contig_1	590725	591781	1056	renamed_GCF_000008685.2	chromosome	312715	311659	1056	100.0	1.239e-230
UNY990P	contig_1	591787	592882	1095	renamed_GCF_000008685.2	chromosome	311617	310558	1095	99.4	1.229e-228
UNY990P	contig_1	592917	593661	744	renamed_GCF_000008685.2	chromosome	310523	309779	744	100.0	5.245e-162
UNY990P	contig_1	593660	594902	1242	renamed_GCF_000008685.2	chromosome	309780	308538	1242	100.0	1.368e-269
UNY990P	contig_1	603725	604646	921	renamed_GCF_000008685.2	chromosome	299715	298794	921	99.6	1.032e-192
UNY990P	contig_1	621630	622110	480	renamed_GCF_000008685.2	chromosome	281793	281313	480	98.7	5.307e-101
UNY990P	contig_1	622112	624017	1905	renamed_GCF_000008685.2	chromosome	281311	279406	1905	99.8	0.0
UNY990P	contig_1	624043	624346	303	renamed_GCF_000008685.2	chromosome	279380	279077	303	98.0	2.549e-63
UNY990P	contig_1	624365	624887	522	renamed_GCF_000008685.2	chromosome	279058	278536	522	99.4	1.962e-110
UNY990P	contig_1	624864	626334	1470	renamed_GCF_000008685.2	chromosome	278559	277089	1470	100.0	8.9e-322
UNY990P	contig_1	626866	626359	507	renamed_GCF_000008685.2	chromosome	276671	277064	507	99.2	3.116e-86
UNY990P	contig_1	626927	628181	1254	renamed_GCF_000008685.2	chromosome	276496	275242	1254	99.5	1.215e-281
UNY990P	contig_1	629570	628187	1383	renamed_GCF_000008685.2	chromosome	273856	275236	1383	99.7	2.662e-303
UNY990P	contig_1	629776	630790	1014	renamed_GCF_000008685.2	chromosome	273647	272633	1014	98.5	8.011e-220
UNY990P	contig_1	648479	647774	705	renamed_GCF_000008685.2	chromosome	254944	255649	705	100.0	7.263e-152
UNY990P	contig_1	671802	671100	702	renamed_GCF_000008685.2	chromosome	231620	232322	702	98.2	3.117e-152
UNY990P	contig_1	671931	673209	1278	renamed_GCF_000008685.2	chromosome	231491	230213	1278	99.7	4.58e-288
UNY990P	contig_1	674206	673198	1008	renamed_GCF_000008685.2	chromosome	229216	230224	1008	99.4	2.993e-221
UNY990P	contig_1	674901	675609	708	renamed_GCF_000008685.2	chromosome	228521	227813	708	100.0	8.763e-159
UNY990P	contig_1	675595	676813	1218	renamed_GCF_000008685.2	chromosome	227827	226609	1218	99.7	1.361e-265
UNY990P	contig_1	676812	678597	1785	renamed_GCF_000008685.2	chromosome	226610	224825	1785	99.6	0.0
UNY990P	contig_1	678637	679459	822	renamed_GCF_000008685.2	chromosome	224785	223963	822	100.0	3.638e-179
UNY990P	contig_1	707914	707053	861	renamed_GCF_000008685.2	chromosome	194875	195736	861	98.9	3.489e-186
UNY990P	contig_1	709327	710467	1140	renamed_GCF_000008685.2	chromosome	193463	192323	1140	99.2	5.008e-255
UNY990P	contig_1	710463	711273	810	renamed_GCF_000008685.2	chromosome	192327	191517	810	99.6	2.276e-182
UNY990P	contig_1	712072	711331	741	renamed_GCF_000008685.2	chromosome	190718	191459	741	99.1	1.777e-156
UNY990P	contig_1	712727	712073	654	renamed_GCF_000008685.2	chromosome	190186	190717	654	99.4	3.12e-110
UNY990P	contig_1	712931	713492	561	renamed_GCF_000008685.2	chromosome	189859	189298	561	100.0	1.275e-121
UNY990P	contig_1	713514	713715	201	renamed_GCF_000008685.2	chromosome	189276	189075	201	100.0	9.889e-41
UNY990P	contig_1	756418	757318	900	renamed_GCF_000008685.2	chromosome	146370	145470	900	100.0	6.779e-194
UNY990P	contig_1	771677	772622	945	renamed_GCF_000008685.2	chromosome	131114	130169	945	100.0	6.888e-210
UNY990P	contig_1	772659	775365	2706	renamed_GCF_000008685.2	chromosome	130132	127426	2706	99.6	0.0
UNY990P	contig_1	775378	776476	1098	renamed_GCF_000008685.2	chromosome	127413	126315	1098	99.4	6.759e-236
UNY990P	contig_1	776490	777258	768	renamed_GCF_000008685.2	chromosome	126301	125533	768	98.0	9.689e-168
UNY990P	contig_1	777244	777994	750	renamed_GCF_000008685.2	chromosome	125547	124797	750	99.1	1.407e-160
UNY990P	contig_1	777977	778643	666	renamed_GCF_000008685.2	chromosome	124814	124148	666	99.5	4.126e-143
UNY990P	contig_1	778645	780301	1656	renamed_GCF_000008685.2	chromosome	124146	122490	1656	99.0	0.0
UNY990P	contig_1	780300	780912	612	renamed_GCF_000008685.2	chromosome	122491	121879	612	98.0	3.95e-126
UNY990P	contig_1	780969	781692	723	renamed_GCF_000008685.2	chromosome	121823	121100	723	94.1	7.988e-154
UNY990P	contig_1	781711	781990	279	renamed_GCF_000008685.2	chromosome	121082	120803	279	94.5	3.848e-55
UNY990P	contig_1	790919	791210	291	renamed_GCF_000008685.2	chromosome	111875	111584	291	98.9	9.399e-64
UNY990P	contig_1	791226	791748	522	renamed_GCF_000008685.2	chromosome	111567	111045	522	100.0	1.783e-111
UNY990P	contig_1	791751	793119	1368	renamed_GCF_000008685.2	chromosome	111042	109674	1368	100.0	1.976e-295
UNY990P	contig_1	794487	793122	1365	renamed_GCF_000008685.2	chromosome	108306	109671	1365	99.7	2.146e-311
UNY990P	contig_1	794623	795820	1197	renamed_GCF_000008685.2	chromosome	108170	106973	1197	99.2	2.246e-256
UNY990P	contig_1	795899	796910	1011	renamed_GCF_000008685.2	chromosome	106894	105883	1011	100.0	4.14e-218
UNY990P	contig_1	796938	797376	438	renamed_GCF_000008685.2	chromosome	105846	105417	438	98.5	1.926e-88
UNY990P	contig_1	797362	799030	1668	renamed_GCF_000008685.2	chromosome	105299	103763	1668	99.8	0.0
UNY990P	contig_1	799022	799778	756	renamed_GCF_000008685.2	chromosome	103771	103015	756	99.6	2.151e-165
UNY990P	contig_1	799844	801269	1425	renamed_GCF_000008685.2	chromosome	102949	101524	1425	99.7	2.24e-312
UNY990P	contig_1	811677	812982	1305	renamed_GCF_000008685.2	chromosome	91115	89810	1305	100.0	2.863e-289
UNY990P	contig_1	812984	813593	609	renamed_GCF_000008685.2	chromosome	89808	89199	609	100.0	1.275e-129
UNY990P	contig_1	815432	815867	435	renamed_GCF_000008685.2	chromosome	87360	86925	435	99.3	6.167e-92
UNY990P	contig_1	815938	816913	975	renamed_GCF_000008685.2	chromosome	86854	85879	975	99.3	2.15e-219
UNY990P	contig_1	816924	818754	1830	renamed_GCF_000008685.2	chromosome	85720	84040	1830	99.8	0.0
UNY990P	contig_1	818874	819825	951	renamed_GCF_000008685.2	chromosome	83920	82969	951	99.3	8.301e-209
UNY990P	contig_1	821390	819854	1536	renamed_GCF_000008685.2	chromosome	81404	82940	1536	100.0	0.0
UNY990P	contig_1	821812	821386	426	renamed_GCF_000008685.2	chromosome	80982	81408	426	99.2	2.643e-91
UNY990P	contig_1	823290	822021	1269	renamed_GCF_000008685.2	chromosome	79504	80773	1269	99.7	6.911e-282
UNY990P	contig_1	845539	844822	717	renamed_GCF_000008685.2	chromosome	57258	57975	717	98.7	3.592e-153
UNY990P	contig_1	845612	845966	354	renamed_GCF_000008685.2	chromosome	57185	56831	354	99.1	6.554e-78
UNY990P	contig_1	846049	846517	468	renamed_GCF_000008685.2	chromosome	56748	56280	468	98.7	9.748e-101
UNY990P	contig_1	846517	847297	780	renamed_GCF_000008685.2	chromosome	56280	55500	780	99.6	1.628e-172
UNY990P	contig_1	847293	849264	1971	renamed_GCF_000008685.2	chromosome	55504	53533	1971	99.5	0.0
UNY990P	contig_1	849336	850344	1008	renamed_GCF_000008685.2	chromosome	53461	52453	1008	99.7	7.295e-220
UNY990P	contig_1	850363	851545	1182	renamed_GCF_000008685.2	chromosome	52434	51252	1182	99.2	3.953e-256
UNY990P	contig_1	851546	852308	762	renamed_GCF_000008685.2	chromosome	51251	50489	762	99.6	5.77e-164
UNY990P	contig_1	852323	852686	363	renamed_GCF_000008685.2	chromosome	50474	50111	363	100.0	4.578e-75
UNY990P	contig_1	853456	852784	672	renamed_GCF_000008685.2	chromosome	49340	50012	672	100.0	9.591e-152
UNY990P	contig_1	876397	875347	1050	renamed_GCF_000008685.2	chromosome	26398	27448	1050	98.8	9.378e-233
UNY990P	contig_1	877043	876404	639	renamed_GCF_000008685.2	chromosome	25752	26391	639	99.5	1.211e-143
UNY990P	contig_1	877172	878099	927	renamed_GCF_000008685.2	chromosome	25623	24696	927	99.3	1.315e-199
UNY990P	contig_1	878099	878831	732	renamed_GCF_000008685.2	chromosome	24696	23964	732	100.0	2.844e-158
UNY990P	contig_1	879977	878837	1140	renamed_GCF_000008685.2	chromosome	22818	23958	1140	98.9	3.157e-260
UNY990P	contig_1	880056	880650	594	renamed_GCF_000008685.2	chromosome	22739	22145	594	100.0	3.27e-125
UNY990P	contig_1	880694	881738	1044	renamed_GCF_000008685.2	chromosome	22101	21057	1044	99.7	3.304e-226
UNY990P	contig_1	893593	892588	1005	renamed_GCF_000008685.2	chromosome	9201	10206	1005	99.7	3.77e-218
UNY990P	contig_2	10842	11604	762	renamed_GCF_000008685.2	cp26	9274	10036	762	98.8	1.282e-163
UNY990P	contig_2	11671	12220	549	renamed_GCF_000008685.2	cp26	10103	10652	549	98.9	3.433e-117
UNY990P	contig_2	12985	12487	498	renamed_GCF_000008685.2	cp26	11417	10919	498	98.7	3.972e-107
UNY990P	contig_2	13569	15162	1593	renamed_GCF_000008685.2	cp26	12013	13606	1593	99.4	0.0
UNY990P	contig_2	16663	15448	1215	renamed_GCF_000008685.2	cp26	15107	13892	1215	99.0	1.424e-264
UNY990P	contig_2	18223	16687	1536	renamed_GCF_000008685.2	cp26	16667	15131	1536	99.2	0.0
UNY990P	contig_2	18457	19093	636	renamed_GCF_000008685.2	cp26	16902	17535	636	74.1	5.73e-92
UNY990P	contig_2	20899	19543	1356	renamed_GCF_000008685.2	cp26	19321	17965	1356	99.5	4.378e-293
UNY990P	contig_2	22364	21008	1356	renamed_GCF_000008685.2	cp26	20786	19430	1356	99.3	4.378e-293
UNY990P	contig_3	17706	18060	354	renamed_GCF_000008685.2	lp56	19584	19938	354	100.0	1.459e-77
UNY990P	contig_3	18853	19471	618	renamed_GCF_000008685.2	lp56	20843	21455	618	71.0	3.977e-93
UNY990P	contig_3	21982	22549	567	renamed_GCF_000008685.2	cp32-4	20066	20633	567	99.4	7.201e-129
UNY990P	contig_3	22524	23274	750	renamed_GCF_000008685.2	cp32-6	20720	21470	750	99.1	1.062e-163
UNY990P	contig_3	23323	23902	579	renamed_GCF_000008685.2	cp32-6	21519	22098	579	100.0	5.735e-125
UNY990P	contig_3	23905	24574	669	renamed_GCF_000008685.2	cp32-6	22101	22770	669	100.0	2.138e-142
UNY990P	contig_3	26419	26845	426	renamed_GCF_000008685.2	cp32-7	24512	24938	426	99.2	1.793e-95
UNY990P	contig_3	28075	28624	549	renamed_GCF_000008685.2	cp32-9	26209	26770	549	73.6	1.052e-79
UNY990P	contig_3	29853	30381	528	renamed_GCF_000008685.2	cp32-4	27675	28203	528	89.7	3.482e-105
UNY990P	contig_4	8350	9463	1113	renamed_GCF_000008685.2	cp32-6	6710	7823	1113	98.3	2.209e-242
UNY990P	contig_5	2221	1444	777	renamed_GCF_000008685.2	cp32-8	25951	25174	777	92.6	8.799e-162
UNY990P	contig_5	2652	3336	684	renamed_GCF_000008685.2	cp32-7	26151	26841	684	72.0	4.254e-103
UNY990P	contig_5	4699	5266	567	renamed_GCF_000008685.2	cp32-3	28235	28874	567	93.0	5.522e-115
UNY990P	contig_5	6680	7907	1227	renamed_GCF_000008685.2	cp32-6	65	1289	1227	99.5	2.639e-268
UNY990P	contig_5	14901	15357	456	renamed_GCF_000008685.2	cp32-6	8281	8737	456	98.6	2.171e-98
UNY990P	contig_6	301	1654	1353	renamed_GCF_000008685.2	cp32-8	29532	30885	1353	99.5	6.861e-305
UNY990P	contig_6	1719	2946	1227	renamed_GCF_000008685.2	cp32-1	65	1289	1227	99.5	2.639e-268
UNY990P	contig_6	2962	3655	693	renamed_GCF_000008685.2	cp32-1	1305	1998	693	100.0	2.582e-144
UNY990P	contig_6	3667	4225	558	renamed_GCF_000008685.2	cp32-7	2009	2567	558	99.4	2.458e-122
UNY990P	contig_6	4231	4996	765	renamed_GCF_000008685.2	cp32-7	2573	3338	765	99.6	3.139e-171
UNY990P	contig_6	5619	6579	960	renamed_GCF_000008685.2	cp32-1	3962	4922	960	99.3	1.607e-211
UNY990P	contig_6	27865	28384	519	renamed_GCF_000008685.2	cp32-8	26381	26903	519	75.6	8.35e-86
UNY990P	contig_6	28411	29524	1113	renamed_GCF_000008685.2	cp32-1	26795	27932	1113	94.4	2.739e-231
UNY990P	contig_6	29707	30247	540	renamed_GCF_000008685.2	cp32-8	28250	28790	540	100.0	1.472e-116
UNY990P	contig_7	838	307	531	renamed_GCF_000008685.2	cp9	4377	3852	531	68.1	6.981e-73
UNY990P	contig_7	1252	961	291	renamed_GCF_000008685.2	cp9	4788	4503	291	79.1	1.054e-46
UNY990P	contig_7	2563	3340	777	renamed_GCF_000008685.2	cp9	6973	7771	777	86.4	2.237e-151
UNY990P	contig_7	5651	5090	561	renamed_GCF_000008685.2	cp9	1891	2452	561	93.0	4.567e-116
UNY990P	contig_7	6261	5703	558	renamed_GCF_000008685.2	cp9	1281	1839	558	97.8	2.458e-122
UNY990P	contig_9	8695	9199	504	renamed_GCF_000008685.2	lp25	15545	15041	504	94.0	7.29e-110
UNY990P	contig_9	9767	10853	1086	renamed_GCF_000008685.2	lp25	14530	13402	1086	93.3	2.166e-229
UNY990P	contig_9	10862	11426	564	renamed_GCF_000008685.2	lp25	13393	12829	564	94.6	2.975e-121
UNY990P	contig_9	11401	12160	759	renamed_GCF_000008685.2	lp25	12854	12095	759	98.4	5.504e-164
UNY990P	contig_9	12176	12758	582	renamed_GCF_000008685.2	lp25	12079	11497	582	98.9	1.106e-126
UNY990P	contig_9	13296	13803	507	renamed_GCF_000008685.2	lp25	10694	10199	507	82.3	5.2e-89
UNY990P	contig_9	13815	14436	621	renamed_GCF_000008685.2	lp25	10187	9566	621	90.2	2.047e-126
UNY990P	contig_12	1017	465	552	renamed_GCF_000008685.2	lp28-4	26359	26914	552	94.0	6.379e-111
UNY990P	contig_12	20668	20209	459	renamed_GCF_000008685.2	lp28-3	1044	1368	459	89.6	2.646e-55
UNY990P	contig_13	18075	16884	1191	renamed_GCF_000008685.2	lp28-2	17684	16493	1191	99.7	6.781e-269
UNY990P	contig_13	19218	18420	798	renamed_GCF_000008685.2	lp28-2	18827	18029	798	92.4	3.139e-168
UNY990P	contig_13	22695	20010	2685	renamed_GCF_000008685.2	lp28-2	22259	19619	2685	98.9	0.0
UNY990P	contig_13	23050	22663	387	renamed_GCF_000008685.2	lp28-2	22659	22272	387	99.2	5.106e-86
UNY990P	contig_13	24116	23423	693	renamed_GCF_000008685.2	lp28-2	23725	23032	693	99.1	1.008e-154
UNY990P	contig_14	11718	12276	558	renamed_GCF_000008685.2	lp28-1	14329	13768	558	53.7	5.684e-71
UNY990P	contig_15	8870	8723	147	renamed_GCF_000008685.2	lp28-3	8017	8431	147	61.5	1.987e-05
UNY990P	contig_16	35955	35268	687	renamed_GCF_000008685.2	lp38	35591	34904	687	98.6	2.239e-153
UNY990P	contig_17	976	178	798	renamed_GCF_000008685.2	lp54	52705	53503	798	99.6	6.687e-177
UNY990P	contig_17	2504	3395	891	renamed_GCF_000008685.2	lp54	51176	50285	891	98.9	4.455e-197
UNY990P	contig_17	14638	14878	240	renamed_GCF_000008685.2	lp54	40112	39872	240	97.4	9.196e-48
UNY990P	contig_17	18471	18204	267	renamed_GCF_000008685.2	lp54	36255	36534	267	98.8	1.568e-54
UNY990P	contig_17	19751	18905	846	renamed_GCF_000008685.2	lp54	34987	35833	846	99.6	2.758e-186
UNY990P	contig_17	21997	21778	219	renamed_GCF_000008685.2	lp54	32741	32960	219	100.0	7.958e-46
UNY990P	contig_1	55088	54821	267	renamed_GCF_000008685.2	chromosome	848537	848804	267	100.0	3.495e-54
UNY990P	contig_1	72621	73245	624	renamed_GCF_000008685.2	chromosome	830941	830317	624	97.5	3.408e-138
UNY990P	contig_1	75932	74450	1482	renamed_GCF_000008685.2	chromosome	827630	829112	1482	98.9	0.0
UNY990P	contig_1	79181	77858	1323	renamed_GCF_000008685.2	chromosome	824381	825704	1323	99.7	4.425e-296
UNY990P	contig_1	80300	79751	549	renamed_GCF_000008685.2	chromosome	823262	823811	549	98.9	4.154e-115
UNY990P	contig_1	81219	80868	351	renamed_GCF_000008685.2	chromosome	822343	822694	351	99.1	1.534e-76
UNY990P	contig_1	82378	81193	1185	renamed_GCF_000008685.2	chromosome	821184	822369	1185	100.0	1.177e-261
UNY990P	contig_1	89856	90201	345	renamed_GCF_000008685.2	chromosome	813706	813385	345	92.0	6.146e-61
UNY990P	contig_1	91202	92084	882	renamed_GCF_000008685.2	chromosome	812388	811506	882	99.6	1.248e-192
UNY990P	contig_1	93095	93890	795	renamed_GCF_000008685.2	chromosome	810495	809700	795	100.0	1.877e-173
UNY990P	contig_1	144002	143372	630	renamed_GCF_000008685.2	chromosome	759585	760215	630	99.0	4.119e-137
UNY990P	contig_1	159067	158743	324	renamed_GCF_000008685.2	chromosome	744521	744845	324	100.0	1.32e-65
UNY990P	contig_1	160959	162192	1233	renamed_GCF_000008685.2	chromosome	742628	741395	1233	99.5	4.064e-273
UNY990P	contig_1	163142	162899	243	renamed_GCF_000008685.2	chromosome	740445	740688	243	100.0	1.755e-49
UNY990P	contig_1	163903	163411	492	renamed_GCF_000008685.2	chromosome	739684	740176	492	99.3	2.164e-104
UNY990P	contig_1	165182	164816	366	renamed_GCF_000008685.2	chromosome	738405	738771	366	100.0	9.695e-76
UNY990P	contig_1	175851	174912	939	renamed_GCF_000008685.2	chromosome	727736	728675	939	99.3	8.285e-207
UNY990P	contig_1	178157	177092	1065	renamed_GCF_000008685.2	chromosome	725430	726495	1065	95.1	4.177e-227
UNY990P	contig_1	179457	180525	1068	renamed_GCF_000008685.2	chromosome	724130	723062	1068	99.4	8.292e-246
UNY990P	contig_1	241981	241057	924	renamed_GCF_000008685.2	chromosome	661605	662529	924	99.6	1.144e-200
UNY990P	contig_1	244689	243963	726	renamed_GCF_000008685.2	chromosome	658897	659623	726	99.5	1.694e-154
UNY990P	contig_1	260460	261087	627	renamed_GCF_000008685.2	chromosome	643126	642499	627	100.0	8.735e-137
UNY990P	contig_1	263747	261338	2409	renamed_GCF_000008685.2	chromosome	639858	642249	2409	99.3	0.0
UNY990P	contig_1	265625	265031	594	renamed_GCF_000008685.2	chromosome	637971	638556	594	100.0	1.47e-125
UNY990P	contig_1	269006	267575	1431	renamed_GCF_000008685.2	chromosome	634580	636011	1431	98.3	9.218e-315
UNY990P	contig_1	271596	271104	492	renamed_GCF_000008685.2	chromosome	631990	632482	492	100.0	1.786e-106
UNY990P	contig_1	287815	289573	1758	renamed_GCF_000008685.2	chromosome	615771	614013	1758	98.2	0.0
UNY990P	contig_1	292278	291564	714	renamed_GCF_000008685.2	chromosome	611308	612022	714	100.0	1.949e-159
UNY990P	contig_1	293680	294526	846	renamed_GCF_000008685.2	chromosome	609906	609060	846	100.0	3.324e-184
UNY990P	contig_1	401559	401253	306	renamed_GCF_000008685.2	chromosome	501879	502185	306	100.0	2.959e-62
UNY990P	contig_1	402224	401969	255	renamed_GCF_000008685.2	chromosome	501214	501469	255	100.0	1.745e-51
UNY990P	contig_1	403732	402850	882	renamed_GCF_000008685.2	chromosome	499706	500588	882	100.0	1.248e-192
UNY990P	contig_1	404383	404104	279	renamed_GCF_000008685.2	chromosome	499055	499334	279	100.0	1.411e-57
UNY990P	contig_1	414455	413942	513	renamed_GCF_000008685.2	chromosome	488982	489495	513	98.8	1.701e-110
UNY990P	contig_1	415903	415213	690	renamed_GCF_000008685.2	chromosome	487534	488224	690	98.6	1.16e-152
UNY990P	contig_1	417364	416668	696	renamed_GCF_000008685.2	chromosome	486073	486769	696	99.5	1.401e-151
UNY990P	contig_1	418675	418171	504	renamed_GCF_000008685.2	chromosome	484756	485266	504	100.0	1.216e-112
UNY990P	contig_1	420838	419155	1683	renamed_GCF_000008685.2	chromosome	482599	484282	1683	99.4	0.0
UNY990P	contig_1	433462	433756	294	renamed_GCF_000008685.2	chromosome	469971	469677	294	100.0	2.2e-63
UNY990P	contig_1	434046	436152	2106	renamed_GCF_000008685.2	chromosome	469387	467281	2106	99.7	0.0
UNY990P	contig_1	439381	438301	1080	renamed_GCF_000008685.2	chromosome	464052	465132	1080	100.0	9.122e-247
UNY990P	contig_1	440615	439547	1068	renamed_GCF_000008685.2	chromosome	462818	463886	1068	100.0	4.491e-244
UNY990P	contig_1	443518	443362	156	renamed_GCF_000008685.2	chromosome	459915	460071	156	100.0	2.965e-30
UNY990P	contig_1	455673	456465	792	renamed_GCF_000008685.2	chromosome	447736	446968	792	99.2	9.228e-164
UNY990P	contig_1	460193	460754	561	renamed_GCF_000008685.2	chromosome	443248	442687	561	98.9	1.159e-122
UNY990P	contig_1	468341	472826	4485	renamed_GCF_000008685.2	chromosome	435103	430618	4485	99.3	0.0
UNY990P	contig_1	474796	473767	1029	renamed_GCF_000008685.2	chromosome	428645	429674	1029	100.0	3.872e-239
UNY990P	contig_1	476706	475491	1215	renamed_GCF_000008685.2	chromosome	426735	427950	1215	99.2	4.167e-261
UNY990P	contig_1	486921	487599	678	renamed_GCF_000008685.2	chromosome	416478	415845	678	99.0	1.008e-143
UNY990P	contig_1	490332	489129	1203	renamed_GCF_000008685.2	chromosome	413112	414315	1203	99.5	7.009e-262
UNY990P	contig_1	492658	491998	660	renamed_GCF_000008685.2	chromosome	410786	411446	660	96.3	6.61e-137
UNY990P	contig_1	494042	494891	849	renamed_GCF_000008685.2	chromosome	409402	408553	849	99.6	2.186e-189
UNY990P	contig_1	495352	495523	171	renamed_GCF_000008685.2	chromosome	408092	407921	171	100.0	1.118e-34
UNY990P	contig_1	509383	510403	1020	renamed_GCF_000008685.2	chromosome	394063	393043	1020	99.7	1.481e-222
UNY990P	contig_1	511627	513052	1425	renamed_GCF_000008685.2	chromosome	391819	390391	1425	100.0	0.0
UNY990P	contig_1	514520	514940	420	renamed_GCF_000008685.2	chromosome	388926	388506	420	100.0	9.787e-93
UNY990P	contig_1	516113	515639	474	renamed_GCF_000008685.2	chromosome	387333	387807	474	100.0	1.339e-106
UNY990P	contig_1	530307	529926	381	renamed_GCF_000008685.2	chromosome	373139	373520	381	100.0	1.683e-80
UNY990P	contig_1	636358	636148	210	renamed_GCF_000008685.2	chromosome	267065	267275	210	100.0	4.647e-42
UNY990P	contig_1	639436	637309	2127	renamed_GCF_000008685.2	chromosome	263987	266114	2127	99.2	0.0
UNY990P	contig_1	647778	647163	615	renamed_GCF_000008685.2	chromosome	255645	256260	615	100.0	1.16e-131
UNY990P	contig_1	660985	659419	1566	renamed_GCF_000008685.2	chromosome	242437	244003	1566	98.6	0.0
UNY990P	contig_1	663172	664279	1107	renamed_GCF_000008685.2	chromosome	240250	239143	1107	99.7	3.718e-244
UNY990P	contig_1	665196	665454	258	renamed_GCF_000008685.2	chromosome	238226	237968	258	100.0	9.113e-51
UNY990P	contig_1	665793	666201	408	renamed_GCF_000008685.2	chromosome	237629	237221	408	100.0	2.649e-88
UNY990P	contig_1	667888	668134	246	renamed_GCF_000008685.2	chromosome	235534	235288	246	98.7	3.025e-52
UNY990P	contig_1	681789	680244	1545	renamed_GCF_000008685.2	chromosome	221741	223178	1545	98.5	1.707e-309
UNY990P	contig_1	724937	725813	876	renamed_GCF_000008685.2	chromosome	177853	176977	876	100.0	9.427e-195
UNY990P	contig_1	725816	726722	906	renamed_GCF_000008685.2	chromosome	176974	176068	906	98.6	7.445e-194
UNY990P	contig_1	728674	729262	588	renamed_GCF_000008685.2	chromosome	174116	173528	588	98.4	4.112e-130
UNY990P	contig_1	731540	731306	234	renamed_GCF_000008685.2	chromosome	171262	171484	234	98.6	1.134e-44
UNY990P	contig_1	733252	732082	1170	renamed_GCF_000008685.2	chromosome	169562	170708	1170	99.2	6.647e-257
UNY990P	contig_1	735032	736877	1845	renamed_GCF_000008685.2	chromosome	167759	165914	1845	99.5	0.0
UNY990P	contig_1	737971	739720	1749	renamed_GCF_000008685.2	chromosome	164820	163071	1749	99.3	0.0
UNY990P	contig_1	739990	741592	1602	renamed_GCF_000008685.2	chromosome	162801	161199	1602	100.0	0.0
UNY990P	contig_1	743424	742749	675	renamed_GCF_000008685.2	chromosome	159367	160042	675	98.6	4.754e-143
UNY990P	contig_1	744734	744317	417	renamed_GCF_000008685.2	chromosome	158075	158474	417	100.0	2.72e-81
UNY990P	contig_1	868758	870639	1881	renamed_GCF_000008685.2	chromosome	34037	32156	1881	100.0	0.0
UNY990P	contig_1	871769	871316	453	renamed_GCF_000008685.2	chromosome	31026	31479	453	100.0	2.279e-97
UNY990P	contig_1	873323	874304	981	renamed_GCF_000008685.2	chromosome	29472	28491	981	100.0	8.047e-223
UNY990P	contig_1	884490	885003	513	renamed_GCF_000008685.2	chromosome	18304	17791	513	100.0	1.701e-110
UNY990P	contig_1	887072	887450	378	renamed_GCF_000008685.2	chromosome	15716	15344	378	98.3	9.667e-78
UNY990P	contig_1	890049	888066	1983	renamed_GCF_000008685.2	chromosome	12745	14728	1983	99.2	0.0
UNY990P	contig_1	891374	890633	741	renamed_GCF_000008685.2	chromosome	11420	12161	741	99.1	4.555e-163
UNY990P	contig_1	892592	892217	375	renamed_GCF_000008685.2	chromosome	10202	10577	375	100.0	3.75e-79
UNY990P	contig_2	8244	9282	1038	renamed_GCF_000008685.2	cp26	6676	7714	1038	99.4	4.211e-231
UNY990P	contig_3	13544	14090	546	renamed_GCF_000008685.2	cp32-8	11919	12465	546	97.2	2.156e-113
UNY990P	contig_3	14119	14452	333	renamed_GCF_000008685.2	cp32-8	12494	12827	333	100.0	8.424e-72
UNY990P	contig_3	15948	16761	813	renamed_GCF_000008685.2	lp56	17822	18638	813	74.9	3.569e-126
UNY990P	contig_3	16834	17038	204	renamed_GCF_000008685.2	cp32-1	15214	15418	204	100.0	2.578e-39
UNY990P	contig_4	16846	17050	204	renamed_GCF_000008685.2	cp32-7	15221	15425	204	100.0	2.578e-39
UNY990P	contig_4	17053	17410	357	renamed_GCF_000008685.2	cp32-7	15428	15785	357	97.4	2.059e-74
UNY990P	contig_4	17390	17726	336	renamed_GCF_000008685.2	cp32-7	15765	16101	336	99.0	2.652e-68
UNY990P	contig_4	17718	18072	354	renamed_GCF_000008685.2	cp32-1	16086	16440	354	100.0	6.554e-78
UNY990P	contig_4	18692	18209	483	renamed_GCF_000008685.2	cp32-6	17075	16592	483	100.0	5.056e-102
UNY990P	contig_4	18863	19295	432	renamed_GCF_000008685.2	cp32-7	17244	17667	432	78.0	2.237e-69
UNY990P	contig_4	20277	19332	945	renamed_GCF_000008685.2	cp32-3	19228	18286	945	89.2	1.174e-186
UNY990P	contig_4	20653	21751	1098	renamed_GCF_000008685.2	cp32-7	19116	20214	1098	98.3	1.326e-245
UNY990P	contig_4	21760	22327	567	renamed_GCF_000008685.2	cp32-3	20714	21281	567	98.9	1.456e-129
UNY990P	contig_5	22042	22390	348	renamed_GCF_000008685.2	cp32-8	15421	15769	348	100.0	8.822e-74
UNY990P	contig_5	22379	22715	336	renamed_GCF_000008685.2	lp56	19256	19592	336	100.0	5.348e-69
UNY990P	contig_5	22707	23061	354	renamed_GCF_000008685.2	cp32-7	16093	16447	354	99.1	3.249e-77
UNY990P	contig_5	23165	23720	555	renamed_GCF_000008685.2	cp32-3	17088	17697	555	91.0	2.485e-113
UNY990P	contig_5	26954	27521	567	renamed_GCF_000008685.2	lp56	23975	24542	567	100.0	1.456e-129
UNY990P	contig_5	27496	28252	756	renamed_GCF_000008685.2	lp56	24517	25273	756	99.6	5.251e-164
UNY990P	contig_6	7053	7437	384	renamed_GCF_000008685.2	cp32-6	5403	5787	384	100.0	2.931e-83
UNY990P	contig_6	7424	7814	390	renamed_GCF_000008685.2	cp32-6	5774	6164	390	98.4	7.187e-83
UNY990P	contig_6	7810	8377	567	renamed_GCF_000008685.2	cp32-3	6153	6720	567	99.4	2.344e-124
UNY990P	contig_6	8357	9470	1113	renamed_GCF_000008685.2	cp32-4	6710	7823	1113	97.8	2.209e-242
UNY990P	contig_6	9485	9914	429	renamed_GCF_000008685.2	cp32-4	7837	8266	429	100.0	5.601e-92
UNY990P	contig_6	10381	10618	237	renamed_GCF_000008685.2	cp32-9	8741	8978	237	100.0	1.76e-48
UNY990P	contig_6	10625	11888	1263	renamed_GCF_000008685.2	cp32-8	8967	10242	1263	88.3	5.427e-240
UNY990P	contig_6	18184	18826	642	renamed_GCF_000008685.2	lp56	20042	20738	642	72.3	2.249e-103
UNY990P	contig_8	9129	8835	294	renamed_GCF_000008685.2	lp17	9980	9590	294	96.8	1.207e-61
UNY990P	contig_8	10889	10226	663	renamed_GCF_000008685.2	lp17	11646	10983	663	100.0	1.005e-149
UNY990P	contig_8	12537	13278	741	renamed_GCF_000008685.2	lp17	13338	14079	741	100.0	7.64e-166
UNY990P	contig_8	13268	13538	270	renamed_GCF_000008685.2	lp17	14069	14339	270	98.8	7.394e-55
UNY990P	contig_8	15312	15081	231	renamed_GCF_000008685.2	lp17	16119	15888	231	97.3	1.956e-46
UNY990P	contig_9	537	834	297	renamed_GCF_000008685.2	lp56	52608	52134	297	100.0	1.037e-63
UNY990P	contig_9	3880	4609	729	renamed_GCF_000008685.2	lp25	22677	21945	729	84.7	5.701e-133
UNY990P	contig_11	14628	14055	573	renamed_GCF_000008685.2	lp28-4	13264	13837	573	100.0	2.579e-124
UNY990P	contig_11	15439	14686	753	renamed_GCF_000008685.2	lp28-4	12453	13206	753	100.0	4.561e-165
UNY990P	contig_11	15969	15414	555	renamed_GCF_000008685.2	lp28-4	11923	12478	555	100.0	3.559e-126
UNY990P	contig_11	20792	19355	1437	renamed_GCF_000008685.2	lp28-4	7182	8538	1437	94.3	1.672e-291
UNY990P	contig_11	24052	23659	393	renamed_GCF_000008685.2	lp36	6040	5287	393	60.3	3.462e-42
UNY990P	contig_14	1258	115	1143	renamed_GCF_000008685.2	lp28-1	26996	28073	1143	43.2	2.193e-70
UNY990P	contig_14	18774	18210	564	renamed_GCF_000008685.2	lp28-2	1046	1928	564	96.4	5.574e-106
UNY990P	contig_15	17138	16526	612	renamed_GCF_000008685.2	lp36	16274	16886	612	100.0	9.153e-134
UNY990P	contig_15	19085	19835	750	renamed_GCF_000008685.2	lp36	14326	13576	750	99.5	5.248e-163
UNY990P	contig_15	23111	21464	1647	renamed_GCF_000008685.2	lp36	10300	11947	1647	99.8	0.0
UNY990P	contig_15	24040	23641	399	renamed_GCF_000008685.2	lp36	9372	9999	399	98.3	5.518e-79
UNY990P	contig_16	31173	30306	867	renamed_GCF_000008685.2	lp28-4	25089	24222	867	99.6	5.869e-190
UNY990P	contig_17	5415	6207	792	renamed_GCF_000008685.2	lp54	48267	47475	792	99.6	4.799e-171
UNY990P	contig_17	10205	11054	849	renamed_GCF_000008685.2	lp54	44533	43684	849	100.0	7.054e-185
UNY990P	contig_17	12484	12277	207	renamed_GCF_000008685.2	lp54	42266	42473	207	100.0	9.856e-42
UNY990P	contig_17	13705	14539	834	renamed_GCF_000008685.2	lp54	41045	40211	834	99.6	1.639e-181
UNY990P	contig_17	22959	22536	423	renamed_GCF_000008685.2	lp54	31779	32202	423	100.0	5.086e-92
UNY990P	contig_17	24645	24105	540	renamed_GCF_000008685.2	lp54	30093	30633	540	100.0	4.969e-120
UNY990P	contig_17	25355	24980	375	renamed_GCF_000008685.2	lp54	29383	29758	375	100.0	1.685e-79
UNY990P	contig_17	51813	52662	849	renamed_GCF_000008685.2	lp54	2893	2044	849	99.6	5.854e-187
UNY990P	contig_17	54057	53571	486	renamed_GCF_000008685.2	lp28-3	28197	27624	486	48.4	2.052e-45
UNY990P	contig_1	2820	1836	984	renamed_GCF_000008685.2	chromosome	900798	901782	984	99.6	2.476e-219
UNY990P	contig_1	4120	2887	1233	renamed_GCF_000008685.2	chromosome	899498	900731	1233	98.5	4.455e-272
UNY990P	contig_1	4304	5915	1611	renamed_GCF_000008685.2	chromosome	899320	897703	1611	96.2	0.0
UNY990P	contig_1	6491	7040	549	renamed_GCF_000008685.2	chromosome	897127	896578	549	99.4	1.275e-119
UNY990P	contig_1	13297	10444	2853	renamed_GCF_000008685.2	chromosome	890321	893174	2853	99.8	0.0
UNY990P	contig_1	15439	17149	1710	renamed_GCF_000008685.2	chromosome	888179	886469	1710	99.6	0.0
UNY990P	contig_1	19405	22534	3129	renamed_GCF_000008685.2	chromosome	884213	881084	3129	99.5	0.0
UNY990P	contig_1	24304	23368	936	renamed_GCF_000008685.2	chromosome	879314	880250	936	100.0	3.242e-208
UNY990P	contig_1	61011	60573	438	renamed_GCF_000008685.2	chromosome	842500	842989	438	98.6	2.908e-92
UNY990P	contig_1	64319	61730	2589	renamed_GCF_000008685.2	chromosome	839243	841832	2589	99.8	0.0
UNY990P	contig_1	67502	65036	2466	renamed_GCF_000008685.2	chromosome	836060	838526	2466	99.6	0.0
UNY990P	contig_1	71999	72608	609	renamed_GCF_000008685.2	chromosome	831563	830954	609	99.5	1.765e-134
UNY990P	contig_1	84021	83034	987	renamed_GCF_000008685.2	chromosome	819541	820528	987	100.0	5.255e-220
UNY990P	contig_1	84641	84320	321	renamed_GCF_000008685.2	chromosome	819035	819242	321	97.0	1.267e-41
UNY990P	contig_1	85545	85014	531	renamed_GCF_000008685.2	chromosome	818017	818548	531	100.0	1.403e-115
UNY990P	contig_1	86360	87251	891	renamed_GCF_000008685.2	chromosome	817160	816311	891	99.6	1.029e-187
UNY990P	contig_1	88260	88695	435	renamed_GCF_000008685.2	chromosome	815302	814867	435	100.0	4.611e-95
UNY990P	contig_1	147234	145917	1317	renamed_GCF_000008685.2	chromosome	756353	757670	1317	99.7	1.293e-291
UNY990P	contig_1	149520	149037	483	renamed_GCF_000008685.2	chromosome	754067	754550	483	99.3	6.952e-107
UNY990P	contig_1	151418	150368	1050	renamed_GCF_000008685.2	chromosome	752169	753219	1050	100.0	6.109e-229
UNY990P	contig_1	153557	152798	759	renamed_GCF_000008685.2	chromosome	750030	750789	759	100.0	2.255e-165
UNY990P	contig_1	166376	165875	501	renamed_GCF_000008685.2	chromosome	737211	737712	501	99.3	4.586e-106
UNY990P	contig_1	166628	166379	249	renamed_GCF_000008685.2	chromosome	736959	737208	249	100.0	2.148e-48
UNY990P	contig_1	168236	166901	1335	renamed_GCF_000008685.2	chromosome	735351	736686	1335	99.3	3.245e-284
UNY990P	contig_1	171794	169784	2010	renamed_GCF_000008685.2	chromosome	731793	733803	2010	99.2	0.0
UNY990P	contig_1	172488	172956	468	renamed_GCF_000008685.2	chromosome	731099	730631	468	96.7	1.182e-98
UNY990P	contig_1	217602	218586	984	renamed_GCF_000008685.2	chromosome	685980	684996	984	99.6	8.434e-223
UNY990P	contig_1	220905	220206	699	renamed_GCF_000008685.2	chromosome	682678	683377	699	100.0	1.337e-152
UNY990P	contig_1	221977	223021	1044	renamed_GCF_000008685.2	chromosome	681606	680562	1044	100.0	8.539e-233
UNY990P	contig_1	223833	224625	792	renamed_GCF_000008685.2	chromosome	679750	678958	792	99.2	7.656e-166
UNY990P	contig_1	227111	225722	1389	renamed_GCF_000008685.2	chromosome	676471	677860	1389	100.0	1.442e-302
UNY990P	contig_1	249700	248737	963	renamed_GCF_000008685.2	chromosome	653886	654849	963	99.6	2.583e-215
UNY990P	contig_1	249796	253174	3378	renamed_GCF_000008685.2	chromosome	653790	650412	3378	99.0	0.0
UNY990P	contig_1	255034	254479	555	renamed_GCF_000008685.2	chromosome	648552	649107	555	100.0	3.12e-119
UNY990P	contig_1	257868	256905	963	renamed_GCF_000008685.2	chromosome	645718	646681	963	99.6	2.583e-215
UNY990P	contig_1	313234	312646	588	renamed_GCF_000008685.2	chromosome	590347	590935	588	98.4	4.522e-129
UNY990P	contig_1	326194	325651	543	renamed_GCF_000008685.2	chromosome	577394	577937	543	100.0	3.121e-117
UNY990P	contig_1	327062	327608	546	renamed_GCF_000008685.2	chromosome	576499	575980	546	100.0	1.781e-115
UNY990P	contig_1	329736	328341	1395	renamed_GCF_000008685.2	chromosome	573852	575247	1395	99.7	6.33e-313
UNY990P	contig_1	332306	331736	570	renamed_GCF_000008685.2	chromosome	571282	571852	570	100.0	1.471e-121
UNY990P	contig_1	334311	334050	261	renamed_GCF_000008685.2	chromosome	569277	569538	261	100.0	9.575e-51
UNY990P	contig_1	348232	346867	1365	renamed_GCF_000008685.2	chromosome	555215	556580	1365	99.1	1.676e-305
UNY990P	contig_1	350309	349658	651	renamed_GCF_000008685.2	chromosome	553138	553789	651	99.5	7.238e-143
UNY990P	contig_1	351719	353801	2082	renamed_GCF_000008685.2	chromosome	551723	549641	2082	99.7	0.0
UNY990P	contig_1	399141	398643	498	renamed_GCF_000008685.2	chromosome	504297	504795	498	100.0	1.785e-107
UNY990P	contig_1	400073	399530	543	renamed_GCF_000008685.2	chromosome	503365	503908	543	100.0	7.636e-116
UNY990P	contig_1	400683	400497	186	renamed_GCF_000008685.2	chromosome	502755	502941	186	100.0	7.664e-41
UNY990P	contig_13	16873	15847	1026	renamed_GCF_000008685.2	lp28-2	16482	15456	1026	99.7	8.508e-230
UNY990P	contig_13	18410	18071	339	renamed_GCF_000008685.2	lp28-2	18019	17680	339	100.0	5.085e-70
UNY990P	contig_13	23424	23049	375	renamed_GCF_000008685.2	lp28-2	23033	22658	375	100.0	2.05e-77
UNY990P	contig_16	17788	18571	783	renamed_GCF_000008685.2	lp38	17387	18170	783	99.2	8.433e-172
UNY990P	contig_16	19713	20409	696	renamed_GCF_000008685.2	lp38	19312	20008	696	100.0	6.303e-152
UNY990P	contig_16	35032	34735	297	renamed_GCF_000008685.2	lp38	34668	34371	297	100.0	2.824e-61
UNY990P	contig_16	36612	35997	615	renamed_GCF_000008685.2	lp38	36248	35633	615	99.0	1.402e-129
UNY990P	contig_16	36863	37331	468	renamed_GCF_000008685.2	lp5	4387	4819	468	53.5	1.74e-44
UNY990P	contig_17	1976	1202	774	renamed_GCF_000008685.2	lp54	51705	52479	774	100.0	9.219e-161
UNY990P	contig_17	3603	3828	225	renamed_GCF_000008685.2	lp54	50077	49852	225	100.0	1.962e-45
UNY990P	contig_17	15345	16590	1245	renamed_GCF_000008685.2	lp54	39405	38160	1245	98.5	7.072e-269
UNY990P	contig_1	56135	55286	849	renamed_GCF_000008685.2	chromosome	847490	848339	849	98.5	1.721e-183
UNY990P	contig_1	74345	73241	1104	renamed_GCF_000008685.2	chromosome	829217	830321	1104	99.7	4.967e-249
UNY990P	contig_1	77862	75942	1920	renamed_GCF_000008685.2	chromosome	825700	827620	1920	100.0	0.0
UNY990P	contig_1	79747	79180	567	renamed_GCF_000008685.2	chromosome	823815	824382	567	100.0	1.275e-122
UNY990P	contig_1	80753	80459	294	renamed_GCF_000008685.2	chromosome	822809	823103	294	100.0	1.207e-61
UNY990P	contig_1	88865	89873	1008	renamed_GCF_000008685.2	chromosome	814697	813689	1008	99.4	2.823e-213
UNY990P	contig_1	90351	91152	801	renamed_GCF_000008685.2	chromosome	813239	812438	801	100.0	9.279e-174
UNY990P	contig_1	92080	93121	1041	renamed_GCF_000008685.2	chromosome	811510	810469	1041	99.7	1.371e-235
UNY990P	contig_1	94038	95130	1092	renamed_GCF_000008685.2	chromosome	809552	808460	1092	100.0	7.863e-242
UNY990P	contig_1	95126	95615	489	renamed_GCF_000008685.2	chromosome	808464	807975	489	100.0	6.125e-101
UNY990P	contig_1	158287	157255	1032	renamed_GCF_000008685.2	chromosome	745301	746333	1032	99.7	1.233e-226
UNY990P	contig_1	160845	159072	1773	renamed_GCF_000008685.2	chromosome	742743	744516	1773	98.8	0.0
UNY990P	contig_1	162900	162162	738	renamed_GCF_000008685.2	chromosome	740687	741425	738	100.0	4.772e-162
UNY990P	contig_1	163348	163165	183	renamed_GCF_000008685.2	chromosome	740239	740422	183	98.3	8.986e-39
UNY990P	contig_1	164444	163904	540	renamed_GCF_000008685.2	chromosome	739143	739683	540	99.4	1.216e-118
UNY990P	contig_1	174922	173968	954	renamed_GCF_000008685.2	chromosome	728665	729619	954	99.0	7.226e-211
UNY990P	contig_1	177103	175834	1269	renamed_GCF_000008685.2	chromosome	726457	727753	1269	97.3	7.791e-272
UNY990P	contig_1	179364	178140	1224	renamed_GCF_000008685.2	chromosome	724223	725447	1224	99.2	1.743e-272
UNY990P	contig_1	182469	180567	1902	renamed_GCF_000008685.2	chromosome	721118	723020	1902	100.0	0.0
UNY990P	contig_1	185845	184918	927	renamed_GCF_000008685.2	chromosome	717742	718669	927	100.0	3.519e-197
UNY990P	contig_1	258936	260292	1356	renamed_GCF_000008685.2	chromosome	644650	643294	1356	99.5	1.919e-302
UNY990P	contig_1	261299	261146	153	renamed_GCF_000008685.2	chromosome	642288	642441	153	100.0	5.64e-31
UNY990P	contig_1	265008	263715	1293	renamed_GCF_000008685.2	chromosome	638579	639872	1293	100.0	3.129e-286
UNY990P	contig_1	266995	265630	1365	renamed_GCF_000008685.2	chromosome	636592	637957	1365	99.5	3.489e-297
UNY990P	contig_1	271102	269122	1980	renamed_GCF_000008685.2	chromosome	632484	634464	1980	98.9	0.0
UNY990P	contig_1	287196	287823	627	renamed_GCF_000008685.2	chromosome	616390	615763	627	99.0	6.305e-132
UNY990P	contig_1	291539	289601	1938	renamed_GCF_000008685.2	chromosome	612047	613985	1938	100.0	0.0
UNY990P	contig_1	292393	293644	1251	renamed_GCF_000008685.2	chromosome	611193	609942	1251	99.2	1.724e-268
UNY990P	contig_1	296603	298808	2205	renamed_GCF_000008685.2	chromosome	606983	604778	2205	99.4	0.0
UNY990P	contig_1	342838	345565	2727	renamed_GCF_000008685.2	chromosome	560732	558005	2727	99.2	0.0
UNY990P	contig_1	345546	346164	618	renamed_GCF_000008685.2	chromosome	558024	557406	618	99.5	1.337e-130
UNY990P	contig_1	346147	346885	738	renamed_GCF_000008685.2	chromosome	557423	556562	738	84.6	1.11e-152
UNY990P	contig_1	359611	358837	774	renamed_GCF_000008685.2	chromosome	543831	544605	774	100.0	1.787e-170
UNY990P	contig_1	361180	360418	762	renamed_GCF_000008685.2	chromosome	542262	543024	762	99.6	1.226e-172
UNY990P	contig_1	365923	365134	789	renamed_GCF_000008685.2	chromosome	537543	538308	789	99.2	6.654e-167
UNY990P	contig_1	367842	368265	423	renamed_GCF_000008685.2	chromosome	535600	535177	423	100.0	5.606e-91
UNY990P	contig_1	388915	387655	1260	renamed_GCF_000008685.2	chromosome	514523	515783	1260	99.2	6.007e-282
UNY990P	contig_1	390299	391046	747	renamed_GCF_000008685.2	chromosome	513139	512392	747	99.5	3.599e-158
UNY990P	contig_1	417888	417360	528	renamed_GCF_000008685.2	chromosome	485549	486077	528	100.0	1.004e-118
UNY990P	contig_1	419151	418851	300	renamed_GCF_000008685.2	chromosome	484286	484586	300	100.0	5.976e-62
UNY990P	contig_1	421380	422094	714	renamed_GCF_000008685.2	chromosome	482057	481343	714	100.0	3.944e-160
UNY990P	contig_1	433768	434044	276	renamed_GCF_000008685.2	chromosome	469665	469389	276	98.9	1.819e-54
UNY990P	contig_1	436155	437916	1761	renamed_GCF_000008685.2	chromosome	467278	465517	1761	100.0	0.0
UNY990P	contig_1	441389	440660	729	renamed_GCF_000008685.2	chromosome	462044	462773	729	99.1	5.489e-159
UNY990P	contig_1	443382	443022	360	renamed_GCF_000008685.2	chromosome	460051	460411	360	99.1	5.311e-73
UNY990P	contig_1	455579	455261	318	renamed_GCF_000008685.2	chromosome	447854	448172	318	99.0	4.406e-68
UNY990P	contig_1	456559	457108	549	renamed_GCF_000008685.2	chromosome	446875	446326	549	99.4	4.738e-122
UNY990P	contig_1	460889	461729	840	renamed_GCF_000008685.2	chromosome	442552	441712	840	98.9	7.382e-183
UNY990P	contig_1	514966	515629	663	renamed_GCF_000008685.2	chromosome	388480	387817	663	99.0	2.698e-147
UNY990P	contig_1	517288	516109	1179	renamed_GCF_000008685.2	chromosome	386158	387337	1179	99.7	9.776e-263
UNY990P	contig_1	517998	517284	714	renamed_GCF_000008685.2	chromosome	385448	386162	714	100.0	3.427e-153
UNY990P	contig_1	532413	530400	2013	renamed_GCF_000008685.2	chromosome	371033	373046	2013	99.4	0.0
UNY990P	contig_1	534562	533419	1143	renamed_GCF_000008685.2	chromosome	368884	370027	1143	98.9	1.738e-241
UNY990P	contig_1	537843	538332	489	renamed_GCF_000008685.2	chromosome	365603	365114	489	100.0	3.787e-106
UNY990P	contig_1	552118	552394	276	renamed_GCF_000008685.2	chromosome	351331	351055	276	96.7	4.486e-53
UNY990P	contig_1	553839	555297	1458	renamed_GCF_000008685.2	chromosome	349610	348152	1458	99.3	5e-324
UNY990P	contig_1	580593	581400	807	renamed_GCF_000008685.2	chromosome	322846	322039	807	99.6	2.064e-174
UNY990P	contig_1	582088	581401	687	renamed_GCF_000008685.2	chromosome	321351	322038	687	100.0	1.336e-150
UNY990P	contig_1	583131	582087	1044	renamed_GCF_000008685.2	chromosome	320308	321352	1044	99.4	3.304e-226
UNY990P	contig_1	583181	583760	579	renamed_GCF_000008685.2	chromosome	320249	319679	579	99.4	6.936e-123
UNY990P	contig_1	583803	584334	531	renamed_GCF_000008685.2	chromosome	319636	319105	531	100.0	1.699e-113
UNY990P	contig_1	584323	585163	840	renamed_GCF_000008685.2	chromosome	319116	318276	840	99.2	4.393e-180
UNY990P	contig_1	594923	596123	1200	renamed_GCF_000008685.2	chromosome	308517	307317	1200	99.7	1.629e-260
UNY990P	contig_1	596123	596816	693	renamed_GCF_000008685.2	chromosome	307317	306624	693	100.0	2.971e-151
UNY990P	contig_1	596822	597770	948	renamed_GCF_000008685.2	chromosome	306615	305670	948	100.0	3.249e-210
UNY990P	contig_1	597779	598328	549	renamed_GCF_000008685.2	chromosome	305661	305112	549	100.0	9.24e-115
UNY990P	contig_1	614477	615242	765	renamed_GCF_000008685.2	chromosome	288946	288181	765	99.6	5.507e-165
UNY990P	contig_1	615546	616335	789	renamed_GCF_000008685.2	chromosome	287877	287088	789	98.8	2.148e-162
UNY990P	contig_1	617464	619555	2091	renamed_GCF_000008685.2	chromosome	285962	283868	2091	99.7	0.0
UNY990P	contig_1	630743	632936	2193	renamed_GCF_000008685.2	chromosome	272641	270487	2193	99.3	0.0
UNY990P	contig_1	637317	636372	945	renamed_GCF_000008685.2	chromosome	266106	267051	945	100.0	6.277e-211
UNY990P	contig_1	639711	642132	2421	renamed_GCF_000008685.2	chromosome	263712	261291	2421	99.8	0.0
UNY990P	contig_1	646961	644438	2523	renamed_GCF_000008685.2	chromosome	256462	258985	2523	99.6	0.0
UNY990P	contig_1	658709	659480	771	renamed_GCF_000008685.2	chromosome	244713	243942	771	99.2	1.016e-167
UNY990P	contig_1	661133	663140	2007	renamed_GCF_000008685.2	chromosome	242289	240282	2007	99.1	0.0
UNY990P	contig_1	716237	715844	393	renamed_GCF_000008685.2	chromosome	186553	186946	393	100.0	5.626e-86
UNY990P	contig_1	719905	719410	495	renamed_GCF_000008685.2	chromosome	182885	183380	495	100.0	9.271e-106
UNY990P	contig_1	721385	723251	1866	renamed_GCF_000008685.2	chromosome	181405	179539	1866	99.3	0.0
UNY990P	contig_1	723930	724923	993	renamed_GCF_000008685.2	chromosome	178860	177867	993	100.0	4.528e-214
UNY990P	contig_1	727706	728693	987	renamed_GCF_000008685.2	chromosome	174970	174097	987	98.2	2.044e-187
UNY990P	contig_1	729210	731259	2049	renamed_GCF_000008685.2	chromosome	173535	171531	2049	99.2	0.0
UNY990P	contig_1	731693	732071	378	renamed_GCF_000008685.2	chromosome	171097	170719	378	98.4	1.768e-79
UNY990P	contig_1	733392	734913	1521	renamed_GCF_000008685.2	chromosome	169399	167878	1521	99.2	0.0
UNY990P	contig_1	736904	737891	987	renamed_GCF_000008685.2	chromosome	165887	164900	987	99.6	2.948e-209
UNY990P	contig_1	838755	837516	1239	renamed_GCF_000008685.2	chromosome	64037	65276	1239	100.0	5.707e-279
UNY990P	contig_1	841541	842231	690	renamed_GCF_000008685.2	chromosome	61257	60567	690	98.6	3.759e-148
UNY990P	contig_1	842759	843698	939	renamed_GCF_000008685.2	chromosome	60039	59100	939	99.6	9.091e-206
UNY990P	contig_1	866959	868759	1800	renamed_GCF_000008685.2	chromosome	35836	34036	1800	100.0	0.0
UNY990P	contig_1	870706	871246	540	renamed_GCF_000008685.2	chromosome	32089	31549	540	100.0	3.274e-116
UNY990P	contig_1	873253	871780	1473	renamed_GCF_000008685.2	chromosome	29542	31015	1473	99.5	0.0
UNY990P	contig_1	874305	874941	636	renamed_GCF_000008685.2	chromosome	28490	27854	636	99.5	4.12e-138
UNY990P	contig_2	6336	7434	1098	renamed_GCF_000008685.2	cp26	4768	5866	1098	98.9	5.441e-247
UNY990P	contig_2	9403	10333	930	renamed_GCF_000008685.2	cp26	7835	8765	930	97.7	5.152e-202
UNY990P	contig_2	23402	22916	486	renamed_GCF_000008685.2	cp26	21833	21338	486	100.0	3.279e-107
UNY990P	contig_11	17075	15965	1110	renamed_GCF_000008685.2	lp28-4	10814	11927	1110	99.1	2.455e-249
UNY990P	contig_11	22847	22628	219	renamed_GCF_000008685.2	lp28-4	5127	5346	219	100.0	1.443e-47
UNY990P	contig_11	25439	24623	816	renamed_GCF_000008685.2	lp28-4	2535	3351	816	100.0	8.08e-178
UNY990P	contig_12	14255	13697	558	renamed_GCF_000008685.2	lp28-1	7869	7353	558	99.4	8.805e-117
UNY990P	contig_14	18094	17590	504	renamed_GCF_000008685.2	lp56	3622	4108	504	93.0	3.962e-83
UNY990P	contig_14	21201	20307	894	renamed_GCF_000008685.2	lp28-2	115	1009	894	99.6	6.773e-193
UNY990P	contig_15	17651	18578	927	renamed_GCF_000008685.2	lp36	15760	14833	927	99.0	6.865e-207
UNY990P	contig_15	18570	19110	540	renamed_GCF_000008685.2	lp36	14841	14301	540	98.3	5.467e-119
UNY990P	contig_15	20810	20174	636	renamed_GCF_000008685.2	lp36	12601	13237	636	100.0	3.41e-140
UNY990P	contig_17	6454	7210	756	renamed_GCF_000008685.2	lp54	47228	46472	756	98.8	2.594e-163
UNY990P	contig_17	8791	10027	1236	renamed_GCF_000008685.2	lp54	45947	44711	1236	98.7	3.997e-265
UNY990P	contig_17	11218	12127	909	renamed_GCF_000008685.2	lp54	43532	42623	909	100.0	1.089e-198
UNY990P	contig_17	12731	13355	624	renamed_GCF_000008685.2	lp54	42019	41395	624	100.0	3.1e-139
UNY990P	contig_17	22478	21989	489	renamed_GCF_000008685.2	lp54	32260	32749	489	100.0	3.125e-108
UNY990P	contig_17	24029	22958	1071	renamed_GCF_000008685.2	lp54	30709	31780	1071	99.7	4.869e-235
UNY990P	contig_17	25804	25351	453	renamed_GCF_000008685.2	lp54	28934	29387	453	100.0	2.51e-96
UNY990P	contig_17	27349	26740	609	renamed_GCF_000008685.2	lp54	27389	27998	609	100.0	2.346e-131
UNY990P	contig_1	1785	360	1425	renamed_GCF_000008685.2	chromosome	901833	903258	1425	99.7	1.327e-309
UNY990P	contig_1	5923	6523	600	renamed_GCF_000008685.2	chromosome	897695	897095	600	99.4	6.881e-135
UNY990P	contig_1	10490	7049	3441	renamed_GCF_000008685.2	chromosome	893128	896569	3441	98.6	0.0
UNY990P	contig_1	17171	19391	2220	renamed_GCF_000008685.2	chromosome	886447	884227	2220	99.3	0.0
UNY990P	contig_1	22527	23352	825	renamed_GCF_000008685.2	chromosome	881091	880266	825	100.0	2.882e-182
UNY990P	contig_1	27190	24337	2853	renamed_GCF_000008685.2	chromosome	876491	879281	2853	99.6	0.0
UNY990P	contig_1	28486	31033	2547	renamed_GCF_000008685.2	chromosome	875132	872585	2547	99.8	0.0
UNY990P	contig_1	33595	34111	516	renamed_GCF_000008685.2	chromosome	870023	869507	516	100.0	1.621e-111
UNY990P	contig_1	35424	34878	546	renamed_GCF_000008685.2	chromosome	868194	868740	546	99.4	4.105e-123
UNY990P	contig_1	84958	84646	312	renamed_GCF_000008685.2	chromosome	818604	818916	312	100.0	1.086e-65
UNY990P	contig_1	86167	85606	561	renamed_GCF_000008685.2	chromosome	817395	817956	561	100.0	3.237e-128
UNY990P	contig_1	87263	88061	798	renamed_GCF_000008685.2	chromosome	816299	815501	798	100.0	1.968e-173
UNY990P	contig_1	100423	100753	330	renamed_GCF_000008685.2	chromosome	803167	802837	330	100.0	2.178e-69
UNY990P	contig_1	102581	101813	768	renamed_GCF_000008685.2	chromosome	801118	801778	768	98.6	1.322e-138
UNY990P	contig_1	103316	104384	1068	renamed_GCF_000008685.2	chromosome	800275	799207	1068	99.1	2.021e-244
UNY990P	contig_1	105543	106473	930	renamed_GCF_000008685.2	chromosome	798048	797118	930	100.0	3.063e-199
UNY990P	contig_1	120340	120613	273	renamed_GCF_000008685.2	chromosome	783248	782975	273	100.0	3.858e-54
UNY990P	contig_1	124831	122203	2628	renamed_GCF_000008685.2	chromosome	778757	781385	2628	99.2	0.0
UNY990P	contig_1	172404	171867	537	renamed_GCF_000008685.2	chromosome	731183	731720	537	100.0	1.936e-121
UNY990P	contig_1	173975	173081	894	renamed_GCF_000008685.2	chromosome	729612	730506	894	97.9	8.157e-191
UNY990P	contig_1	188821	189484	663	renamed_GCF_000008685.2	chromosome	714766	714103	663	98.1	7.961e-144
UNY990P	contig_1	190337	191384	1047	renamed_GCF_000008685.2	chromosome	713250	712203	1047	99.7	8.437e-225
UNY990P	contig_1	192378	191937	441	renamed_GCF_000008685.2	chromosome	711210	711651	441	100.0	1.245e-93
UNY990P	contig_1	196916	194321	2595	renamed_GCF_000008685.2	chromosome	706672	709267	2595	99.5	0.0
UNY990P	contig_1	206144	206831	687	renamed_GCF_000008685.2	chromosome	697437	696750	687	99.5	1.468e-149
UNY990P	contig_1	208059	208890	831	renamed_GCF_000008685.2	chromosome	695523	694692	831	100.0	5.839e-184
UNY990P	contig_1	210954	210054	900	renamed_GCF_000008685.2	chromosome	692628	693528	900	99.6	4.423e-190
UNY990P	contig_1	213080	212783	297	renamed_GCF_000008685.2	chromosome	690481	690799	297	98.9	6.955e-60
UNY990P	contig_1	257985	258450	465	renamed_GCF_000008685.2	chromosome	645601	645136	465	99.3	2.067e-100
UNY990P	contig_1	272818	271600	1218	renamed_GCF_000008685.2	chromosome	630795	631986	1218	99.4	4.366e-261
UNY990P	contig_1	274638	276495	1857	renamed_GCF_000008685.2	chromosome	628948	627091	1857	99.1	0.0
UNY990P	contig_1	280136	278579	1557	renamed_GCF_000008685.2	chromosome	623450	625007	1557	98.4	0.0
UNY990P	contig_1	281633	282542	909	renamed_GCF_000008685.2	chromosome	621953	621044	909	99.3	3.709e-202
UNY990P	contig_1	284759	282551	2208	renamed_GCF_000008685.2	chromosome	618827	621035	2208	99.8	0.0
UNY990P	contig_1	301213	299857	1356	renamed_GCF_000008685.2	chromosome	602373	603729	1356	99.3	5.612e-299
UNY990P	contig_1	304092	302742	1350	renamed_GCF_000008685.2	chromosome	599494	600844	1350	100.0	3.989e-293
UNY990P	contig_1	307056	304995	2061	renamed_GCF_000008685.2	chromosome	596530	598591	2061	100.0	0.0
UNY990P	contig_1	311099	307655	3444	renamed_GCF_000008685.2	chromosome	592445	595931	3444	99.4	0.0
UNY990P	contig_1	313373	313898	525	renamed_GCF_000008685.2	chromosome	590208	589683	525	97.7	3.018e-106
UNY990P	contig_1	326401	327007	606	renamed_GCF_000008685.2	chromosome	577187	576581	606	99.5	1.106e-130
UNY990P	contig_1	327772	328315	543	renamed_GCF_000008685.2	chromosome	575816	575273	543	99.4	3.433e-116
UNY990P	contig_1	329848	331699	1851	renamed_GCF_000008685.2	chromosome	573740	571889	1851	100.0	0.0
UNY990P	contig_1	334030	332308	1722	renamed_GCF_000008685.2	chromosome	569558	571280	1722	100.0	0.0
UNY990P	contig_1	335318	334448	870	renamed_GCF_000008685.2	chromosome	568269	569139	870	100.0	1.737e-195
UNY990P	contig_1	349456	348235	1221	renamed_GCF_000008685.2	chromosome	553991	555212	1221	100.0	5.34e-268
UNY990P	contig_1	353824	354523	699	renamed_GCF_000008685.2	chromosome	549618	548919	699	100.0	1.058e-146
UNY990P	contig_1	358857	356055	2802	renamed_GCF_000008685.2	chromosome	544585	547387	2802	99.4	0.0
UNY990P	contig_1	371751	372315	564	renamed_GCF_000008685.2	chromosome	531692	531128	564	100.0	2.704e-122
UNY990P	contig_1	374245	375340	1095	renamed_GCF_000008685.2	chromosome	529198	528103	1095	99.7	1.942e-249
UNY990P	contig_1	378889	377188	1701	renamed_GCF_000008685.2	chromosome	524553	526254	1701	99.4	0.0
UNY990P	contig_1	396437	396059	378	renamed_GCF_000008685.2	chromosome	507001	507379	378	100.0	8.763e-79
UNY990P	contig_1	396568	396454	114	renamed_GCF_000008685.2	chromosome	506864	506984	114	100.0	7.638e-22
UNY990P	contig_1	398335	397897	438	renamed_GCF_000008685.2	chromosome	505103	505541	438	100.0	1.186e-93
UNY990P	contig_1	399513	399153	360	renamed_GCF_000008685.2	chromosome	503925	504285	360	100.0	4.361e-75
UNY990P	contig_1	400488	400089	399	renamed_GCF_000008685.2	chromosome	502950	503349	399	100.0	3.071e-85
UNY990P	contig_1	405544	405247	297	renamed_GCF_000008685.2	chromosome	497894	498191	297	100.0	5.69e-62
UNY990P	contig_1	519284	520052	768	renamed_GCF_000008685.2	chromosome	384162	383394	768	99.6	9.689e-168
UNY990P	contig_1	520064	521537	1473	renamed_GCF_000008685.2	chromosome	383382	381909	1473	100.0	0.0
UNY990P	contig_1	521554	522892	1338	renamed_GCF_000008685.2	chromosome	381892	380554	1338	99.7	6.95e-311
UNY990P	contig_1	522888	524106	1218	renamed_GCF_000008685.2	chromosome	380558	379340	1218	99.2	4.24e-270
UNY990P	contig_1	524116	526408	2292	renamed_GCF_000008685.2	chromosome	379258	377038	2292	98.3	0.0
UNY990P	contig_1	526427	527486	1059	renamed_GCF_000008685.2	chromosome	377019	375960	1059	97.4	3.805e-227
UNY990P	contig_1	527786	527507	279	renamed_GCF_000008685.2	chromosome	375660	375939	279	98.9	3.477e-56
UNY990P	contig_1	529170	527793	1377	renamed_GCF_000008685.2	chromosome	374276	375653	1377	99.3	3.407e-308
UNY990P	contig_1	529295	529880	585	renamed_GCF_000008685.2	chromosome	374151	373566	585	97.9	1.275e-125
UNY990P	contig_1	539329	541129	1800	renamed_GCF_000008685.2	chromosome	364117	362317	1800	99.4	0.0
UNY990P	contig_1	563109	562188	921	renamed_GCF_000008685.2	chromosome	340340	341261	921	99.0	7.121e-197
UNY990P	contig_1	565092	563466	1626	renamed_GCF_000008685.2	chromosome	338357	339983	1626	99.6	0.0
UNY990P	contig_1	568500	566928	1572	renamed_GCF_000008685.2	chromosome	334936	336508	1572	99.8	0.0
UNY990P	contig_1	568921	569818	897	renamed_GCF_000008685.2	chromosome	334515	333618	897	100.0	1.666e-200
UNY990P	contig_1	569838	572634	2796	renamed_GCF_000008685.2	chromosome	333598	330802	2796	100.0	0.0
UNY990P	contig_1	572684	573794	1110	renamed_GCF_000008685.2	chromosome	330752	329642	1110	99.7	1.105e-249
UNY990P	contig_1	574175	573815	360	renamed_GCF_000008685.2	chromosome	329261	329621	360	100.0	1.609e-77
UNY990P	contig_1	575408	574271	1137	renamed_GCF_000008685.2	chromosome	328031	329165	1137	99.4	6.912e-251
UNY990P	contig_1	585434	586193	759	renamed_GCF_000008685.2	chromosome	318005	317246	759	100.0	1.223e-163
UNY990P	contig_1	604664	605975	1311	renamed_GCF_000008685.2	chromosome	298776	297465	1311	99.5	1.7e-287
UNY990P	contig_1	605971	606403	432	renamed_GCF_000008685.2	chromosome	297469	297037	432	99.3	2.176e-94
UNY990P	contig_1	606395	607013	618	renamed_GCF_000008685.2	chromosome	297045	296427	618	99.5	5.47e-132
UNY990P	contig_1	607020	608199	1179	renamed_GCF_000008685.2	chromosome	296420	295241	1179	98.9	2.863e-259
UNY990P	contig_1	608212	608656	444	renamed_GCF_000008685.2	chromosome	295228	294784	444	100.0	1.185e-94
UNY990P	contig_1	608660	609989	1329	renamed_GCF_000008685.2	chromosome	294780	293451	1329	99.7	1.183e-294
UNY990P	contig_1	610011	610236	225	renamed_GCF_000008685.2	chromosome	293429	293204	225	100.0	8.8e-46
UNY990P	contig_1	610232	611015	783	renamed_GCF_000008685.2	chromosome	293208	292425	783	100.0	6.057e-167
UNY990P	contig_1	611014	611797	783	renamed_GCF_000008685.2	chromosome	292426	291643	783	100.0	1.874e-171
UNY990P	contig_1	620736	621624	888	renamed_GCF_000008685.2	chromosome	282687	281799	888	100.0	4.025e-189
UNY990P	contig_1	650265	648492	1773	renamed_GCF_000008685.2	chromosome	253158	254931	1773	99.6	0.0
UNY990P	contig_1	650990	650384	606	renamed_GCF_000008685.2	chromosome	252433	253039	606	100.0	4.115e-133
UNY990P	contig_1	651186	652212	1026	renamed_GCF_000008685.2	chromosome	252237	251211	1026	99.4	1.351e-224
UNY990P	contig_1	652212	652767	555	renamed_GCF_000008685.2	chromosome	251211	250656	555	100.0	3.12e-119
UNY990P	contig_1	652753	653248	495	renamed_GCF_000008685.2	chromosome	250670	250175	495	100.0	5.051e-104
UNY990P	contig_1	654897	653334	1563	renamed_GCF_000008685.2	chromosome	248505	250089	1563	99.6	0.0
UNY990P	contig_1	656827	655321	1506	renamed_GCF_000008685.2	chromosome	246596	248102	1506	100.0	0.0
UNY990P	contig_1	657634	656869	765	renamed_GCF_000008685.2	chromosome	245789	246554	765	100.0	7.663e-170
UNY990P	contig_1	658043	658646	603	renamed_GCF_000008685.2	chromosome	245382	244776	603	99.0	3.924e-133
UNY990P	contig_1	671085	668169	2916	renamed_GCF_000008685.2	chromosome	232337	235253	2916	99.2	0.0
UNY990P	contig_1	694154	694691	537	renamed_GCF_000008685.2	chromosome	208581	208083	537	98.7	8.112e-106
UNY990P	contig_1	696245	694694	1551	renamed_GCF_000008685.2	chromosome	206528	208106	1551	99.6	0.0
UNY990P	contig_1	697701	696729	972	renamed_GCF_000008685.2	chromosome	205174	206044	972	99.6	3.289e-188
UNY990P	contig_1	698637	697701	936	renamed_GCF_000008685.2	chromosome	204136	205072	936	100.0	4.7e-204
UNY990P	contig_1	699924	698685	1239	renamed_GCF_000008685.2	chromosome	202849	204088	1239	100.0	5.514e-262
UNY990P	contig_1	700195	701722	1527	renamed_GCF_000008685.2	chromosome	202578	201051	1527	99.6	0.0
UNY990P	contig_1	701723	702809	1086	renamed_GCF_000008685.2	chromosome	201050	199964	1086	99.7	1.322e-243
UNY990P	contig_1	707097	705093	2004	renamed_GCF_000008685.2	chromosome	195692	197696	2004	99.7	0.0
UNY990P	contig_1	757330	758203	873	renamed_GCF_000008685.2	chromosome	145458	144585	873	100.0	2.787e-199
UNY990P	contig_1	758522	759845	1323	renamed_GCF_000008685.2	chromosome	144230	142943	1323	99.5	3.887e-280
UNY990P	contig_1	759856	760810	954	renamed_GCF_000008685.2	chromosome	142932	141978	954	99.0	8.218e-201
UNY990P	contig_1	764045	764357	312	renamed_GCF_000008685.2	chromosome	138745	138433	312	98.0	5.387e-65
UNY990P	contig_1	765025	766918	1893	renamed_GCF_000008685.2	chromosome	137766	135873	1893	100.0	0.0
UNY990P	contig_1	768817	766927	1890	renamed_GCF_000008685.2	chromosome	133974	135864	1890	99.6	0.0
UNY990P	contig_1	768946	770320	1374	renamed_GCF_000008685.2	chromosome	133842	132471	1374	100.0	2.538e-302
UNY990P	contig_1	771494	770366	1128	renamed_GCF_000008685.2	chromosome	131297	132425	1128	99.7	1.76e-247
UNY990P	contig_1	782204	782987	783	renamed_GCF_000008685.2	chromosome	120589	119806	783	98.4	6.057e-167
UNY990P	contig_1	782990	783830	840	renamed_GCF_000008685.2	chromosome	119803	118963	840	96.0	7.682e-174
UNY990P	contig_1	783864	784419	555	renamed_GCF_000008685.2	chromosome	118929	118374	555	99.4	3.776e-117
UNY990P	contig_1	784423	785116	693	renamed_GCF_000008685.2	chromosome	118370	117677	693	98.6	6.012e-152
UNY990P	contig_1	785987	787289	1302	renamed_GCF_000008685.2	chromosome	116806	115504	1302	98.3	5.194e-282
UNY990P	contig_1	787987	787285	702	renamed_GCF_000008685.2	chromosome	114806	115508	702	99.5	2.35e-155
UNY990P	contig_1	788190	789885	1695	renamed_GCF_000008685.2	chromosome	114603	112908	1695	100.0	0.0
UNY990P	contig_1	790025	790445	420	renamed_GCF_000008685.2	chromosome	112769	112349	420	98.5	7.151e-88
UNY990P	contig_1	790456	790906	450	renamed_GCF_000008685.2	chromosome	112338	111888	450	99.3	9.762e-98
UNY990P	contig_1	801454	802048	594	renamed_GCF_000008685.2	chromosome	101339	100745	594	100.0	6.255e-135
UNY990P	contig_1	802566	802044	522	renamed_GCF_000008685.2	chromosome	100227	100749	522	97.1	3.966e-111
UNY990P	contig_1	803977	802588	1389	renamed_GCF_000008685.2	chromosome	98816	100205	1389	99.5	2.596e-313
UNY990P	contig_1	804012	804930	918	renamed_GCF_000008685.2	chromosome	98648	97862	918	99.2	2.569e-173
UNY990P	contig_1	804926	805850	924	renamed_GCF_000008685.2	chromosome	97866	96942	924	99.6	3.896e-204
UNY990P	contig_1	805839	808182	2343	renamed_GCF_000008685.2	chromosome	96953	94610	2343	99.3	0.0
UNY990P	contig_1	808187	808574	387	renamed_GCF_000008685.2	chromosome	94605	94218	387	100.0	1.031e-86
UNY990P	contig_1	808760	809360	600	renamed_GCF_000008685.2	chromosome	94032	93432	600	99.4	7.27e-126
UNY990P	contig_1	809369	809915	546	renamed_GCF_000008685.2	chromosome	93423	92877	546	98.8	2.975e-118
UNY990P	contig_1	823441	823792	351	renamed_GCF_000008685.2	chromosome	79322	79001	351	100.0	3.732e-67
UNY990P	contig_1	823784	825083	1299	renamed_GCF_000008685.2	chromosome	79009	77710	1299	99.5	4.523e-283
UNY990P	contig_1	826343	825092	1251	renamed_GCF_000008685.2	chromosome	76450	77701	1251	99.7	1.89e-267
UNY990P	contig_1	827020	826339	681	renamed_GCF_000008685.2	chromosome	75773	76454	681	100.0	3.584e-147
UNY990P	contig_1	830146	829300	846	renamed_GCF_000008685.2	chromosome	72646	73492	846	98.9	1.418e-176
UNY990P	contig_1	831592	830182	1410	renamed_GCF_000008685.2	chromosome	71200	72610	1410	99.7	5.687e-308
UNY990P	contig_1	832422	831573	849	renamed_GCF_000008685.2	chromosome	70141	71219	849	99.2	1.08e-188
UNY990P	contig_1	843761	844769	1008	renamed_GCF_000008685.2	chromosome	58982	58028	1008	99.6	2.659e-205
UNY990P	contig_1	853537	854194	657	renamed_GCF_000008685.2	chromosome	49259	48602	657	98.1	5.738e-138
UNY990P	contig_1	854892	854190	702	renamed_GCF_000008685.2	chromosome	47916	48606	702	99.5	2.243e-147
UNY990P	contig_1	855630	854955	675	renamed_GCF_000008685.2	chromosome	47166	47841	675	100.0	3.937e-145
UNY990P	contig_1	856417	856786	369	renamed_GCF_000008685.2	chromosome	46379	46010	369	100.0	3.085e-80
UNY990P	contig_1	857351	856805	546	renamed_GCF_000008685.2	chromosome	45445	45991	546	100.0	3.273e-117
UNY990P	contig_1	857442	859890	2448	renamed_GCF_000008685.2	chromosome	45354	42906	2448	99.7	0.0
UNY990P	contig_1	859915	860317	402	renamed_GCF_000008685.2	chromosome	42881	42479	402	100.0	2.405e-88
UNY990P	contig_1	861363	862035	672	renamed_GCF_000008685.2	chromosome	41432	40760	672	100.0	1.856e-144
UNY990P	contig_1	862970	862118	852	renamed_GCF_000008685.2	chromosome	39825	40677	852	99.6	5.092e-189
UNY990P	contig_1	874930	875362	432	renamed_GCF_000008685.2	chromosome	27865	27433	432	100.0	2.641e-92
UNY990P	contig_1	894368	893597	771	renamed_GCF_000008685.2	chromosome	8426	9197	771	100.0	1.781e-161
UNY990P	contig_1	894479	895337	858	renamed_GCF_000008685.2	chromosome	8315	7457	858	99.6	1.438e-195
UNY990P	contig_1	895397	896486	1089	renamed_GCF_000008685.2	chromosome	7397	6308	1089	100.0	1.828e-240
UNY990P	contig_1	896488	897544	1056	renamed_GCF_000008685.2	chromosome	6306	5250	1056	99.4	3.853e-235
UNY990P	contig_1	899400	897606	1794	renamed_GCF_000008685.2	chromosome	3418	5188	1794	98.6	0.0
UNY990P	contig_1	900999	902028	1029	renamed_GCF_000008685.2	chromosome	1796	767	1029	99.1	5.811e-226
UNY990P	contig_1	902719	902146	573	renamed_GCF_000008685.2	chromosome	104	677	573	99.4	1.938e-127
UNY990P	contig_2	31	1525	1494	renamed_GCF_000008685.2	cp26	24824	26453	1494	99.7	0.0
UNY990P	contig_3	6578	7034	456	renamed_GCF_000008685.2	cp32-1	4941	5397	456	98.0	5.86e-96
UNY990P	contig_3	7033	7417	384	renamed_GCF_000008685.2	cp32-9	5412	5796	384	100.0	2.931e-83
UNY990P	contig_3	7790	8357	567	renamed_GCF_000008685.2	lp56	9623	10190	567	98.9	1.159e-123
UNY990P	contig_3	8337	9450	1113	renamed_GCF_000008685.2	lp56	10170	11283	1113	98.1	2.209e-242
UNY990P	contig_3	9909	10365	456	renamed_GCF_000008685.2	cp32-4	8281	8737	456	98.6	9.757e-99
UNY990P	contig_3	10361	10598	237	renamed_GCF_000008685.2	cp32-4	8733	8970	237	100.0	1.76e-48
UNY990P	contig_4	10373	10610	237	renamed_GCF_000008685.2	lp56	12192	12429	237	100.0	1.76e-48
UNY990P	contig_4	14131	14464	333	renamed_GCF_000008685.2	cp32-3	12494	12827	333	100.0	8.424e-72
UNY990P	contig_4	14460	15336	876	renamed_GCF_000008685.2	cp32-3	12823	13699	876	100.0	5.609e-192
UNY990P	contig_5	17568	18519	951	renamed_GCF_000008685.2	cp32-6	10961	11912	951	99.6	1.057e-214
UNY990P	contig_5	18536	19091	555	renamed_GCF_000008685.2	cp32-6	11929	12484	555	98.3	3.776e-117
UNY990P	contig_5	20334	20940	606	renamed_GCF_000008685.2	cp32-8	13708	14314	606	99.5	2.704e-129
UNY990P	contig_6	14139	14472	333	renamed_GCF_000008685.2	cp32-4	12447	12780	333	100.0	8.424e-72
UNY990P	contig_6	14468	15344	876	renamed_GCF_000008685.2	cp32-1	12823	13699	876	100.0	5.609e-192
UNY990P	contig_6	15353	15959	606	renamed_GCF_000008685.2	lp56	17207	17813	606	99.5	2.704e-129
UNY990P	contig_6	16854	17058	204	renamed_GCF_000008685.2	lp56	18712	18916	204	100.0	2.578e-39
UNY990P	contig_6	27435	26658	777	renamed_GCF_000008685.2	lp56	29506	28729	777	97.6	2.057e-169
UNY990P	contig_7	7386	6270	1116	renamed_GCF_000008685.2	cp9	162	1272	1116	87.8	2.1e-217
UNY990P	contig_8	834	1188	354	renamed_GCF_000008685.2	lp5	743	1097	354	99.1	3.585e-76
UNY990P	contig_8	1256	1625	369	renamed_GCF_000008685.2	lp5	1207	1576	369	97.5	1.687e-78
UNY990P	contig_8	4296	4980	684	renamed_GCF_000008685.2	lp17	5055	5739	684	99.5	1.274e-150
UNY990P	contig_8	5694	5115	579	renamed_GCF_000008685.2	lp17	6452	5873	579	98.9	5.735e-125
UNY990P	contig_8	7023	7350	327	renamed_GCF_000008685.2	lp17	7784	8111	327	99.0	2.291e-68
UNY990P	contig_10	4217	395	3822	renamed_GCF_000008685.2	lp28-3	7728	3891	3822	87.5	0.0
UNY990P	contig_10	13986	13371	615	renamed_GCF_000008685.2	lp28-3	10516	9847	615	91.8	2.251e-124
UNY990P	contig_11	224	1118	894	renamed_GCF_000008685.2	lp36	187	1081	894	98.9	4.028e-190
UNY990P	contig_11	4960	5797	837	renamed_GCF_000008685.2	lp28-4	22931	22094	837	99.2	3.479e-182
UNY990P	contig_11	8707	9373	666	renamed_GCF_000008685.2	lp28-4	19183	18517	666	99.5	1.537e-145
UNY990P	contig_12	23013	22014	999	renamed_GCF_000008685.2	lp28-1	466	1465	999	99.6	3.433e-218
UNY990P	contig_13	5679	5124	555	renamed_GCF_000008685.2	cp32-4	21414	21960	555	52.0	1.513e-59
UNY990P	contig_13	6526	5764	762	renamed_GCF_000008685.2	cp32-4	20608	21364	762	58.0	2.565e-95
UNY990P	contig_13	15822	15276	546	renamed_GCF_000008685.2	lp28-2	15431	14885	546	99.4	1.96e-114
UNY990P	contig_15	10309	10015	294	renamed_GCF_000008685.2	lp28-1	10895	10697	294	100.0	9.155e-41
UNY990P	contig_15	11502	11280	222	renamed_GCF_000008685.2	lp36	21911	22133	222	100.0	1.866e-45
UNY990P	contig_16	11477	10889	588	renamed_GCF_000008685.2	lp38	11105	10517	588	100.0	1.006e-128
UNY990P	contig_16	12824	12233	591	renamed_GCF_000008685.2	lp38	12452	11861	591	98.9	1.764e-131
UNY990P	contig_16	16889	17702	813	renamed_GCF_000008685.2	lp38	16519	17329	813	98.5	2.065e-175
UNY990P	contig_16	18614	19655	1041	renamed_GCF_000008685.2	lp38	18213	19254	1041	99.1	7.428e-234
UNY990P	contig_16	20401	21631	1230	renamed_GCF_000008685.2	lp38	20000	21230	1230	99.7	3.323e-266
UNY990P	contig_17	30231	29625	606	renamed_GCF_000008685.2	lp54	24497	25103	606	98.0	1.777e-125
UNY990P	contig_17	31449	33036	1587	renamed_GCF_000008685.2	lp54	23273	21683	1587	99.2	0.0
UNY990P	contig_17	34002	33807	195	renamed_GCF_000008685.2	lp54	20717	20912	195	100.0	2.214e-39
UNY990P	contig_17	36559	35965	594	renamed_GCF_000008685.2	lp54	18127	18721	594	98.9	7.995e-124
UNY990P	contig_17	38104	38668	564	renamed_GCF_000008685.2	lp54	16576	16000	564	91.8	3.333e-103
UNY990P	contig_1	46114	44704	1410	renamed_GCF_000008685.2	chromosome	857505	858915	1410	98.7	4.432e-302
UNY990P	contig_1	47631	46110	1521	renamed_GCF_000008685.2	chromosome	855988	857509	1521	99.6	0.0
UNY990P	contig_1	48751	47623	1128	renamed_GCF_000008685.2	chromosome	854868	855996	1128	96.8	1.335e-250
UNY990P	contig_1	49851	48783	1068	renamed_GCF_000008685.2	chromosome	853774	854842	1068	100.0	1.362e-231
UNY990P	contig_1	52632	51111	1521	renamed_GCF_000008685.2	chromosome	850993	852514	1521	99.6	0.0
UNY990P	contig_1	95624	96671	1047	renamed_GCF_000008685.2	chromosome	807966	806919	1047	99.7	1.181e-229
UNY990P	contig_1	108736	109729	993	renamed_GCF_000008685.2	chromosome	794855	793841	993	99.0	2.367e-221
UNY990P	contig_1	111336	111795	459	renamed_GCF_000008685.2	chromosome	792252	791793	459	99.3	2.509e-97
UNY990P	contig_1	112781	113642	861	renamed_GCF_000008685.2	chromosome	790807	789946	861	100.0	1.57e-186
UNY990P	contig_1	116729	114626	2103	renamed_GCF_000008685.2	chromosome	786859	788962	2103	99.5	0.0
UNY990P	contig_1	120199	118567	1632	renamed_GCF_000008685.2	chromosome	783389	785021	1632	99.8	0.0
UNY990P	contig_1	134117	135509	1392	renamed_GCF_000008685.2	chromosome	769470	768078	1392	100.0	1.696e-292
UNY990P	contig_1	138215	136871	1344	renamed_GCF_000008685.2	chromosome	765372	766716	1344	100.0	2.685e-305
UNY990P	contig_1	140009	139226	783	renamed_GCF_000008685.2	chromosome	763578	764361	783	100.0	1.874e-171
UNY990P	contig_1	184761	182499	2262	renamed_GCF_000008685.2	chromosome	718826	721088	2262	99.8	0.0
UNY990P	contig_1	186968	185816	1152	renamed_GCF_000008685.2	chromosome	716619	717771	1152	99.4	6.226e-246
UNY990P	contig_1	199656	198627	1029	renamed_GCF_000008685.2	chromosome	703960	704959	1029	97.8	4.554e-220
UNY990P	contig_1	200620	201304	684	renamed_GCF_000008685.2	chromosome	702951	702282	684	99.5	1.009e-144
UNY990P	contig_1	202186	201775	411	renamed_GCF_000008685.2	chromosome	701394	701805	411	97.7	3.065e-87
UNY990P	contig_1	202657	203530	873	renamed_GCF_000008685.2	chromosome	700924	700051	873	100.0	5.874e-191
UNY990P	contig_1	205996	205249	747	renamed_GCF_000008685.2	chromosome	697585	698332	747	99.1	3.778e-166
UNY990P	contig_1	230246	228809	1437	renamed_GCF_000008685.2	chromosome	673341	674778	1437	100.0	0.0
UNY990P	contig_1	238575	240408	1833	renamed_GCF_000008685.2	chromosome	665011	663178	1833	99.8	0.0
UNY990P	contig_1	296449	295651	798	renamed_GCF_000008685.2	chromosome	607137	607935	798	99.6	9.72e-173
UNY990P	contig_1	298817	299861	1044	renamed_GCF_000008685.2	chromosome	604769	603725	1044	99.7	1.577e-234
UNY990P	contig_1	316551	315699	852	renamed_GCF_000008685.2	chromosome	587030	587882	852	99.6	1.732e-192
UNY990P	contig_1	318490	317425	1065	renamed_GCF_000008685.2	chromosome	585079	586156	1065	99.4	1.659e-237
UNY990P	contig_1	320124	319749	375	renamed_GCF_000008685.2	chromosome	583457	583832	375	100.0	8.349e-79
UNY990P	contig_1	323096	321938	1158	renamed_GCF_000008685.2	chromosome	580485	581643	1158	99.4	1.942e-251
UNY990P	contig_1	325639	325327	312	renamed_GCF_000008685.2	chromosome	577949	578261	312	100.0	5.387e-65
UNY990P	contig_1	337627	335764	1863	renamed_GCF_000008685.2	chromosome	565954	567823	1863	99.0	0.0
UNY990P	contig_1	341404	339421	1983	renamed_GCF_000008685.2	chromosome	562184	564167	1983	99.8	0.0
UNY990P	contig_1	360394	359626	768	renamed_GCF_000008685.2	chromosome	543048	543816	768	100.0	8.433e-178
UNY990P	contig_1	364167	365115	948	renamed_GCF_000008685.2	chromosome	539275	538327	948	100.0	1.008e-214
UNY990P	contig_1	367739	365915	1824	renamed_GCF_000008685.2	chromosome	535703	537527	1824	99.3	0.0
UNY990P	contig_1	390213	388911	1302	renamed_GCF_000008685.2	chromosome	513225	514527	1302	100.0	1.62e-286
UNY990P	contig_1	392603	391814	789	renamed_GCF_000008685.2	chromosome	510835	511624	789	98.8	8.439e-173
UNY990P	contig_1	394569	394197	372	renamed_GCF_000008685.2	chromosome	508869	509241	372	98.3	2.155e-76
UNY990P	contig_1	396033	395640	393	renamed_GCF_000008685.2	chromosome	507405	507798	393	99.2	6.841e-84
UNY990P	contig_1	533420	532433	987	renamed_GCF_000008685.2	chromosome	370026	371013	987	98.7	1.964e-222
UNY990P	contig_1	534991	534565	426	renamed_GCF_000008685.2	chromosome	368455	368881	426	98.5	9.562e-86
UNY990P	contig_1	536486	537218	732	renamed_GCF_000008685.2	chromosome	366960	366228	732	99.1	2.589e-159
UNY990P	contig_1	538366	539317	951	renamed_GCF_000008685.2	chromosome	364972	364129	951	99.6	1.174e-187
UNY990P	contig_1	552404	553850	1446	renamed_GCF_000008685.2	chromosome	351045	349599	1446	95.4	2.012e-308
UNY990P	contig_1	555289	556099	810	renamed_GCF_000008685.2	chromosome	348160	347350	810	99.6	4.196e-184
UNY990P	contig_1	615250	615514	264	renamed_GCF_000008685.2	chromosome	288173	287909	264	100.0	2.025e-51
UNY990P	contig_1	616334	617453	1119	renamed_GCF_000008685.2	chromosome	287089	285970	1119	99.4	2.426e-242
UNY990P	contig_1	619558	620725	1167	renamed_GCF_000008685.2	chromosome	283865	282698	1167	100.0	1.172e-258
UNY990P	contig_1	632950	633751	801	renamed_GCF_000008685.2	chromosome	270473	269672	801	100.0	6.66e-169
UNY990P	contig_1	683623	682783	840	renamed_GCF_000008685.2	chromosome	219799	220639	840	100.0	1.641e-182
UNY990P	contig_1	684344	684998	654	renamed_GCF_000008685.2	chromosome	219078	218424	654	100.0	1.052e-147
UNY990P	contig_1	687996	686163	1833	renamed_GCF_000008685.2	chromosome	215426	217259	1833	99.5	0.0
UNY990P	contig_1	691474	690706	768	renamed_GCF_000008685.2	chromosome	211300	212068	768	100.0	8.822e-169
UNY990P	contig_1	714553	714967	414	renamed_GCF_000008685.2	chromosome	188237	187823	414	99.2	2.918e-88
UNY990P	contig_1	715842	715596	246	renamed_GCF_000008685.2	chromosome	186948	187194	246	100.0	9.168e-49
UNY990P	contig_1	719988	721383	1395	renamed_GCF_000008685.2	chromosome	182802	181407	1395	100.0	4.219e-300
UNY990P	contig_1	723247	723874	627	renamed_GCF_000008685.2	chromosome	179543	178916	627	98.0	3.426e-130
UNY990P	contig_1	746330	745193	1137	renamed_GCF_000008685.2	chromosome	156461	157598	1137	100.0	1.164e-253
UNY990P	contig_1	749105	749717	612	renamed_GCF_000008685.2	chromosome	153686	153074	612	100.0	4.712e-141
UNY990P	contig_1	751818	750612	1206	renamed_GCF_000008685.2	chromosome	150973	152179	1206	99.7	1.095e-274
UNY990P	contig_1	755293	756412	1119	renamed_GCF_000008685.2	chromosome	147495	146376	1119	100.0	3.727e-246
UNY990P	contig_1	835545	833223	2322	renamed_GCF_000008685.2	chromosome	67247	69569	2322	99.6	0.0
UNY990P	contig_1	837502	837040	462	renamed_GCF_000008685.2	chromosome	65290	65752	462	100.0	3.193e-95
UNY990P	contig_1	839646	838764	882	renamed_GCF_000008685.2	chromosome	63146	64028	882	99.6	6.762e-191
UNY990P	contig_1	842265	842763	498	renamed_GCF_000008685.2	chromosome	60533	60035	498	99.3	3.608e-108
UNY990P	contig_1	863157	864660	1503	renamed_GCF_000008685.2	chromosome	39638	38135	1503	100.0	0.0
UNY990P	contig_1	866186	866939	753	renamed_GCF_000008685.2	chromosome	36609	35856	753	98.0	1.62e-159
UNY990P	contig_2	22942	22435	507	renamed_GCF_000008685.2	cp26	21364	20857	507	100.0	3.123e-111
UNY990P	contig_2	23475	24171	696	renamed_GCF_000008685.2	cp26	21897	22593	696	98.2	3.76e-149
UNY990P	contig_2	24732	24180	552	renamed_GCF_000008685.2	cp26	23154	22602	552	99.4	6.616e-119
UNY990P	contig_2	24832	26077	1245	renamed_GCF_000008685.2	cp26	23254	24499	1245	99.7	2.573e-280
UNY990P	contig_3	2944	3637	693	renamed_GCF_000008685.2	lp56	35114	35807	693	96.5	7.611e-141
UNY990P	contig_3	11889	12573	684	renamed_GCF_000008685.2	lp56	13754	14438	684	96.0	4.984e-144
UNY990P	contig_4	6591	7047	456	renamed_GCF_000008685.2	cp32-7	4940	5396	456	98.0	5.86e-96
UNY990P	contig_4	7046	7430	384	renamed_GCF_000008685.2	cp32-4	5406	5790	384	100.0	2.931e-83
UNY990P	contig_4	23135	23663	528	renamed_GCF_000008685.2	cp32-1	21560	22118	528	61.8	2.482e-75
UNY990P	contig_4	23675	24233	558	renamed_GCF_000008685.2	cp32-1	22130	22763	558	73.8	1.744e-92
UNY990P	contig_4	27313	26518	795	renamed_GCF_000008685.2	cp32-4	25435	24640	795	99.2	1.418e-176
UNY990P	contig_4	27743	28346	603	renamed_GCF_000008685.2	cp32-3	26707	27298	603	52.6	1.939e-55
UNY990P	contig_4	29104	28417	687	renamed_GCF_000008685.2	cp32-6	27745	27076	687	51.6	8.829e-60
UNY990P	contig_5	8630	9197	567	renamed_GCF_000008685.2	lp56	35818	36385	567	98.4	1.159e-123
UNY990P	contig_5	9200	9968	768	renamed_GCF_000008685.2	cp32-6	2576	3344	768	97.6	9.689e-168
UNY990P	contig_5	9996	10572	576	renamed_GCF_000008685.2	cp32-4	3375	3951	576	98.4	5.468e-125
UNY990P	contig_5	10593	11553	960	renamed_GCF_000008685.2	cp32-6	3969	4929	960	99.6	2.967e-213
UNY990P	contig_5	11572	12028	456	renamed_GCF_000008685.2	cp32-6	4948	5404	456	99.3	5.32e-97
UNY990P	contig_5	12027	12411	384	renamed_GCF_000008685.2	lp56	8866	9250	384	100.0	2.931e-83
UNY990P	contig_5	12398	12788	390	renamed_GCF_000008685.2	cp32-9	5783	6173	390	100.0	3.229e-83
UNY990P	contig_5	14457	14886	429	renamed_GCF_000008685.2	lp56	11296	11725	429	100.0	5.601e-92
UNY990P	contig_5	21835	22039	204	renamed_GCF_000008685.2	cp32-3	15211	15415	204	100.0	2.578e-39
UNY990P	contig_6	18931	19375	444	renamed_GCF_000008685.2	cp32-3	17802	18249	444	81.0	1.243e-77
UNY990P	contig_6	20751	21852	1101	renamed_GCF_000008685.2	cp32-1	19113	20214	1101	92.8	3.495e-235
UNY990P	contig_6	21861	22428	567	renamed_GCF_000008685.2	cp32-6	20178	20745	567	99.4	1.456e-129
UNY990P	contig_6	22403	23144	741	renamed_GCF_000008685.2	cp32-8	20739	21480	741	99.5	5.003e-162
UNY990P	contig_6	23775	24354	579	renamed_GCF_000008685.2	cp32-8	22112	22691	579	99.4	9.224e-120
UNY990P	contig_6	24850	26176	1326	renamed_GCF_000008685.2	cp32-7	23134	24460	1326	99.0	1.737e-298
UNY990P	contig_6	26227	26653	426	renamed_GCF_000008685.2	cp32-4	24209	24635	426	98.5	8.877e-95
UNY990P	contig_8	7505	8618	1113	renamed_GCF_000008685.2	lp17	8266	9379	1113	97.8	9.945e-243
UNY990P	contig_9	31051	31759	708	renamed_GCF_000008685.2	lp28-3	2970	2259	708	96.1	7.261e-144
UNY990P	contig_10	19986	20883	897	renamed_GCF_000008685.2	lp28-3	16518	17415	897	98.6	4.063e-199
UNY990P	contig_10	20875	21442	567	renamed_GCF_000008685.2	lp28-3	17407	17974	567	98.9	5.214e-124
UNY990P	contig_10	21414	22170	756	renamed_GCF_000008685.2	lp28-3	17946	18702	756	99.2	4.353e-166
UNY990P	contig_10	22265	22895	630	renamed_GCF_000008685.2	lp28-3	18797	19427	630	99.5	4.977e-135
UNY990P	contig_10	24896	25646	750	renamed_GCF_000008685.2	lp28-3	21469	22219	750	100.0	6.33e-161
UNY990P	contig_10	26108	26381	273	renamed_GCF_000008685.2	lp28-3	22677	22953	273	100.0	7.02e-56
UNY990P	contig_10	29897	28934	963	renamed_GCF_000008685.2	lp28-3	26371	25432	963	90.6	1.699e-185
UNY990P	contig_11	12541	11362	1179	renamed_GCF_000008685.2	lp28-4	15351	16530	1179	99.4	2.454e-252
UNY990P	contig_13	11881	11452	429	renamed_GCF_000008685.2	lp28-2	11491	11062	429	99.2	1.514e-89
UNY990P	contig_13	13142	12698	444	renamed_GCF_000008685.2	lp28-2	12752	12308	444	100.0	8.866e-98
UNY990P	contig_13	13885	13546	339	renamed_GCF_000008685.2	lp28-2	13495	13156	339	98.2	8.413e-73
UNY990P	contig_13	15276	14766	510	renamed_GCF_000008685.2	lp28-2	14885	14375	510	98.2	1.964e-108
UNY990P	contig_13	24877	26344	1467	renamed_GCF_000008685.2	lp28-2	24488	25955	1467	99.5	0.0
UNY990P	contig_13	27045	27474	429	renamed_GCF_000008685.2	lp28-2	26569	27085	429	100.0	3.799e-96
UNY990P	contig_13	28418	29099	681	renamed_GCF_000008685.2	lp28-2	28030	28831	681	65.4	3.188e-97
UNY990P	contig_15	27921	27369	552	renamed_GCF_000008685.2	lp56	855	1407	552	96.7	3.6e-117
UNY990P	contig_16	6108	6876	768	renamed_GCF_000008685.2	lp38	6088	6862	768	98.4	2.711e-156
UNY990P	contig_16	9145	8869	276	renamed_GCF_000008685.2	lp38	9155	8876	276	97.8	3.31e-56
UNY990P	contig_16	22371	23409	1038	renamed_GCF_000008685.2	lp38	22042	23008	1038	98.7	2.836e-218
UNY990P	contig_16	26810	25739	1071	renamed_GCF_000008685.2	lp38	26407	25336	1071	99.4	4.869e-235
UNY990P	contig_17	26725	25807	918	renamed_GCF_000008685.2	lp54	28013	28931	918	100.0	2.109e-201
UNY990P	contig_17	40365	39819	546	renamed_GCF_000008685.2	lp54	14337	14883	546	100.0	1.338e-118
UNY990P	contig_17	41708	41123	585	renamed_GCF_000008685.2	lp54	12994	13579	585	100.0	1.763e-130
UNY990P	contig_17	44423	43532	891	renamed_GCF_000008685.2	lp54	10287	11178	891	99.3	4.629e-188
UNY990P	contig_17	46269	45843	426	renamed_GCF_000008685.2	lp54	8441	8867	426	100.0	3.21e-89
UNY990P	contig_17	47502	46467	1035	renamed_GCF_000008685.2	lp54	7208	8243	1035	100.0	8.138e-232
UNY990P	contig_17	49065	48192	873	renamed_GCF_000008685.2	lp54	5645	6518	873	100.0	2.408e-192
UNY990P	contig_17	49473	50040	567	renamed_GCF_000008685.2	lp54	5140	4666	567	91.7	2.203e-91
UNY990P	contig_1	28412	27170	1242	renamed_GCF_000008685.2	chromosome	875206	876448	1242	98.3	1.597e-276
UNY990P	contig_1	31035	33507	2472	renamed_GCF_000008685.2	chromosome	872583	870111	2472	100.0	0.0
UNY990P	contig_1	34103	34886	783	renamed_GCF_000008685.2	chromosome	869380	868732	783	99.0	4.291e-145
UNY990P	contig_1	35504	35876	372	renamed_GCF_000008685.2	chromosome	868114	867742	372	99.1	1.771e-78
UNY990P	contig_1	36938	36017	921	renamed_GCF_000008685.2	chromosome	866680	867601	921	99.3	3.387e-205
UNY990P	contig_1	37125	36924	201	renamed_GCF_000008685.2	chromosome	866493	866694	201	100.0	2.206e-40
UNY990P	contig_1	39983	38576	1407	renamed_GCF_000008685.2	chromosome	863635	865042	1407	99.5	3.133e-314
UNY990P	contig_1	43180	41845	1335	renamed_GCF_000008685.2	chromosome	860439	861774	1335	99.7	1.873e-290
UNY990P	contig_1	59109	56523	2586	renamed_GCF_000008685.2	chromosome	844453	847102	2586	96.5	0.0
UNY990P	contig_1	100792	101650	858	renamed_GCF_000008685.2	chromosome	802798	801940	858	99.2	3.799e-176
UNY990P	contig_1	103116	102519	597	renamed_GCF_000008685.2	chromosome	800475	801072	597	99.4	1.402e-126
UNY990P	contig_1	104575	105535	960	renamed_GCF_000008685.2	chromosome	799016	798056	960	99.6	2.967e-213
UNY990P	contig_1	120759	121437	678	renamed_GCF_000008685.2	chromosome	782829	782151	678	99.1	5.213e-151
UNY990P	contig_1	125824	124834	990	renamed_GCF_000008685.2	chromosome	777764	778754	990	99.3	7.696e-225
UNY990P	contig_1	126909	127923	1014	renamed_GCF_000008685.2	chromosome	776679	775665	1014	99.4	1.78e-219
UNY990P	contig_1	129220	132019	2799	renamed_GCF_000008685.2	chromosome	774368	771569	2799	99.4	0.0
UNY990P	contig_1	188579	186968	1611	renamed_GCF_000008685.2	chromosome	715008	716619	1611	99.6	0.0
UNY990P	contig_1	189480	190344	864	renamed_GCF_000008685.2	chromosome	714107	713243	864	99.6	5.599e-190
UNY990P	contig_1	191380	191896	516	renamed_GCF_000008685.2	chromosome	712207	711691	516	99.4	3.605e-111
UNY990P	contig_1	192903	192417	486	renamed_GCF_000008685.2	chromosome	710685	711171	486	100.0	5.304e-102
UNY990P	contig_1	194315	192914	1401	renamed_GCF_000008685.2	chromosome	709273	710674	1401	99.3	4.513e-309
UNY990P	contig_1	198009	196983	1026	renamed_GCF_000008685.2	chromosome	705579	706605	1026	100.0	2.737e-225
UNY990P	contig_1	207951	206817	1134	renamed_GCF_000008685.2	chromosome	695630	696764	1134	99.2	7.681e-258
UNY990P	contig_1	210029	208886	1143	renamed_GCF_000008685.2	chromosome	693553	694696	1143	100.0	3.979e-258
UNY990P	contig_1	212698	210937	1761	renamed_GCF_000008685.2	chromosome	690884	692645	1761	99.4	0.0
UNY990P	contig_1	213390	213093	297	renamed_GCF_000008685.2	chromosome	690192	690489	297	100.0	1.037e-63
UNY990P	contig_1	258815	258446	369	renamed_GCF_000008685.2	chromosome	644771	645140	369	100.0	1.529e-79
UNY990P	contig_1	272888	274391	1503	renamed_GCF_000008685.2	chromosome	630698	629195	1503	99.8	3e-323
UNY990P	contig_1	277301	276548	753	renamed_GCF_000008685.2	chromosome	626285	627038	753	99.2	2.253e-164
UNY990P	contig_1	278580	277326	1254	renamed_GCF_000008685.2	chromosome	625006	626260	1254	100.0	1.925e-276
UNY990P	contig_1	281582	280139	1443	renamed_GCF_000008685.2	chromosome	622004	623447	1443	99.1	0.0
UNY990P	contig_1	285027	287175	2148	renamed_GCF_000008685.2	chromosome	618559	616411	2148	99.8	0.0
UNY990P	contig_1	302577	301242	1335	renamed_GCF_000008685.2	chromosome	601009	602344	1335	100.0	3.161e-293
UNY990P	contig_1	304210	304999	789	renamed_GCF_000008685.2	chromosome	599376	598587	789	99.2	1.175e-177
UNY990P	contig_1	307644	307065	579	renamed_GCF_000008685.2	chromosome	595942	596521	579	99.4	1.865e-120
UNY990P	contig_1	312399	311229	1170	renamed_GCF_000008685.2	chromosome	591187	592357	1170	100.0	9.606e-253
UNY990P	contig_1	354557	354956	399	renamed_GCF_000008685.2	chromosome	548885	548486	399	99.2	3.385e-84
UNY990P	contig_1	354952	355597	645	renamed_GCF_000008685.2	chromosome	548490	547845	645	100.0	1.056e-137
UNY990P	contig_1	369142	368287	855	renamed_GCF_000008685.2	chromosome	534300	535155	855	100.0	8.967e-192
UNY990P	contig_1	372338	374246	1908	renamed_GCF_000008685.2	chromosome	531105	529197	1908	100.0	0.0
UNY990P	contig_1	386950	380449	6501	renamed_GCF_000008685.2	chromosome	516492	522993	6501	99.5	0.0
UNY990P	contig_1	397885	396580	1305	renamed_GCF_000008685.2	chromosome	505553	506858	1305	99.7	2.039e-284
UNY990P	contig_1	398640	398334	306	renamed_GCF_000008685.2	chromosome	504798	505104	306	99.0	3.271e-61
UNY990P	contig_15	7634	8546	912	renamed_GCF_000008685.2	lp28-3	27445	26977	912	98.5	7.306e-89
UNY990P	contig_15	11119	10945	174	renamed_GCF_000008685.2	lp36	22293	22467	174	94.7	2.363e-35
UNY990P	contig_15	13023	11958	1065	renamed_GCF_000008685.2	lp36	20388	21453	1065	100.0	2.633e-232
UNY990P	contig_15	16033	15829	204	renamed_GCF_000008685.2	lp36	17379	17583	204	100.0	8.441e-43
UNY990P	contig_16	12261	11523	738	renamed_GCF_000008685.2	lp38	11889	11151	738	100.0	8.004e-165
UNY990P	contig_16	13812	12816	996	renamed_GCF_000008685.2	lp38	13440	12444	996	99.3	4.175e-224
UNY990P	contig_17	18785	18509	276	renamed_GCF_000008685.2	lp54	35953	36229	276	100.0	3.31e-56
UNY990P	contig_17	20354	19790	564	renamed_GCF_000008685.2	lp54	34384	34948	564	99.4	3.599e-119
UNY990P	contig_17	29276	28034	1242	renamed_GCF_000008685.2	lp54	25467	26694	1242	99.7	3.651e-267
UNY990P	contig_17	30946	30313	633	renamed_GCF_000008685.2	lp54	23776	24415	633	98.1	6.93e-132
UNY990P	contig_17	33633	33093	540	renamed_GCF_000008685.2	lp54	21086	21626	540	97.2	5.277e-111
UNY990P	contig_17	35962	34609	1353	renamed_GCF_000008685.2	lp54	18724	20077	1353	100.0	1.524e-304
UNY990P	contig_17	37421	37985	564	renamed_GCF_000008685.2	lp54	17259	16695	564	98.3	5.792e-114
UNY990P	contig_1	43508	44681	1173	renamed_GCF_000008685.2	chromosome	860111	858938	1173	99.4	3.135e-257
UNY990P	contig_1	51137	49847	1290	renamed_GCF_000008685.2	chromosome	852488	853778	1290	99.5	3.274e-285
UNY990P	contig_1	54807	52638	2169	renamed_GCF_000008685.2	chromosome	848836	850987	2169	99.8	0.0
UNY990P	contig_1	96667	97816	1149	renamed_GCF_000008685.2	chromosome	806923	805774	1149	99.7	5.42e-247
UNY990P	contig_1	111238	109966	1272	renamed_GCF_000008685.2	chromosome	792350	793625	1272	98.5	4.707e-278
UNY990P	contig_1	111801	112782	981	renamed_GCF_000008685.2	chromosome	791787	790806	981	99.6	2.843e-217
UNY990P	contig_1	114268	113650	618	renamed_GCF_000008685.2	chromosome	789302	789938	618	99.5	1.684e-136
UNY990P	contig_1	118532	116834	1698	renamed_GCF_000008685.2	chromosome	785056	786754	1698	99.4	0.0
UNY990P	contig_1	132449	134042	1593	renamed_GCF_000008685.2	chromosome	771139	769546	1593	99.8	0.0
UNY990P	contig_1	135520	136855	1335	renamed_GCF_000008685.2	chromosome	768064	766732	1335	98.4	9.244e-290
UNY990P	contig_1	139217	138245	972	renamed_GCF_000008685.2	chromosome	764370	765342	972	100.0	2.973e-215
UNY990P	contig_1	143386	141940	1446	renamed_GCF_000008685.2	chromosome	760225	761647	1446	99.7	9.686e-317
UNY990P	contig_1	198638	198086	552	renamed_GCF_000008685.2	chromosome	704948	705500	552	93.4	3.96e-116
UNY990P	contig_1	200578	199618	960	renamed_GCF_000008685.2	chromosome	703008	703968	960	97.1	7.937e-211
UNY990P	contig_1	201756	201312	444	renamed_GCF_000008685.2	chromosome	701824	702274	444	96.6	3.201e-92
UNY990P	contig_1	202552	202195	357	renamed_GCF_000008685.2	chromosome	701028	701385	357	99.1	2.301e-81
UNY990P	contig_1	203616	205182	1566	renamed_GCF_000008685.2	chromosome	699965	698399	1566	99.4	0.0
UNY990P	contig_1	228553	227209	1344	renamed_GCF_000008685.2	chromosome	675034	676378	1344	99.7	1.793e-292
UNY990P	contig_1	230375	231821	1446	renamed_GCF_000008685.2	chromosome	673167	671766	1446	98.4	1.191e-305
UNY990P	contig_1	235069	238579	3510	renamed_GCF_000008685.2	chromosome	668517	665007	3510	99.4	0.0
UNY990P	contig_1	240669	240984	315	renamed_GCF_000008685.2	chromosome	662917	662602	315	99.0	1.26e-64
UNY990P	contig_1	242071	243943	1872	renamed_GCF_000008685.2	chromosome	661515	659643	1872	99.1	0.0
UNY990P	contig_1	315516	313914	1602	renamed_GCF_000008685.2	chromosome	588065	589667	1602	100.0	0.0
UNY990P	contig_1	318701	319391	690	renamed_GCF_000008685.2	chromosome	584880	584190	690	100.0	9.609e-155
UNY990P	contig_1	321937	320164	1773	renamed_GCF_000008685.2	chromosome	581644	583417	1773	99.3	0.0
UNY990P	contig_1	325312	323167	2145	renamed_GCF_000008685.2	chromosome	578276	580421	2145	99.2	0.0
UNY990P	contig_1	335778	335310	468	renamed_GCF_000008685.2	chromosome	567809	568277	468	100.0	1.969e-101
UNY990P	contig_1	341645	342026	381	renamed_GCF_000008685.2	chromosome	561943	561562	381	99.2	5.027e-77
UNY990P	contig_1	342034	342454	420	renamed_GCF_000008685.2	chromosome	561554	561116	420	93.7	1.163e-82
UNY990P	contig_1	342443	342842	399	renamed_GCF_000008685.2	chromosome	561127	560728	399	95.4	5.004e-80
UNY990P	contig_1	394125	392592	1533	renamed_GCF_000008685.2	chromosome	509313	510846	1533	99.8	0.0
UNY990P	contig_1	395625	394590	1035	renamed_GCF_000008685.2	chromosome	507813	508848	1035	100.0	4.156e-222
UNY990P	contig_1	401248	400699	549	renamed_GCF_000008685.2	chromosome	502190	502739	549	100.0	1.698e-116
UNY990P	contig_1	401942	401573	369	renamed_GCF_000008685.2	chromosome	501496	501865	369	99.1	4.571e-76
UNY990P	contig_1	402427	402226	201	renamed_GCF_000008685.2	chromosome	501014	501212	201	98.4	1.098e-39
UNY990P	contig_1	402846	402429	417	renamed_GCF_000008685.2	chromosome	500592	501009	417	100.0	2.778e-89
UNY990P	contig_1	404098	403735	363	renamed_GCF_000008685.2	chromosome	499340	499703	363	100.0	3.407e-78
UNY990P	contig_1	405226	404392	834	renamed_GCF_000008685.2	chromosome	498212	499046	834	100.0	1.895e-188
UNY990P	contig_1	415212	414465	747	renamed_GCF_000008685.2	chromosome	488225	488972	747	99.1	2.05e-164
UNY990P	contig_1	416721	415899	822	renamed_GCF_000008685.2	chromosome	486746	487538	822	99.6	9.243e-169
UNY990P	contig_1	472828	473752	924	renamed_GCF_000008685.2	chromosome	430616	429692	924	100.0	4.275e-203
UNY990P	contig_1	475455	474819	636	renamed_GCF_000008685.2	chromosome	427986	428622	636	99.5	1.686e-139
UNY990P	contig_1	486756	486339	417	renamed_GCF_000008685.2	chromosome	416688	417105	417	99.2	6.183e-89
UNY990P	contig_1	487651	489118	1467	renamed_GCF_000008685.2	chromosome	415793	414326	1467	99.5	0.0
UNY990P	contig_1	490444	491989	1545	renamed_GCF_000008685.2	chromosome	413006	411455	1545	98.2	0.0
UNY990P	contig_1	492997	494029	1032	renamed_GCF_000008685.2	chromosome	410447	409415	1032	99.4	5.36e-236
UNY990P	contig_1	495064	495244	180	renamed_GCF_000008685.2	chromosome	408380	408200	180	100.0	2.118e-37
UNY990P	contig_1	508280	509342	1062	renamed_GCF_000008685.2	chromosome	395166	394104	1062	99.7	9.401e-235
UNY990P	contig_1	510489	511515	1026	renamed_GCF_000008685.2	chromosome	392957	391931	1026	98.8	1.626e-222
UNY990P	contig_1	513105	514470	1365	renamed_GCF_000008685.2	chromosome	390341	388976	1365	99.1	3.579e-288
UNY990P	contig_1	556148	556589	441	renamed_GCF_000008685.2	chromosome	347301	346860	441	98.6	4.183e-97
UNY990P	contig_1	556608	557019	411	renamed_GCF_000008685.2	chromosome	346841	346430	411	99.2	1.518e-86
UNY990P	contig_1	558387	557085	1302	renamed_GCF_000008685.2	chromosome	345062	346364	1302	99.5	1.478e-287
UNY990P	contig_1	560242	559270	972	renamed_GCF_000008685.2	chromosome	343207	344179	972	100.0	3.579e-213
UNY990P	contig_1	561115	560242	873	renamed_GCF_000008685.2	chromosome	342334	343207	873	99.6	3.495e-188
UNY990P	contig_1	575712	576741	1029	renamed_GCF_000008685.2	chromosome	327757	326698	1029	99.4	1.646e-231
UNY990P	contig_1	577151	578204	1053	renamed_GCF_000008685.2	chromosome	326288	325235	1053	99.7	1.991e-233
UNY990P	contig_1	578203	579664	1461	renamed_GCF_000008685.2	chromosome	325236	323775	1461	99.5	0.0
UNY990P	contig_1	579660	580593	933	renamed_GCF_000008685.2	chromosome	323779	322846	933	99.3	2.018e-204
UNY990P	contig_1	598320	599667	1347	renamed_GCF_000008685.2	chromosome	305120	303773	1347	100.0	1.016e-290
UNY990P	contig_1	599700	600108	408	renamed_GCF_000008685.2	chromosome	303740	303332	408	99.2	2.649e-88
UNY990P	contig_1	600131	600590	459	renamed_GCF_000008685.2	chromosome	303309	302850	459	100.0	4.601e-99
UNY990P	contig_1	600604	600937	333	renamed_GCF_000008685.2	chromosome	302839	302503	333	99.0	1.253e-67
UNY990P	contig_1	600951	602661	1710	renamed_GCF_000008685.2	chromosome	302489	300779	1710	99.8	0.0
UNY990P	contig_1	602676	603711	1035	renamed_GCF_000008685.2	chromosome	300764	299729	1035	100.0	3.255e-216
UNY990P	contig_1	611845	612382	537	renamed_GCF_000008685.2	chromosome	291595	291058	537	99.4	3.778e-114
UNY990P	contig_1	612402	613461	1059	renamed_GCF_000008685.2	chromosome	291021	289962	1059	100.0	3.164e-229
UNY990P	contig_1	613506	613848	342	renamed_GCF_000008685.2	chromosome	289917	289575	342	99.1	5.339e-70
UNY990P	contig_1	613840	614467	627	renamed_GCF_000008685.2	chromosome	289583	288956	627	94.2	2.472e-125
UNY990P	contig_1	664294	665122	828	renamed_GCF_000008685.2	chromosome	239128	238300	828	99.2	1.027e-185
UNY990P	contig_1	665466	665793	327	renamed_GCF_000008685.2	chromosome	237956	237629	327	100.0	8.435e-71
UNY990P	contig_1	666280	667828	1548	renamed_GCF_000008685.2	chromosome	237142	235594	1548	99.8	0.0
UNY990P	contig_1	680244	679461	783	renamed_GCF_000008685.2	chromosome	223178	223961	783	98.8	4.166e-171
UNY990P	contig_1	682694	681785	909	renamed_GCF_000008685.2	chromosome	220728	221637	909	99.3	4.638e-191
UNY990P	contig_1	683788	684367	579	renamed_GCF_000008685.2	chromosome	219634	219055	579	99.4	1.865e-120
UNY990P	contig_1	686142	685110	1032	renamed_GCF_000008685.2	chromosome	217277	218312	1032	99.7	2.148e-220
UNY990P	contig_1	714296	714557	261	renamed_GCF_000008685.2	chromosome	188494	188233	261	100.0	7.054e-54
UNY990P	contig_1	714959	715613	654	renamed_GCF_000008685.2	chromosome	187831	187177	654	100.0	1.397e-144
UNY990P	contig_1	739914	739746	168	renamed_GCF_000008685.2	chromosome	162877	163045	168	100.0	5.294e-34
UNY990P	contig_1	742702	741583	1119	renamed_GCF_000008685.2	chromosome	160089	161208	1119	99.4	5.725e-250
UNY990P	contig_1	744164	743447	717	renamed_GCF_000008685.2	chromosome	158627	159344	717	97.0	3.592e-153
UNY990P	contig_1	745165	744730	435	renamed_GCF_000008685.2	chromosome	157626	158061	435	99.3	1.372e-91
UNY990P	contig_1	746391	749091	2700	renamed_GCF_000008685.2	chromosome	156400	153700	2700	99.8	0.0
UNY990P	contig_1	750586	749779	807	renamed_GCF_000008685.2	chromosome	152205	153012	807	99.6	4.826e-182
UNY990P	contig_1	754129	755140	1011	renamed_GCF_000008685.2	chromosome	148659	147648	1011	99.7	2.697e-214
UNY990P	contig_1	833227	832666	561	renamed_GCF_000008685.2	chromosome	69565	70126	561	100.0	3.775e-118
UNY990P	contig_1	886950	885990	960	renamed_GCF_000008685.2	chromosome	15994	16804	960	99.2	5.358e-172
UNY990P	contig_1	887449	888070	621	renamed_GCF_000008685.2	chromosome	15345	14724	621	100.0	3.249e-138
UNY990P	contig_1	890641	890041	600	renamed_GCF_000008685.2	chromosome	12153	12753	600	99.4	2.034e-131
UNY990P	contig_1	892214	891374	840	renamed_GCF_000008685.2	chromosome	10580	11420	840	100.0	7.775e-191
UNY990P	contig_2	1615	1894	279	renamed_GCF_000008685.2	cp26	45	324	279	98.9	5.175e-60
UNY990P	contig_2	2321	1877	444	renamed_GCF_000008685.2	cp26	751	307	444	98.6	3.617e-99
UNY990P	contig_2	3756	2406	1350	renamed_GCF_000008685.2	cp26	2186	836	1350	100.0	7.868e-303
UNY990P	contig_2	5366	4043	1323	renamed_GCF_000008685.2	cp26	3798	2475	1323	99.3	1.555e-290
UNY990P	contig_2	5651	5999	348	renamed_GCF_000008685.2	cp26	4083	4431	348	100.0	1.075e-71
UNY990P	contig_2	6007	6325	318	renamed_GCF_000008685.2	cp26	4481	4757	318	98.9	7.253e-55
UNY990P	contig_13	12709	11890	819	renamed_GCF_000008685.2	lp28-2	12319	11500	819	100.0	1.075e-183
UNY990P	contig_13	13531	13138	393	renamed_GCF_000008685.2	lp28-2	13141	12748	393	99.2	3.389e-83
UNY990P	contig_13	14731	13897	834	renamed_GCF_000008685.2	lp28-2	14341	13507	834	98.5	6.719e-183
UNY990P	contig_13	24499	24112	387	renamed_GCF_000008685.2	lp28-2	24108	23721	387	100.0	1.013e-78
UNY990P	contig_13	26368	26779	411	renamed_GCF_000008685.2	lp28-2	25979	26390	411	99.2	4.62e-91
UNY990P	contig_13	27501	28329	828	renamed_GCF_000008685.2	lp28-2	27112	27940	828	95.6	6.371e-174
UNY990P	contig_13	29886	29121	765	renamed_GCF_000008685.2	lp28-2	29618	28853	765	96.0	2.988e-163
UNY990P	contig_15	24553	25249	696	renamed_GCF_000008685.2	lp36	8859	8163	696	99.1	6.303e-152
UNY990P	contig_15	27373	26524	849	renamed_GCF_000008685.2	lp36	35443	34594	849	98.2	2.634e-187
UNY990P	contig_15	28474	28228	246	renamed_GCF_000008685.2	lp21	16548	16227	246	90.7	5.597e-46
UNY990P	contig_16	4619	5330	711	renamed_GCF_000008685.2	lp38	4575	5496	711	97.4	1.058e-148
UNY990P	contig_16	7282	7489	207	renamed_GCF_000008685.2	lp36	25102	25657	207	58.6	1.063e-18
UNY990P	contig_16	21623	22349	726	renamed_GCF_000008685.2	lp38	21222	21948	726	99.5	2.587e-158
UNY990P	contig_16	23766	24489	723	renamed_GCF_000008685.2	lp38	32497	33220	723	98.7	7.272e-155
UNY990P	contig_16	27918	27396	522	renamed_GCF_000008685.2	lp38	28053	26994	522	98.2	5.286e-108
UNY990P	contig_16	31624	32542	918	renamed_GCF_000008685.2	lp38	31219	32140	918	99.6	1.1e-208
UNY990P	contig_17	39333	38901	432	renamed_GCF_000008685.2	lp54	15369	15801	432	97.2	9.777e-95
UNY990P	contig_17	41148	40395	753	renamed_GCF_000008685.2	lp54	13554	14307	753	100.0	4.561e-165
UNY990P	contig_17	45254	44432	822	renamed_GCF_000008685.2	lp54	9456	10278	822	99.6	1.415e-172
UNY990P	contig_17	46445	46265	180	renamed_GCF_000008685.2	lp54	8265	8445	180	100.0	1.452e-33
UNY990P	contig_17	48190	47563	627	renamed_GCF_000008685.2	lp54	6520	7147	627	100.0	4.747e-135
UNY990P	contig_17	49397	49061	336	renamed_GCF_000008685.2	lp54	5313	5649	336	99.0	4.386e-71
UNY990P	contig_17	50450	51704	1254	renamed_GCF_000008685.2	lp54	4256	3002	1254	100.0	3.245e-279
UNY990P	contig_17	53247	52737	510	renamed_GCF_000008685.2	lp54	1460	1970	510	100.0	8.829e-109