QUERY_ID	QUERY_NAME	QUERY_START	QUERY_END	QUERY_LENGTH	REF_ID	REF_NAME	REF_START	REF_END	REF_LENGTH	IDENTITY	EVALUE
GCF_040790715.1_ASM4079071v1_genomic	NZ_CP161144.1	21938	20894	1044	renamed_GCF_000008685.2	chromosome	22101	21057	1044	100.0	6.693e-227
GCF_040790715.1_ASM4079071v1_genomic	NZ_CP161144.1	22576	21982	594	renamed_GCF_000008685.2	chromosome	22739	22145	594	99.4	7.271e-125
GCF_040790715.1_ASM4079071v1_genomic	NZ_CP161144.1	24533	23801	732	renamed_GCF_000008685.2	chromosome	24696	23964	732	100.0	2.844e-158
GCF_040790715.1_ASM4079071v1_genomic	NZ_CP161144.1	25589	26228	639	renamed_GCF_000008685.2	chromosome	25752	26391	639	99.5	1.211e-143
GCF_040790715.1_ASM4079071v1_genomic	NZ_CP161144.1	27702	27270	432	renamed_GCF_000008685.2	chromosome	27865	27433	432	100.0	2.641e-92
GCF_040790715.1_ASM4079071v1_genomic	NZ_CP161144.1	29309	28328	981	renamed_GCF_000008685.2	chromosome	29472	28491	981	99.3	9.688e-221
GCF_040790715.1_ASM4079071v1_genomic	NZ_CP161144.1	30867	31326	459	renamed_GCF_000008685.2	chromosome	31026	31479	459	99.3	5.582e-97
GCF_040790715.1_ASM4079071v1_genomic	NZ_CP161144.1	33884	32003	1881	renamed_GCF_000008685.2	chromosome	34037	32156	1881	100.0	0.0
GCF_040790715.1_ASM4079071v1_genomic	NZ_CP161144.1	36456	35703	753	renamed_GCF_000008685.2	chromosome	36609	35856	753	98.0	1.62e-159
GCF_040790715.1_ASM4079071v1_genomic	NZ_CP161144.1	39482	37979	1503	renamed_GCF_000008685.2	chromosome	39638	38135	1503	99.8	0.0
GCF_040790715.1_ASM4079071v1_genomic	NZ_CP161144.1	70254	71064	810	renamed_GCF_000008685.2	chromosome	70141	71219	810	99.6	2.744e-180
GCF_040790715.1_ASM4079071v1_genomic	NZ_CP161144.1	72491	73337	846	renamed_GCF_000008685.2	chromosome	72646	73492	846	99.2	6.38e-177
GCF_040790715.1_ASM4079071v1_genomic	NZ_CP161144.1	76294	77545	1251	renamed_GCF_000008685.2	chromosome	76450	77701	1251	99.7	8.508e-268
GCF_040790715.1_ASM4079071v1_genomic	NZ_CP161144.1	79196	78845	351	renamed_GCF_000008685.2	chromosome	79322	79001	351	99.0	3.732e-67
GCF_040790715.1_ASM4079071v1_genomic	NZ_CP161144.1	93267	92721	546	renamed_GCF_000008685.2	chromosome	93423	92877	546	97.7	1.472e-117
GCF_040790715.1_ASM4079071v1_genomic	NZ_CP161144.1	94449	94062	387	renamed_GCF_000008685.2	chromosome	94605	94218	387	100.0	1.031e-86
GCF_040790715.1_ASM4079071v1_genomic	NZ_CP161144.1	97710	96786	924	renamed_GCF_000008685.2	chromosome	97866	96942	924	99.3	8.657e-204
GCF_040790715.1_ASM4079071v1_genomic	NZ_CP161144.1	98659	100048	1389	renamed_GCF_000008685.2	chromosome	98816	100205	1389	99.3	2.596e-313
GCF_040790715.1_ASM4079071v1_genomic	NZ_CP161144.1	100070	100592	522	renamed_GCF_000008685.2	chromosome	100227	100749	522	100.0	2.976e-114
GCF_040790715.1_ASM4079071v1_genomic	NZ_CP161144.1	169377	170547	1170	renamed_GCF_000008685.2	chromosome	169562	170708	1170	99.7	6.062e-258
GCF_040790715.1_ASM4079071v1_genomic	NZ_CP161144.1	217134	218166	1032	renamed_GCF_000008685.2	chromosome	217277	218312	1032	99.1	2.355e-219
GCF_040790715.1_ASM4079071v1_genomic	NZ_CP161144.1	219488	218909	579	renamed_GCF_000008685.2	chromosome	219634	219055	579	100.0	8.388e-121
GCF_040790715.1_ASM4079071v1_genomic	NZ_CP161144.1	220582	221491	909	renamed_GCF_000008685.2	chromosome	220728	221637	909	99.3	4.638e-191
GCF_040790715.1_ASM4079071v1_genomic	NZ_CP161144.1	221487	223032	1545	renamed_GCF_000008685.2	chromosome	221741	223178	1545	98.3	8.416e-309
GCF_040790715.1_ASM4079071v1_genomic	NZ_CP161144.1	245233	244630	603	renamed_GCF_000008685.2	chromosome	245382	244776	603	99.5	7.936e-134
GCF_040790715.1_ASM4079071v1_genomic	NZ_CP161144.1	246449	247955	1506	renamed_GCF_000008685.2	chromosome	246596	248102	1506	100.0	0.0
GCF_040790715.1_ASM4079071v1_genomic	NZ_CP161144.1	251064	250509	555	renamed_GCF_000008685.2	chromosome	251211	250656	555	99.4	1.543e-118
GCF_040790715.1_ASM4079071v1_genomic	NZ_CP161144.1	252286	252892	606	renamed_GCF_000008685.2	chromosome	252433	253039	606	100.0	4.115e-133
GCF_040790715.1_ASM4079071v1_genomic	NZ_CP161144.1	254797	255502	705	renamed_GCF_000008685.2	chromosome	254944	255649	705	99.5	3.589e-151
GCF_040790715.1_ASM4079071v1_genomic	NZ_CP161144.1	285812	283721	2091	renamed_GCF_000008685.2	chromosome	285962	283868	2091	99.4	0.0
GCF_040790715.1_ASM4079071v1_genomic	NZ_CP161144.1	287730	286941	789	renamed_GCF_000008685.2	chromosome	287877	287088	789	100.0	1.783e-164
GCF_040790715.1_ASM4079071v1_genomic	NZ_CP161144.1	288799	288034	765	renamed_GCF_000008685.2	chromosome	288946	288181	765	100.0	2.478e-165
GCF_040790715.1_ASM4079071v1_genomic	NZ_CP161144.1	289770	289428	342	renamed_GCF_000008685.2	chromosome	289917	289575	342	100.0	1.077e-70
GCF_040790715.1_ASM4079071v1_genomic	NZ_CP161144.1	291448	290911	537	renamed_GCF_000008685.2	chromosome	291595	291058	537	100.0	7.638e-115
GCF_040790715.1_ASM4079071v1_genomic	NZ_CP161144.1	310375	309631	744	renamed_GCF_000008685.2	chromosome	310523	309779	744	100.0	5.245e-162
GCF_040790715.1_ASM4079071v1_genomic	NZ_CP161144.1	312567	311511	1056	renamed_GCF_000008685.2	chromosome	312715	311659	1056	100.0	1.239e-230
GCF_040790715.1_ASM4079071v1_genomic	NZ_CP161144.1	314280	313998	282	renamed_GCF_000008685.2	chromosome	314427	314145	282	100.0	2.699e-59
GCF_040790715.1_ASM4079071v1_genomic	NZ_CP161144.1	315996	315159	837	renamed_GCF_000008685.2	chromosome	316143	315306	837	99.6	1.426e-183
GCF_040790715.1_ASM4079071v1_genomic	NZ_CP161144.1	317858	317099	759	renamed_GCF_000008685.2	chromosome	318005	317246	759	100.0	1.223e-163
GCF_040790715.1_ASM4079071v1_genomic	NZ_CP161144.1	342197	343070	873	renamed_GCF_000008685.2	chromosome	342334	343207	873	99.6	7.766e-188
GCF_040790715.1_ASM4079071v1_genomic	NZ_CP161144.1	344925	346227	1302	renamed_GCF_000008685.2	chromosome	345062	346364	1302	99.5	6.653e-288
GCF_040790715.1_ASM4079071v1_genomic	NZ_CP161144.1	347163	346722	441	renamed_GCF_000008685.2	chromosome	347301	346860	441	100.0	1.706e-98
GCF_040790715.1_ASM4079071v1_genomic	NZ_CP161144.1	349472	348014	1458	renamed_GCF_000008685.2	chromosome	349610	348152	1458	99.5	5e-324
GCF_040790715.1_ASM4079071v1_genomic	NZ_CP161144.1	384149	385289	1140	renamed_GCF_000008685.2	chromosome	384286	385426	1140	99.4	1.764e-249
GCF_040790715.1_ASM4079071v1_genomic	NZ_CP161144.1	386021	387200	1179	renamed_GCF_000008685.2	chromosome	386158	387337	1179	99.7	9.776e-263
GCF_040790715.1_ASM4079071v1_genomic	NZ_CP161144.1	388343	387680	663	renamed_GCF_000008685.2	chromosome	388480	387817	663	99.5	1.104e-148
GCF_040790715.1_ASM4079071v1_genomic	NZ_CP161144.1	390204	388839	1365	renamed_GCF_000008685.2	chromosome	390341	388976	1365	99.3	3.579e-288
GCF_040790715.1_ASM4079071v1_genomic	NZ_CP161144.1	392820	391794	1026	renamed_GCF_000008685.2	chromosome	392957	391931	1026	99.4	6.082e-225
GCF_040790715.1_ASM4079071v1_genomic	NZ_CP161144.1	416563	416980	417	renamed_GCF_000008685.2	chromosome	416688	417105	417	100.0	1.248e-89
GCF_040790715.1_ASM4079071v1_genomic	NZ_CP161144.1	417598	418210	612	renamed_GCF_000008685.2	chromosome	417723	418335	612	99.0	7.572e-136
GCF_040790715.1_ASM4079071v1_genomic	NZ_CP161144.1	421255	419377	1878	renamed_GCF_000008685.2	chromosome	421380	419502	1878	99.5	0.0
GCF_040790715.1_ASM4079071v1_genomic	NZ_CP161144.1	424323	423699	624	renamed_GCF_000008685.2	chromosome	424442	423821	624	99.5	4.527e-135
GCF_040790715.1_ASM4079071v1_genomic	NZ_CP161144.1	454946	456104	1158	renamed_GCF_000008685.2	chromosome	458276	459434	1158	99.7	1.225e-256
GCF_040790715.1_ASM4079071v1_genomic	NZ_CP161144.1	456585	456741	156	renamed_GCF_000008685.2	chromosome	459915	460071	156	100.0	2.965e-30
GCF_040790715.1_ASM4079071v1_genomic	NZ_CP161144.1	458714	459443	729	renamed_GCF_000008685.2	chromosome	462044	462773	729	98.7	1.34e-157
GCF_040790715.1_ASM4079071v1_genomic	NZ_CP161144.1	460722	461802	1080	renamed_GCF_000008685.2	chromosome	464052	465132	1080	99.7	2.027e-246
GCF_040790715.1_ASM4079071v1_genomic	NZ_CP161144.1	466056	463950	2106	renamed_GCF_000008685.2	chromosome	469387	467281	2106	99.7	0.0
GCF_040790715.1_ASM4079071v1_genomic	NZ_CP161144.1	485648	486161	513	renamed_GCF_000008685.2	chromosome	488982	489495	513	100.0	1.545e-111
GCF_040790715.1_ASM4079071v1_genomic	NZ_CP161144.1	486398	487220	822	renamed_GCF_000008685.2	chromosome	489732	490554	822	98.9	1.491e-180
GCF_040790715.1_ASM4079071v1_genomic	NZ_CP161144.1	489253	490618	1365	renamed_GCF_000008685.2	chromosome	492587	493952	1365	100.0	1.721e-296
GCF_040790715.1_ASM4079071v1_genomic	NZ_CP161144.1	491699	492884	1185	renamed_GCF_000008685.2	chromosome	495032	496217	1185	100.0	4.832e-263
GCF_040790715.1_ASM4079071v1_genomic	NZ_CP161144.1	503537	503651	114	renamed_GCF_000008685.2	chromosome	506864	506984	114	100.0	7.638e-22
GCF_040790715.1_ASM4079071v1_genomic	NZ_CP161144.1	504072	504465	393	renamed_GCF_000008685.2	chromosome	507405	507798	393	100.0	3.073e-84
GCF_040790715.1_ASM4079071v1_genomic	NZ_CP161144.1	794662	793732	930	renamed_GCF_000008685.2	chromosome	798048	797118	930	100.0	3.063e-199
GCF_040790715.1_ASM4079071v1_genomic	NZ_CP161144.1	795630	794670	960	renamed_GCF_000008685.2	chromosome	799016	798056	960	99.6	2.967e-213
GCF_040790715.1_ASM4079071v1_genomic	NZ_CP161144.1	796889	795821	1068	renamed_GCF_000008685.2	chromosome	800275	799207	1068	99.4	4.094e-245
GCF_040790715.1_ASM4079071v1_genomic	NZ_CP161144.1	797089	797686	597	renamed_GCF_000008685.2	chromosome	800475	801072	597	99.4	1.402e-126
GCF_040790715.1_ASM4079071v1_genomic	NZ_CP161144.1	797624	798392	768	renamed_GCF_000008685.2	chromosome	801118	801778	768	98.1	1.322e-138
GCF_040790715.1_ASM4079071v1_genomic	NZ_CP161144.1	799413	798555	858	renamed_GCF_000008685.2	chromosome	802798	801940	858	99.2	3.799e-176
GCF_040790715.1_ASM4079071v1_genomic	NZ_CP161144.1	799782	799452	330	renamed_GCF_000008685.2	chromosome	803167	802837	330	100.0	2.178e-69
GCF_040790715.1_ASM4079071v1_genomic	NZ_CP161144.1	810351	810006	345	renamed_GCF_000008685.2	chromosome	813706	813385	345	92.0	6.146e-61
GCF_040790715.1_ASM4079071v1_genomic	NZ_CP161144.1	811342	810334	1008	renamed_GCF_000008685.2	chromosome	814697	813689	1008	99.4	2.823e-213
GCF_040790715.1_ASM4079071v1_genomic	NZ_CP161144.1	811947	811512	435	renamed_GCF_000008685.2	chromosome	815302	814867	435	100.0	4.611e-95
GCF_040790715.1_ASM4079071v1_genomic	NZ_CP161144.1	845158	845425	267	renamed_GCF_000008685.2	chromosome	848537	848804	267	100.0	3.495e-54
GCF_040790715.1_ASM4079071v1_genomic	NZ_CP161144.1	845439	847608	2169	renamed_GCF_000008685.2	chromosome	848836	850987	2169	99.8	0.0
GCF_040790715.1_ASM4079071v1_genomic	NZ_CP161144.1	847614	849135	1521	renamed_GCF_000008685.2	chromosome	850993	852514	1521	99.6	0.0
GCF_040790715.1_ASM4079071v1_genomic	NZ_CP161144.1	849109	850399	1290	renamed_GCF_000008685.2	chromosome	852488	853778	1290	99.7	1.474e-285
GCF_040790715.1_ASM4079071v1_genomic	NZ_CP161144.1	850395	851463	1068	renamed_GCF_000008685.2	chromosome	853774	854842	1068	100.0	1.362e-231
GCF_040790715.1_ASM4079071v1_genomic	NZ_CP161144.1	851489	852617	1128	renamed_GCF_000008685.2	chromosome	854868	855996	1128	99.4	1.292e-259
GCF_040790715.1_ASM4079071v1_genomic	NZ_CP161144.1	852609	854130	1521	renamed_GCF_000008685.2	chromosome	855988	857509	1521	99.8	0.0
GCF_040790715.1_ASM4079071v1_genomic	NZ_CP161144.1	864736	864364	372	renamed_GCF_000008685.2	chromosome	868114	867742	372	99.1	1.771e-78
GCF_040790715.1_ASM4079071v1_genomic	NZ_CP161144.1	864816	865362	546	renamed_GCF_000008685.2	chromosome	868194	868740	546	100.0	1.846e-123
GCF_040790715.1_ASM4079071v1_genomic	NZ_CP161144.1	866137	865354	783	renamed_GCF_000008685.2	chromosome	869380	868732	783	99.5	1.931e-145
GCF_040790715.1_ASM4079071v1_genomic	NZ_CP161154.1	12016	13609	1593	renamed_GCF_000008685.2	cp26	12013	13606	1593	99.2	0.0
GCF_040790715.1_ASM4079071v1_genomic	NZ_CP161154.1	15110	13895	1215	renamed_GCF_000008685.2	cp26	15107	13892	1215	99.2	1.299e-265
GCF_040790715.1_ASM4079071v1_genomic	NZ_CP161154.1	16670	15134	1536	renamed_GCF_000008685.2	cp26	16667	15131	1536	99.0	0.0
GCF_040790715.1_ASM4079071v1_genomic	NZ_CP161154.1	16906	17539	633	renamed_GCF_000008685.2	cp26	16902	17535	633	73.9	1.336e-90
GCF_040790715.1_ASM4079071v1_genomic	NZ_CP161154.1	19342	17986	1356	renamed_GCF_000008685.2	cp26	19321	17965	1356	99.5	9.723e-293
GCF_040790715.1_ASM4079071v1_genomic	NZ_CP161154.1	20807	19451	1356	renamed_GCF_000008685.2	cp26	20786	19430	1356	98.6	2.16e-292
GCF_040790715.1_ASM4079071v1_genomic	NZ_CP161154.1	21385	20878	507	renamed_GCF_000008685.2	cp26	21364	20857	507	100.0	3.123e-111
GCF_040790715.1_ASM4079071v1_genomic	NZ_CP161148.1	1305	1998	693	renamed_GCF_000008685.2	cp32-6	1305	1998	693	100.0	5.741e-144
GCF_040790715.1_ASM4079071v1_genomic	NZ_CP161148.1	2009	2573	564	renamed_GCF_000008685.2	cp32-6	2009	2573	564	99.4	1.105e-123
GCF_040790715.1_ASM4079071v1_genomic	NZ_CP161148.1	15367	15715	348	renamed_GCF_000008685.2	cp32-1	15421	15769	348	99.1	4.373e-73
GCF_040790715.1_ASM4079071v1_genomic	NZ_CP161148.1	15704	16040	336	renamed_GCF_000008685.2	lp56	19256	19592	336	100.0	5.348e-69
GCF_040790715.1_ASM4079071v1_genomic	NZ_CP161148.1	16032	16386	354	renamed_GCF_000008685.2	cp32-3	16083	16437	354	100.0	1.459e-77
GCF_040790715.1_ASM4079071v1_genomic	NZ_CP161148.1	17176	17602	426	renamed_GCF_000008685.2	cp32-4	17102	17525	426	87.9	3.813e-79
GCF_040790715.1_ASM4079071v1_genomic	NZ_CP161148.1	18655	17638	1017	renamed_GCF_000008685.2	cp32-7	18728	17711	1017	97.3	2.862e-223
GCF_040790715.1_ASM4079071v1_genomic	NZ_CP161148.1	19044	20145	1101	renamed_GCF_000008685.2	cp32-3	19604	20705	1101	93.7	2.907e-237
GCF_040790715.1_ASM4079071v1_genomic	NZ_CP161157.1	8966	9293	327	renamed_GCF_000008685.2	lp17	7784	8111	327	100.0	1.029e-68
GCF_040790715.1_ASM4079071v1_genomic	NZ_CP161157.1	9448	10561	1113	renamed_GCF_000008685.2	lp17	8266	9379	1113	93.7	5.062e-233
GCF_040790715.1_ASM4079071v1_genomic	NZ_CP161157.1	11069	10775	294	renamed_GCF_000008685.2	lp17	9980	9590	294	95.8	5.989e-61
GCF_040790715.1_ASM4079071v1_genomic	NZ_CP161155.1	10185	9564	621	renamed_GCF_000008685.2	lp25	10187	9566	621	97.0	1.766e-136
GCF_040790715.1_ASM4079071v1_genomic	NZ_CP161155.1	10707	10197	510	renamed_GCF_000008685.2	lp25	10694	10199	510	96.3	2.618e-105
GCF_040790715.1_ASM4079071v1_genomic	NZ_CP161155.1	11827	11245	582	renamed_GCF_000008685.2	lp25	12079	11497	582	98.9	1.106e-126
GCF_040790715.1_ASM4079071v1_genomic	NZ_CP161155.1	12602	11843	759	renamed_GCF_000008685.2	lp25	12854	12095	759	98.4	5.504e-164
GCF_040790715.1_ASM4079071v1_genomic	NZ_CP161155.1	13141	12577	564	renamed_GCF_000008685.2	lp25	13393	12829	564	94.6	2.975e-121
GCF_040790715.1_ASM4079071v1_genomic	NZ_CP161155.1	14236	13150	1086	renamed_GCF_000008685.2	lp25	14530	13402	1086	93.0	1.069e-228
GCF_040790715.1_ASM4079071v1_genomic	NZ_CP161155.1	15308	14804	504	renamed_GCF_000008685.2	lp25	15545	15041	504	93.4	3.607e-109
GCF_040790715.1_ASM4079071v1_genomic	NZ_CP161155.1	20277	19545	732	renamed_GCF_000008685.2	lp25	22677	21945	732	83.1	7.896e-130
GCF_040790715.1_ASM4079071v1_genomic	NZ_CP161151.1	10512	9843	669	renamed_GCF_000008685.2	lp28-3	10516	9847	669	99.5	5.739e-140
GCF_040790715.1_ASM4079071v1_genomic	NZ_CP161151.1	16516	17437	921	renamed_GCF_000008685.2	lp28-3	16518	17415	921	97.3	5.914e-199
GCF_040790715.1_ASM4079071v1_genomic	NZ_CP161151.1	17429	17996	567	renamed_GCF_000008685.2	lp28-3	17407	17974	567	100.0	1.938e-126
GCF_040790715.1_ASM4079071v1_genomic	NZ_CP161151.1	17968	18724	756	renamed_GCF_000008685.2	lp28-3	17946	18702	756	100.0	8.81e-167
GCF_040790715.1_ASM4079071v1_genomic	NZ_CP161149.1	4023	4839	816	renamed_GCF_000008685.2	lp28-4	2535	3351	816	100.0	8.08e-178
GCF_040790715.1_ASM4079071v1_genomic	NZ_CP161149.1	6616	6835	219	renamed_GCF_000008685.2	lp28-4	5127	5346	219	100.0	1.443e-47
GCF_040790715.1_ASM4079071v1_genomic	NZ_CP161149.1	8692	9619	927	renamed_GCF_000008685.2	lp28-4	7182	8538	927	88.3	1.973e-160
GCF_040790715.1_ASM4079071v1_genomic	NZ_CP161149.1	12895	14005	1110	renamed_GCF_000008685.2	lp28-4	10814	11927	1110	98.6	1.212e-248
GCF_040790715.1_ASM4079071v1_genomic	NZ_CP161150.1	26925	27462	537	renamed_GCF_000008685.2	lp28-2	26569	27085	537	52.2	3.419e-56
GCF_040790715.1_ASM4079071v1_genomic	NZ_CP161150.1	27521	28373	852	renamed_GCF_000008685.2	lp28-2	28030	28831	852	73.1	3.453e-124
GCF_040790715.1_ASM4079071v1_genomic	NZ_CP161150.1	29159	28394	765	renamed_GCF_000008685.2	lp28-2	29618	28853	765	77.5	1.436e-128
GCF_040790715.1_ASM4079071v1_genomic	NZ_CP161156.1	3491	2738	753	renamed_GCF_000008685.2	lp36	6040	5287	753	99.6	3.6e-159
GCF_040790715.1_ASM4079071v1_genomic	NZ_CP161156.1	3825	4101	276	renamed_GCF_000008685.2	lp36	6365	6650	276	98.9	6.026e-58
GCF_040790715.1_ASM4079071v1_genomic	NZ_CP161145.1	653	1139	486	renamed_GCF_000008685.2	lp28-3	28197	27624	486	48.4	2.052e-45
GCF_040790715.1_ASM4079071v1_genomic	NZ_CP161145.1	1461	1971	510	renamed_GCF_000008685.2	lp54	1460	1970	510	100.0	8.829e-109
GCF_040790715.1_ASM4079071v1_genomic	NZ_CP161145.1	2895	2046	849	renamed_GCF_000008685.2	lp54	2893	2044	849	100.0	5.332e-188
GCF_040790715.1_ASM4079071v1_genomic	NZ_CP161145.1	28952	29405	453	renamed_GCF_000008685.2	lp54	28934	29387	453	100.0	2.51e-96
GCF_040790715.1_ASM4079071v1_genomic	NZ_CP161145.1	29401	29776	375	renamed_GCF_000008685.2	lp54	29383	29758	375	100.0	1.685e-79
GCF_040790715.1_ASM4079071v1_genomic	NZ_CP161145.1	30111	30651	540	renamed_GCF_000008685.2	lp54	30093	30633	540	100.0	4.969e-120
GCF_040790715.1_ASM4079071v1_genomic	NZ_CP161145.1	30727	31798	1071	renamed_GCF_000008685.2	lp54	30709	31780	1071	99.4	1.082e-234
GCF_040790715.1_ASM4079071v1_genomic	NZ_CP161145.1	31797	32220	423	renamed_GCF_000008685.2	lp54	31779	32202	423	100.0	5.086e-92
GCF_040790715.1_ASM4079071v1_genomic	NZ_CP161145.1	32278	32767	489	renamed_GCF_000008685.2	lp54	32260	32749	489	100.0	3.125e-108
GCF_040790715.1_ASM4079071v1_genomic	NZ_CP161145.1	50274	50049	225	renamed_GCF_000008685.2	lp54	50077	49852	225	100.0	1.962e-45
GCF_040790715.1_ASM4079071v1_genomic	NZ_CP161145.1	51373	50482	891	renamed_GCF_000008685.2	lp54	51176	50285	891	99.3	9.02e-198
GCF_040790715.1_ASM4079071v1_genomic	NZ_CP161145.1	51902	52676	774	renamed_GCF_000008685.2	lp54	51705	52479	774	100.0	9.219e-161
GCF_040790715.1_ASM4079071v1_genomic	NZ_CP161144.1	105698	105260	438	renamed_GCF_000008685.2	chromosome	105846	105417	438	97.8	4.286e-88
GCF_040790715.1_ASM4079071v1_genomic	NZ_CP161144.1	108013	106816	1197	renamed_GCF_000008685.2	chromosome	108170	106973	1197	99.7	1.869e-258
GCF_040790715.1_ASM4079071v1_genomic	NZ_CP161144.1	110885	109517	1368	renamed_GCF_000008685.2	chromosome	111042	109674	1368	100.0	1.976e-295
GCF_040790715.1_ASM4079071v1_genomic	NZ_CP161144.1	111717	111426	291	renamed_GCF_000008685.2	chromosome	111875	111584	291	100.0	1.894e-64
GCF_040790715.1_ASM4079071v1_genomic	NZ_CP161144.1	112611	112191	420	renamed_GCF_000008685.2	chromosome	112769	112349	420	99.2	1.444e-88
GCF_040790715.1_ASM4079071v1_genomic	NZ_CP161144.1	114648	115350	702	renamed_GCF_000008685.2	chromosome	114806	115508	702	98.7	1.276e-153
GCF_040790715.1_ASM4079071v1_genomic	NZ_CP161144.1	118771	118216	555	renamed_GCF_000008685.2	chromosome	118929	118374	555	99.4	3.776e-117
GCF_040790715.1_ASM4079071v1_genomic	NZ_CP161144.1	120431	119648	783	renamed_GCF_000008685.2	chromosome	120589	119806	783	99.6	5.024e-169
GCF_040790715.1_ASM4079071v1_genomic	NZ_CP161144.1	133683	132312	1371	renamed_GCF_000008685.2	chromosome	133842	132471	1371	100.0	2.422e-302
GCF_040790715.1_ASM4079071v1_genomic	NZ_CP161144.1	170936	170558	378	renamed_GCF_000008685.2	chromosome	171097	170719	378	98.4	1.768e-79
GCF_040790715.1_ASM4079071v1_genomic	NZ_CP161144.1	173419	171370	2049	renamed_GCF_000008685.2	chromosome	173535	171531	2049	99.2	0.0
GCF_040790715.1_ASM4079071v1_genomic	NZ_CP161144.1	176813	175907	906	renamed_GCF_000008685.2	chromosome	176974	176068	906	100.0	1.374e-195
GCF_040790715.1_ASM4079071v1_genomic	NZ_CP161144.1	178699	177706	993	renamed_GCF_000008685.2	chromosome	178860	177867	993	99.6	2.235e-213
GCF_040790715.1_ASM4079071v1_genomic	NZ_CP161144.1	181244	179378	1866	renamed_GCF_000008685.2	chromosome	181405	179539	1866	99.6	0.0
GCF_040790715.1_ASM4079071v1_genomic	NZ_CP161144.1	182724	183219	495	renamed_GCF_000008685.2	chromosome	182885	183380	495	100.0	9.271e-106
GCF_040790715.1_ASM4079071v1_genomic	NZ_CP161144.1	186392	186785	393	renamed_GCF_000008685.2	chromosome	186553	186946	393	100.0	5.626e-86
GCF_040790715.1_ASM4079071v1_genomic	NZ_CP161144.1	187670	187016	654	renamed_GCF_000008685.2	chromosome	187831	187177	654	100.0	1.397e-144
GCF_040790715.1_ASM4079071v1_genomic	NZ_CP161144.1	188333	188072	261	renamed_GCF_000008685.2	chromosome	188494	188233	261	100.0	7.054e-54
GCF_040790715.1_ASM4079071v1_genomic	NZ_CP161144.1	227681	226463	1218	renamed_GCF_000008685.2	chromosome	227827	226609	1218	99.7	3.023e-265
GCF_040790715.1_ASM4079071v1_genomic	NZ_CP161144.1	229070	230078	1008	renamed_GCF_000008685.2	chromosome	229216	230224	1008	99.4	2.993e-221
GCF_040790715.1_ASM4079071v1_genomic	NZ_CP161144.1	231474	232176	702	renamed_GCF_000008685.2	chromosome	231620	232322	702	100.0	1.161e-154
GCF_040790715.1_ASM4079071v1_genomic	NZ_CP161144.1	235388	235142	246	renamed_GCF_000008685.2	chromosome	235534	235288	246	98.7	3.025e-52
GCF_040790715.1_ASM4079071v1_genomic	NZ_CP161144.1	237483	237075	408	renamed_GCF_000008685.2	chromosome	237629	237221	408	100.0	2.649e-88
GCF_040790715.1_ASM4079071v1_genomic	NZ_CP161144.1	238080	237822	258	renamed_GCF_000008685.2	chromosome	238226	237968	258	100.0	9.113e-51
GCF_040790715.1_ASM4079071v1_genomic	NZ_CP161144.1	240104	238997	1107	renamed_GCF_000008685.2	chromosome	240250	239143	1107	99.1	1.835e-243
GCF_040790715.1_ASM4079071v1_genomic	NZ_CP161144.1	242291	243857	1566	renamed_GCF_000008685.2	chromosome	242437	244003	1566	98.8	0.0
GCF_040790715.1_ASM4079071v1_genomic	NZ_CP161144.1	255498	256113	615	renamed_GCF_000008685.2	chromosome	255645	256260	615	99.5	1.275e-130
GCF_040790715.1_ASM4079071v1_genomic	NZ_CP161144.1	293282	293057	225	renamed_GCF_000008685.2	chromosome	293429	293204	225	100.0	8.8e-46
GCF_040790715.1_ASM4079071v1_genomic	NZ_CP161144.1	295080	294636	444	renamed_GCF_000008685.2	chromosome	295228	294784	444	100.0	1.185e-94
GCF_040790715.1_ASM4079071v1_genomic	NZ_CP161144.1	296897	296279	618	renamed_GCF_000008685.2	chromosome	297045	296427	618	99.5	5.47e-132
GCF_040790715.1_ASM4079071v1_genomic	NZ_CP161144.1	298628	297317	1311	renamed_GCF_000008685.2	chromosome	298776	297465	1311	99.5	1.7e-287
GCF_040790715.1_ASM4079071v1_genomic	NZ_CP161144.1	300616	299581	1035	renamed_GCF_000008685.2	chromosome	300764	299729	1035	100.0	3.255e-216
GCF_040790715.1_ASM4079071v1_genomic	NZ_CP161144.1	302691	302355	336	renamed_GCF_000008685.2	chromosome	302839	302503	336	98.1	1.315e-67
GCF_040790715.1_ASM4079071v1_genomic	NZ_CP161144.1	303592	303184	408	renamed_GCF_000008685.2	chromosome	303740	303332	408	99.2	2.649e-88
GCF_040790715.1_ASM4079071v1_genomic	NZ_CP161144.1	412875	411330	1545	renamed_GCF_000008685.2	chromosome	413006	411455	1545	99.2	0.0
GCF_040790715.1_ASM4079071v1_genomic	NZ_CP161144.1	412987	414190	1203	renamed_GCF_000008685.2	chromosome	413112	414315	1203	99.5	7.009e-262
GCF_040790715.1_ASM4079071v1_genomic	NZ_CP161144.1	415668	414201	1467	renamed_GCF_000008685.2	chromosome	415793	414326	1467	99.5	0.0
GCF_040790715.1_ASM4079071v1_genomic	NZ_CP161144.1	443544	442995	549	renamed_GCF_000008685.2	chromosome	446875	446326	549	98.9	2.344e-121
GCF_040790715.1_ASM4079071v1_genomic	NZ_CP161144.1	444313	443638	675	renamed_GCF_000008685.2	chromosome	447736	446968	675	99.5	9.618e-144
GCF_040790715.1_ASM4079071v1_genomic	NZ_CP161144.1	444524	444842	318	renamed_GCF_000008685.2	chromosome	447854	448172	318	100.0	8.883e-69
GCF_040790715.1_ASM4079071v1_genomic	NZ_CP161144.1	445261	444871	390	renamed_GCF_000008685.2	chromosome	448591	448201	390	100.0	7.926e-82
GCF_040790715.1_ASM4079071v1_genomic	NZ_CP161144.1	445374	445980	606	renamed_GCF_000008685.2	chromosome	448707	449310	606	99.0	1.216e-129
GCF_040790715.1_ASM4079071v1_genomic	NZ_CP161144.1	446088	446841	753	renamed_GCF_000008685.2	chromosome	449418	450171	753	100.0	3.278e-160
GCF_040790715.1_ASM4079071v1_genomic	NZ_CP161144.1	448591	447808	783	renamed_GCF_000008685.2	chromosome	451921	451138	783	99.2	5.024e-169
GCF_040790715.1_ASM4079071v1_genomic	NZ_CP161144.1	451142	448709	2433	renamed_GCF_000008685.2	chromosome	454472	452039	2433	100.0	0.0
GCF_040790715.1_ASM4079071v1_genomic	NZ_CP161144.1	453058	451153	1905	renamed_GCF_000008685.2	chromosome	456388	454483	1905	99.8	0.0
GCF_040790715.1_ASM4079071v1_genomic	NZ_CP161144.1	474743	472931	1812	renamed_GCF_000008685.2	chromosome	478005	476262	1812	99.4	0.0
GCF_040790715.1_ASM4079071v1_genomic	NZ_CP161144.1	476374	477685	1311	renamed_GCF_000008685.2	chromosome	479708	481019	1311	100.0	7.438e-297
GCF_040790715.1_ASM4079071v1_genomic	NZ_CP161144.1	478723	478009	714	renamed_GCF_000008685.2	chromosome	482057	481343	714	100.0	3.944e-160
GCF_040790715.1_ASM4079071v1_genomic	NZ_CP161144.1	479265	480948	1683	renamed_GCF_000008685.2	chromosome	482599	484282	1683	99.4	0.0
GCF_040790715.1_ASM4079071v1_genomic	NZ_CP161144.1	481428	481932	504	renamed_GCF_000008685.2	chromosome	484756	485266	504	100.0	1.216e-112
GCF_040790715.1_ASM4079071v1_genomic	NZ_CP161144.1	482739	483435	696	renamed_GCF_000008685.2	chromosome	486073	486769	696	100.0	2.835e-152
GCF_040790715.1_ASM4079071v1_genomic	NZ_CP161144.1	484200	484890	690	renamed_GCF_000008685.2	chromosome	487534	488224	690	99.5	4.749e-154
GCF_040790715.1_ASM4079071v1_genomic	NZ_CP161144.1	494561	494858	297	renamed_GCF_000008685.2	chromosome	497894	498191	297	100.0	5.69e-62
GCF_040790715.1_ASM4079071v1_genomic	NZ_CP161144.1	495722	496001	279	renamed_GCF_000008685.2	chromosome	499055	499334	279	100.0	1.411e-57
GCF_040790715.1_ASM4079071v1_genomic	NZ_CP161144.1	525857	524762	1095	renamed_GCF_000008685.2	chromosome	529198	528103	1095	99.7	8.741e-250
GCF_040790715.1_ASM4079071v1_genomic	NZ_CP161144.1	528351	527787	564	renamed_GCF_000008685.2	chromosome	531692	531128	564	100.0	2.704e-122
GCF_040790715.1_ASM4079071v1_genomic	NZ_CP161144.1	532260	531837	423	renamed_GCF_000008685.2	chromosome	535600	535177	423	99.2	2.776e-90
GCF_040790715.1_ASM4079071v1_genomic	NZ_CP161144.1	534179	534968	789	renamed_GCF_000008685.2	chromosome	537543	538308	789	98.8	3.287e-166
GCF_040790715.1_ASM4079071v1_genomic	NZ_CP161144.1	538922	539684	762	renamed_GCF_000008685.2	chromosome	542262	543024	762	99.2	1.347e-171
GCF_040790715.1_ASM4079071v1_genomic	NZ_CP161144.1	540491	541265	774	renamed_GCF_000008685.2	chromosome	543831	544605	774	99.6	1.962e-169
GCF_040790715.1_ASM4079071v1_genomic	NZ_CP161144.1	545150	544505	645	renamed_GCF_000008685.2	chromosome	548490	547845	645	100.0	1.056e-137
GCF_040790715.1_ASM4079071v1_genomic	NZ_CP161144.1	633226	634591	1365	renamed_GCF_000008685.2	chromosome	636592	637957	1365	99.1	3.824e-296
GCF_040790715.1_ASM4079071v1_genomic	NZ_CP161144.1	635213	636506	1293	renamed_GCF_000008685.2	chromosome	638579	639872	1293	99.5	1.544e-285
GCF_040790715.1_ASM4079071v1_genomic	NZ_CP161144.1	638922	639075	153	renamed_GCF_000008685.2	chromosome	642288	642441	153	98.0	2.814e-30
GCF_040790715.1_ASM4079071v1_genomic	NZ_CP161144.1	641284	639928	1356	renamed_GCF_000008685.2	chromosome	644650	643294	1356	99.7	8.637e-303
GCF_040790715.1_ASM4079071v1_genomic	NZ_CP161144.1	642235	641770	465	renamed_GCF_000008685.2	chromosome	645601	645136	465	100.0	4.176e-101
GCF_040790715.1_ASM4079071v1_genomic	NZ_CP161144.1	644960	643292	1668	renamed_GCF_000008685.2	chromosome	648254	646658	1668	99.4	0.0
GCF_040790715.1_ASM4079071v1_genomic	NZ_CP161144.1	647021	645803	1218	renamed_GCF_000008685.2	chromosome	650387	649169	1218	99.7	6.126e-266
GCF_040790715.1_ASM4079071v1_genomic	NZ_CP161144.1	650520	651483	963	renamed_GCF_000008685.2	chromosome	653886	654849	963	100.0	5.23e-216
GCF_040790715.1_ASM4079071v1_genomic	NZ_CP161144.1	671667	673011	1344	renamed_GCF_000008685.2	chromosome	675034	676378	1344	99.7	1.793e-292
GCF_040790715.1_ASM4079071v1_genomic	NZ_CP161144.1	675567	674520	1047	renamed_GCF_000008685.2	chromosome	678938	677891	1047	100.0	5.633e-238
GCF_040790715.1_ASM4079071v1_genomic	NZ_CP161144.1	707304	707790	486	renamed_GCF_000008685.2	chromosome	710685	711171	486	100.0	5.304e-102
GCF_040790715.1_ASM4079071v1_genomic	NZ_CP161144.1	708826	708310	516	renamed_GCF_000008685.2	chromosome	712207	711691	516	99.4	8.019e-111
GCF_040790715.1_ASM4079071v1_genomic	NZ_CP161144.1	710726	709862	864	renamed_GCF_000008685.2	chromosome	714107	713243	864	100.0	1.134e-190
GCF_040790715.1_ASM4079071v1_genomic	NZ_CP161144.1	711627	713238	1611	renamed_GCF_000008685.2	chromosome	715008	716619	1611	99.8	0.0
GCF_040790715.1_ASM4079071v1_genomic	NZ_CP161144.1	714361	715288	927	renamed_GCF_000008685.2	chromosome	717742	718669	927	100.0	3.519e-197
GCF_040790715.1_ASM4079071v1_genomic	NZ_CP161144.1	717734	719636	1902	renamed_GCF_000008685.2	chromosome	721118	723020	1902	99.6	0.0
GCF_040790715.1_ASM4079071v1_genomic	NZ_CP161144.1	720839	722063	1224	renamed_GCF_000008685.2	chromosome	724223	725447	1224	99.5	3.533e-273
GCF_040790715.1_ASM4079071v1_genomic	NZ_CP161144.1	723100	724369	1269	renamed_GCF_000008685.2	chromosome	726457	727753	1269	96.6	8.539e-271
GCF_040790715.1_ASM4079071v1_genomic	NZ_CP161144.1	734323	735043	720	renamed_GCF_000008685.2	chromosome	737708	738428	720	99.5	4.764e-159
GCF_040790715.1_ASM4079071v1_genomic	NZ_CP161144.1	735758	736298	540	renamed_GCF_000008685.2	chromosome	739143	739683	540	100.0	2.458e-119
GCF_040790715.1_ASM4079071v1_genomic	NZ_CP161144.1	773295	772281	1014	renamed_GCF_000008685.2	chromosome	776679	775665	1014	99.7	8.011e-220
GCF_040790715.1_ASM4079071v1_genomic	NZ_CP161144.1	774380	775370	990	renamed_GCF_000008685.2	chromosome	777764	778754	990	99.6	1.559e-225
GCF_040790715.1_ASM4079071v1_genomic	NZ_CP161144.1	779445	778767	678	renamed_GCF_000008685.2	chromosome	782829	782151	678	97.7	6.295e-149
GCF_040790715.1_ASM4079071v1_genomic	NZ_CP161144.1	780005	781637	1632	renamed_GCF_000008685.2	chromosome	783389	785021	1632	99.8	0.0
GCF_040790715.1_ASM4079071v1_genomic	NZ_CP161144.1	783475	785578	2103	renamed_GCF_000008685.2	chromosome	786859	788962	2103	99.4	0.0
GCF_040790715.1_ASM4079071v1_genomic	NZ_CP161144.1	787421	786560	861	renamed_GCF_000008685.2	chromosome	790807	789946	861	100.0	1.57e-186
GCF_040790715.1_ASM4079071v1_genomic	NZ_CP161144.1	788866	788407	459	renamed_GCF_000008685.2	chromosome	792252	791793	459	99.3	2.509e-97
GCF_040790715.1_ASM4079071v1_genomic	NZ_CP161144.1	803538	802389	1149	renamed_GCF_000008685.2	chromosome	806923	805774	1149	99.7	5.42e-247
GCF_040790715.1_ASM4079071v1_genomic	NZ_CP161144.1	832711	835177	2466	renamed_GCF_000008685.2	chromosome	836060	838526	2466	99.5	0.0
GCF_040790715.1_ASM4079071v1_genomic	NZ_CP161144.1	835894	838483	2589	renamed_GCF_000008685.2	chromosome	839243	841832	2589	99.6	0.0
GCF_040790715.1_ASM4079071v1_genomic	NZ_CP161144.1	839202	839640	438	renamed_GCF_000008685.2	chromosome	842500	842989	438	97.9	6.471e-92
GCF_040790715.1_ASM4079071v1_genomic	NZ_CP161144.1	854126	855536	1410	renamed_GCF_000008685.2	chromosome	857505	858915	1410	99.3	7.483e-305
GCF_040790715.1_ASM4079071v1_genomic	NZ_CP161144.1	857060	858395	1335	renamed_GCF_000008685.2	chromosome	860439	861774	1335	98.6	5.478e-287
GCF_040790715.1_ASM4079071v1_genomic	NZ_CP161144.1	860257	861664	1407	renamed_GCF_000008685.2	chromosome	863635	865042	1407	99.5	3.133e-314
GCF_040790715.1_ASM4079071v1_genomic	NZ_CP161144.1	862537	863080	543	renamed_GCF_000008685.2	chromosome	865915	866458	543	98.8	6.309e-118
GCF_040790715.1_ASM4079071v1_genomic	NZ_CP161144.1	863302	864223	921	renamed_GCF_000008685.2	chromosome	866680	867601	921	99.3	3.387e-205
GCF_040790715.1_ASM4079071v1_genomic	NZ_CP161144.1	883069	880849	2220	renamed_GCF_000008685.2	chromosome	886447	884227	2220	99.0	0.0
GCF_040790715.1_ASM4079071v1_genomic	NZ_CP161154.1	4769	5867	1098	renamed_GCF_000008685.2	cp26	4768	5866	1098	100.0	2.035e-249
GCF_040790715.1_ASM4079071v1_genomic	NZ_CP161154.1	6677	7715	1038	renamed_GCF_000008685.2	cp26	6676	7714	1038	99.4	4.211e-231
GCF_040790715.1_ASM4079071v1_genomic	NZ_CP161154.1	21918	22614	696	renamed_GCF_000008685.2	cp26	21897	22593	696	99.5	6.925e-151
GCF_040790715.1_ASM4079071v1_genomic	NZ_CP161154.1	23275	24520	1245	renamed_GCF_000008685.2	cp26	23254	24499	1245	99.7	5.213e-281
GCF_040790715.1_ASM4079071v1_genomic	NZ_CP161146.1	2	1289	1287	renamed_GCF_000008685.2	cp32-6	65	1289	1287	99.5	6.099e-269
GCF_040790715.1_ASM4079071v1_genomic	NZ_CP161146.1	2009	2576	567	renamed_GCF_000008685.2	lp56	35818	36385	567	100.0	4.74e-125
GCF_040790715.1_ASM4079071v1_genomic	NZ_CP161146.1	4951	5407	456	renamed_GCF_000008685.2	cp32-6	4948	5404	456	99.3	5.32e-97
GCF_040790715.1_ASM4079071v1_genomic	NZ_CP161146.1	6163	6730	567	renamed_GCF_000008685.2	lp56	9623	10190	567	98.9	1.159e-123
GCF_040790715.1_ASM4079071v1_genomic	NZ_CP161146.1	22270	22828	558	renamed_GCF_000008685.2	cp32-3	22592	23183	558	74.8	1.918e-91
GCF_040790715.1_ASM4079071v1_genomic	NZ_CP161146.1	26337	27039	702	renamed_GCF_000008685.2	cp32-7	26151	26841	702	81.59	3.385e-117
GCF_040790715.1_ASM4079071v1_genomic	NZ_CP161146.1	28968	30321	1353	renamed_GCF_000008685.2	cp32-6	28485	29838	1353	99.5	6.861e-305
GCF_040790715.1_ASM4079071v1_genomic	NZ_CP161147.1	3973	4933	960	renamed_GCF_000008685.2	cp32-6	3969	4929	960	100.0	6.008e-214
GCF_040790715.1_ASM4079071v1_genomic	NZ_CP161147.1	19537	20635	1098	renamed_GCF_000008685.2	cp32-4	18959	20057	1098	97.8	6.545e-245
GCF_040790715.1_ASM4079071v1_genomic	NZ_CP161147.1	21186	21942	756	renamed_GCF_000008685.2	cp32-4	20608	21364	756	98.8	4.353e-166
GCF_040790715.1_ASM4079071v1_genomic	NZ_CP161147.1	22550	23045	495	renamed_GCF_000008685.2	cp32-9	22183	22723	495	69.79	4.44e-72
GCF_040790715.1_ASM4079071v1_genomic	NZ_CP161147.1	26101	25324	777	renamed_GCF_000008685.2	cp32-7	25720	24943	777	100.0	1.414e-173
GCF_040790715.1_ASM4079071v1_genomic	NZ_CP161147.1	28389	28956	567	renamed_GCF_000008685.2	cp32-1	28834	29401	567	94.1	2.483e-115
GCF_040790715.1_ASM4079071v1_genomic	NZ_CP161148.1	7836	8265	429	renamed_GCF_000008685.2	cp32-4	7837	8266	429	100.0	5.601e-92
GCF_040790715.1_ASM4079071v1_genomic	NZ_CP161148.1	8732	8969	237	renamed_GCF_000008685.2	cp32-7	8725	8962	237	100.0	7.893e-49
GCF_040790715.1_ASM4079071v1_genomic	NZ_CP161152.1	2897	3686	789	renamed_GCF_000008685.2	lp21	2867	3656	789	99.6	6.373e-176
GCF_040790715.1_ASM4079071v1_genomic	NZ_CP161152.1	12981	13512	531	renamed_GCF_000008685.2	cp9	4377	3852	531	66.4	4.169e-70
GCF_040790715.1_ASM4079071v1_genomic	NZ_CP161152.1	14933	16049	1116	renamed_GCF_000008685.2	cp9	162	1272	1116	88.3	1.916e-218
GCF_040790715.1_ASM4079071v1_genomic	NZ_CP161152.1	16176	16617	441	renamed_GCF_000008685.2	cp9	1281	1839	441	98.6	4.183e-97
GCF_040790715.1_ASM4079071v1_genomic	NZ_CP161152.1	19945	20485	540	renamed_GCF_000008685.2	cp9	6808	6280	540	87.1	4.907e-95
GCF_040790715.1_ASM4079071v1_genomic	NZ_CP161152.1	23323	23911	588	renamed_GCF_000008685.2	lp21	14647	15235	588	100.0	4.973e-128
GCF_040790715.1_ASM4079071v1_genomic	NZ_CP161152.1	24466	24760	294	renamed_GCF_000008685.2	lp21	15790	16084	294	100.0	2.432e-62
GCF_040790715.1_ASM4079071v1_genomic	NZ_CP161152.1	25561	26554	993	renamed_GCF_000008685.2	lp5	3339	4332	993	100.0	1.858e-215
GCF_040790715.1_ASM4079071v1_genomic	NZ_CP161151.1	18819	19449	630	renamed_GCF_000008685.2	lp28-3	18797	19427	630	99.5	4.977e-135
GCF_040790715.1_ASM4079071v1_genomic	NZ_CP161153.1	26452	26098	354	renamed_GCF_000008685.2	lp5	743	1097	354	99.1	7.983e-76
GCF_040790715.1_ASM4079071v1_genomic	NZ_CP161150.1	15808	15262	546	renamed_GCF_000008685.2	lp28-2	15431	14885	546	99.4	2.156e-113
GCF_040790715.1_ASM4079071v1_genomic	NZ_CP161150.1	18061	16870	1191	renamed_GCF_000008685.2	lp28-2	17684	16493	1191	99.4	7.436e-268
GCF_040790715.1_ASM4079071v1_genomic	NZ_CP161150.1	19186	18406	780	renamed_GCF_000008685.2	lp28-2	18827	18029	780	86.0	1.614e-155
GCF_040790715.1_ASM4079071v1_genomic	NZ_CP161150.1	22660	19978	2682	renamed_GCF_000008685.2	lp28-2	22259	19619	2682	97.3	0.0
GCF_040790715.1_ASM4079071v1_genomic	NZ_CP161150.1	23432	23060	372	renamed_GCF_000008685.2	lp28-2	23033	22658	372	80.4	3.483e-63
GCF_040790715.1_ASM4079071v1_genomic	NZ_CP161156.1	6313	5617	696	renamed_GCF_000008685.2	lp36	8859	8163	696	97.8	8.359e-149
GCF_040790715.1_ASM4079071v1_genomic	NZ_CP161145.1	9458	10280	822	renamed_GCF_000008685.2	lp54	9456	10278	822	98.9	1.553e-171
GCF_040790715.1_ASM4079071v1_genomic	NZ_CP161145.1	13612	14365	753	renamed_GCF_000008685.2	lp54	13554	14307	753	100.0	4.561e-165
GCF_040790715.1_ASM4079071v1_genomic	NZ_CP161145.1	16656	16089	567	renamed_GCF_000008685.2	lp54	16576	16000	567	91.8	1.571e-103
GCF_040790715.1_ASM4079071v1_genomic	NZ_CP161145.1	18207	18801	594	renamed_GCF_000008685.2	lp54	18127	18721	594	99.4	7.271e-125
GCF_040790715.1_ASM4079071v1_genomic	NZ_CP161145.1	20742	20937	195	renamed_GCF_000008685.2	lp54	20717	20912	195	100.0	2.214e-39
GCF_040790715.1_ASM4079071v1_genomic	NZ_CP161145.1	23298	21708	1590	renamed_GCF_000008685.2	lp54	23273	21683	1590	99.6	0.0
GCF_040790715.1_ASM4079071v1_genomic	NZ_CP161145.1	24525	25131	606	renamed_GCF_000008685.2	lp54	24497	25103	606	99.5	1.47e-127
GCF_040790715.1_ASM4079071v1_genomic	NZ_CP161145.1	32759	32978	219	renamed_GCF_000008685.2	lp54	32741	32960	219	100.0	7.958e-46
GCF_040790715.1_ASM4079071v1_genomic	NZ_CP161144.1	22655	23795	1140	renamed_GCF_000008685.2	chromosome	22818	23958	1140	97.8	4.164e-257
GCF_040790715.1_ASM4079071v1_genomic	NZ_CP161144.1	25460	24533	927	renamed_GCF_000008685.2	chromosome	25623	24696	927	98.3	7.127e-198
GCF_040790715.1_ASM4079071v1_genomic	NZ_CP161144.1	26235	27285	1050	renamed_GCF_000008685.2	chromosome	26398	27448	1050	100.0	7.794e-235
GCF_040790715.1_ASM4079071v1_genomic	NZ_CP161144.1	28327	27691	636	renamed_GCF_000008685.2	chromosome	28490	27854	636	99.5	9.161e-138
GCF_040790715.1_ASM4079071v1_genomic	NZ_CP161144.1	29380	30862	1482	renamed_GCF_000008685.2	chromosome	29542	31015	1482	97.1	0.0
GCF_040790715.1_ASM4079071v1_genomic	NZ_CP161144.1	31936	31396	540	renamed_GCF_000008685.2	chromosome	32089	31549	540	100.0	3.274e-116
GCF_040790715.1_ASM4079071v1_genomic	NZ_CP161144.1	35683	33883	1800	renamed_GCF_000008685.2	chromosome	35836	34036	1800	100.0	0.0
GCF_040790715.1_ASM4079071v1_genomic	NZ_CP161144.1	69410	69971	561	renamed_GCF_000008685.2	chromosome	69565	70126	561	100.0	3.775e-118
GCF_040790715.1_ASM4079071v1_genomic	NZ_CP161144.1	71045	72455	1410	renamed_GCF_000008685.2	chromosome	71200	72610	1410	99.5	1.263e-307
GCF_040790715.1_ASM4079071v1_genomic	NZ_CP161144.1	75617	76298	681	renamed_GCF_000008685.2	chromosome	75773	76454	681	100.0	3.584e-147
GCF_040790715.1_ASM4079071v1_genomic	NZ_CP161144.1	78853	77554	1299	renamed_GCF_000008685.2	chromosome	79009	77710	1299	99.7	4.127e-284
GCF_040790715.1_ASM4079071v1_genomic	NZ_CP161144.1	79348	80617	1269	renamed_GCF_000008685.2	chromosome	79504	80773	1269	100.0	1.4e-282
GCF_040790715.1_ASM4079071v1_genomic	NZ_CP161144.1	93876	93276	600	renamed_GCF_000008685.2	chromosome	94032	93432	600	100.0	1.47e-126
GCF_040790715.1_ASM4079071v1_genomic	NZ_CP161144.1	96797	94454	2343	renamed_GCF_000008685.2	chromosome	96953	94610	2343	98.8	0.0
GCF_040790715.1_ASM4079071v1_genomic	NZ_CP161144.1	98624	97706	918	renamed_GCF_000008685.2	chromosome	98648	97862	918	99.2	2.569e-173
GCF_040790715.1_ASM4079071v1_genomic	NZ_CP161144.1	101182	100588	594	renamed_GCF_000008685.2	chromosome	101339	100745	594	100.0	6.255e-135
GCF_040790715.1_ASM4079071v1_genomic	NZ_CP161144.1	211154	211922	768	renamed_GCF_000008685.2	chromosome	211300	212068	768	100.0	8.822e-169
GCF_040790715.1_ASM4079071v1_genomic	NZ_CP161144.1	215280	217113	1833	renamed_GCF_000008685.2	chromosome	215426	217259	1833	99.1	0.0
GCF_040790715.1_ASM4079071v1_genomic	NZ_CP161144.1	218932	218278	654	renamed_GCF_000008685.2	chromosome	219078	218424	654	100.0	1.052e-147
GCF_040790715.1_ASM4079071v1_genomic	NZ_CP161144.1	219653	220493	840	renamed_GCF_000008685.2	chromosome	219799	220639	840	100.0	1.641e-182
GCF_040790715.1_ASM4079071v1_genomic	NZ_CP161144.1	223032	223815	783	renamed_GCF_000008685.2	chromosome	223178	223961	783	99.2	8.433e-172
GCF_040790715.1_ASM4079071v1_genomic	NZ_CP161144.1	245642	246407	765	renamed_GCF_000008685.2	chromosome	245789	246554	765	100.0	7.663e-170
GCF_040790715.1_ASM4079071v1_genomic	NZ_CP161144.1	248379	249942	1563	renamed_GCF_000008685.2	chromosome	248505	250089	1563	99.8	0.0
GCF_040790715.1_ASM4079071v1_genomic	NZ_CP161144.1	250523	250028	495	renamed_GCF_000008685.2	chromosome	250670	250175	495	100.0	5.051e-104
GCF_040790715.1_ASM4079071v1_genomic	NZ_CP161144.1	252090	251064	1026	renamed_GCF_000008685.2	chromosome	252237	251211	1026	99.4	1.351e-224
GCF_040790715.1_ASM4079071v1_genomic	NZ_CP161144.1	253011	254784	1773	renamed_GCF_000008685.2	chromosome	253158	254931	1773	98.9	0.0
GCF_040790715.1_ASM4079071v1_genomic	NZ_CP161144.1	283718	282551	1167	renamed_GCF_000008685.2	chromosome	283865	282698	1167	100.0	1.172e-258
GCF_040790715.1_ASM4079071v1_genomic	NZ_CP161144.1	286942	285823	1119	renamed_GCF_000008685.2	chromosome	287089	285970	1119	100.0	9.957e-244
GCF_040790715.1_ASM4079071v1_genomic	NZ_CP161144.1	288026	287762	264	renamed_GCF_000008685.2	chromosome	288173	287909	264	100.0	2.025e-51
GCF_040790715.1_ASM4079071v1_genomic	NZ_CP161144.1	289436	288809	627	renamed_GCF_000008685.2	chromosome	289583	288956	627	100.0	2.836e-132
GCF_040790715.1_ASM4079071v1_genomic	NZ_CP161144.1	290874	289815	1059	renamed_GCF_000008685.2	chromosome	291021	289962	1059	100.0	3.164e-229
GCF_040790715.1_ASM4079071v1_genomic	NZ_CP161144.1	309632	308390	1242	renamed_GCF_000008685.2	chromosome	309780	308538	1242	100.0	1.368e-269
GCF_040790715.1_ASM4079071v1_genomic	NZ_CP161144.1	311505	310410	1095	renamed_GCF_000008685.2	chromosome	311617	310558	1095	99.4	1.229e-228
GCF_040790715.1_ASM4079071v1_genomic	NZ_CP161144.1	313976	312584	1392	renamed_GCF_000008685.2	chromosome	314123	312728	1392	100.0	1.047e-306
GCF_040790715.1_ASM4079071v1_genomic	NZ_CP161144.1	315167	314276	891	renamed_GCF_000008685.2	chromosome	315314	314423	891	99.3	2.2e-196
GCF_040790715.1_ASM4079071v1_genomic	NZ_CP161144.1	317069	315992	1077	renamed_GCF_000008685.2	chromosome	317216	316139	1077	99.7	9.003e-238
GCF_040790715.1_ASM4079071v1_genomic	NZ_CP161144.1	416976	417588	612	renamed_GCF_000008685.2	chromosome	417101	417713	612	100.0	4.975e-132
GCF_040790715.1_ASM4079071v1_genomic	NZ_CP161144.1	419381	418262	1119	renamed_GCF_000008685.2	chromosome	419506	418387	1119	99.7	1.781e-254
GCF_040790715.1_ASM4079071v1_genomic	NZ_CP161144.1	421428	422058	630	renamed_GCF_000008685.2	chromosome	421553	422183	630	98.5	1.533e-139
GCF_040790715.1_ASM4079071v1_genomic	NZ_CP161144.1	422932	423712	780	renamed_GCF_000008685.2	chromosome	423054	423834	780	99.6	1.628e-172
GCF_040790715.1_ASM4079071v1_genomic	NZ_CP161144.1	424570	425428	858	renamed_GCF_000008685.2	chromosome	424693	425551	858	100.0	1.579e-194
GCF_040790715.1_ASM4079071v1_genomic	NZ_CP161144.1	456194	456494	300	renamed_GCF_000008685.2	chromosome	459524	459824	300	95.9	4.432e-57
GCF_040790715.1_ASM4079071v1_genomic	NZ_CP161144.1	456721	457081	360	renamed_GCF_000008685.2	chromosome	460051	460411	360	99.1	5.311e-73
GCF_040790715.1_ASM4079071v1_genomic	NZ_CP161144.1	459488	460556	1068	renamed_GCF_000008685.2	chromosome	462818	463886	1068	99.7	9.979e-244
GCF_040790715.1_ASM4079071v1_genomic	NZ_CP161144.1	463947	462186	1761	renamed_GCF_000008685.2	chromosome	467278	465517	1761	99.4	0.0
GCF_040790715.1_ASM4079071v1_genomic	NZ_CP161144.1	484891	485638	747	renamed_GCF_000008685.2	chromosome	488225	488972	747	100.0	3.778e-166
GCF_040790715.1_ASM4079071v1_genomic	NZ_CP161144.1	509806	509059	747	renamed_GCF_000008685.2	chromosome	513139	512392	747	99.5	3.599e-158
GCF_040790715.1_ASM4079071v1_genomic	NZ_CP161144.1	509892	511194	1302	renamed_GCF_000008685.2	chromosome	513225	514527	1302	99.3	1.946e-284
GCF_040790715.1_ASM4079071v1_genomic	NZ_CP161144.1	550657	551878	1221	renamed_GCF_000008685.2	chromosome	553991	555212	1221	100.0	5.34e-268
GCF_040790715.1_ASM4079071v1_genomic	NZ_CP161144.1	551881	553246	1365	renamed_GCF_000008685.2	chromosome	555215	556580	1365	98.8	3.723e-305
GCF_040790715.1_ASM4079071v1_genomic	NZ_CP161144.1	554089	553228	861	renamed_GCF_000008685.2	chromosome	557423	556562	861	99.3	3.179e-187
GCF_040790715.1_ASM4079071v1_genomic	NZ_CP161144.1	554690	554072	618	renamed_GCF_000008685.2	chromosome	558024	557406	618	100.0	1.216e-131
GCF_040790715.1_ASM4079071v1_genomic	NZ_CP161144.1	557398	554671	2727	renamed_GCF_000008685.2	chromosome	560732	558005	2727	99.4	0.0
GCF_040790715.1_ASM4079071v1_genomic	NZ_CP161144.1	557793	557394	399	renamed_GCF_000008685.2	chromosome	561127	560728	399	96.2	1.01e-80
GCF_040790715.1_ASM4079071v1_genomic	NZ_CP161144.1	558202	557782	420	renamed_GCF_000008685.2	chromosome	561554	561116	420	93.0	2.589e-82
GCF_040790715.1_ASM4079071v1_genomic	NZ_CP161144.1	581520	580830	690	renamed_GCF_000008685.2	chromosome	584880	584190	690	99.1	4.749e-154
GCF_040790715.1_ASM4079071v1_genomic	NZ_CP161144.1	581731	582796	1065	renamed_GCF_000008685.2	chromosome	585079	586156	1065	98.0	9.851e-235
GCF_040790715.1_ASM4079071v1_genomic	NZ_CP161144.1	583670	584522	852	renamed_GCF_000008685.2	chromosome	587030	587882	852	98.5	4.638e-190
GCF_040790715.1_ASM4079071v1_genomic	NZ_CP161144.1	584705	586307	1602	renamed_GCF_000008685.2	chromosome	588065	589667	1602	99.8	0.0
GCF_040790715.1_ASM4079071v1_genomic	NZ_CP161144.1	586848	586323	525	renamed_GCF_000008685.2	chromosome	590208	589683	525	97.7	3.018e-106
GCF_040790715.1_ASM4079071v1_genomic	NZ_CP161144.1	586987	587575	588	renamed_GCF_000008685.2	chromosome	590347	590935	588	99.4	4.112e-130
GCF_040790715.1_ASM4079071v1_genomic	NZ_CP161144.1	587822	588992	1170	renamed_GCF_000008685.2	chromosome	591187	592357	1170	98.9	5.197e-251
GCF_040790715.1_ASM4079071v1_genomic	NZ_CP161144.1	589122	592566	3444	renamed_GCF_000008685.2	chromosome	592445	595931	3444	99.4	0.0
GCF_040790715.1_ASM4079071v1_genomic	NZ_CP161144.1	592577	593156	579	renamed_GCF_000008685.2	chromosome	595942	596521	579	99.4	1.865e-120
GCF_040790715.1_ASM4079071v1_genomic	NZ_CP161144.1	607828	606577	1251	renamed_GCF_000008685.2	chromosome	611193	609942	1251	98.3	2.071e-266
GCF_040790715.1_ASM4079071v1_genomic	NZ_CP161144.1	607943	608657	714	renamed_GCF_000008685.2	chromosome	611308	612022	714	99.5	9.633e-159
GCF_040790715.1_ASM4079071v1_genomic	NZ_CP161144.1	608682	610620	1938	renamed_GCF_000008685.2	chromosome	612047	613985	1938	99.8	0.0
GCF_040790715.1_ASM4079071v1_genomic	NZ_CP161144.1	612406	610648	1758	renamed_GCF_000008685.2	chromosome	615771	614013	1758	99.1	0.0
GCF_040790715.1_ASM4079071v1_genomic	NZ_CP161144.1	613025	612398	627	renamed_GCF_000008685.2	chromosome	616390	615763	627	99.0	1.402e-131
GCF_040790715.1_ASM4079071v1_genomic	NZ_CP161144.1	615194	613046	2148	renamed_GCF_000008685.2	chromosome	618559	616411	2148	99.8	0.0
GCF_040790715.1_ASM4079071v1_genomic	NZ_CP161144.1	615462	617670	2208	renamed_GCF_000008685.2	chromosome	618827	621035	2208	100.0	0.0
GCF_040790715.1_ASM4079071v1_genomic	NZ_CP161144.1	618588	617679	909	renamed_GCF_000008685.2	chromosome	621953	621044	909	99.3	3.709e-202
GCF_040790715.1_ASM4079071v1_genomic	NZ_CP161144.1	618639	620082	1443	renamed_GCF_000008685.2	chromosome	622004	623447	1443	99.1	0.0
GCF_040790715.1_ASM4079071v1_genomic	NZ_CP161144.1	620085	621642	1557	renamed_GCF_000008685.2	chromosome	623450	625007	1557	98.6	0.0
GCF_040790715.1_ASM4079071v1_genomic	NZ_CP161144.1	665151	661641	3510	renamed_GCF_000008685.2	chromosome	668517	665007	3510	99.4	0.0
GCF_040790715.1_ASM4079071v1_genomic	NZ_CP161144.1	669845	668399	1446	renamed_GCF_000008685.2	chromosome	673167	671766	1446	98.7	5.364e-306
GCF_040790715.1_ASM4079071v1_genomic	NZ_CP161144.1	682610	681626	984	renamed_GCF_000008685.2	chromosome	685980	684996	984	99.3	1.874e-222
GCF_040790715.1_ASM4079071v1_genomic	NZ_CP161144.1	683137	682606	531	renamed_GCF_000008685.2	chromosome	686507	685976	531	100.0	1.053e-118
GCF_040790715.1_ASM4079071v1_genomic	NZ_CP161144.1	685119	686757	1638	renamed_GCF_000008685.2	chromosome	688489	690127	1638	100.0	0.0
GCF_040790715.1_ASM4079071v1_genomic	NZ_CP161144.1	686822	687119	297	renamed_GCF_000008685.2	chromosome	690192	690489	297	100.0	1.037e-63
GCF_040790715.1_ASM4079071v1_genomic	NZ_CP161144.1	687132	687429	297	renamed_GCF_000008685.2	chromosome	690481	690799	297	98.9	6.955e-60
GCF_040790715.1_ASM4079071v1_genomic	NZ_CP161144.1	687514	689275	1761	renamed_GCF_000008685.2	chromosome	690884	692645	1761	99.6	0.0
GCF_040790715.1_ASM4079071v1_genomic	NZ_CP161144.1	731966	733301	1335	renamed_GCF_000008685.2	chromosome	735351	736686	1335	99.5	6.578e-285
GCF_040790715.1_ASM4079071v1_genomic	NZ_CP161144.1	733313	733574	261	renamed_GCF_000008685.2	chromosome	736698	736959	261	100.0	3.165e-54
GCF_040790715.1_ASM4079071v1_genomic	NZ_CP161144.1	733574	733823	249	renamed_GCF_000008685.2	chromosome	736959	737208	249	100.0	2.148e-48
GCF_040790715.1_ASM4079071v1_genomic	NZ_CP161144.1	741136	741460	324	renamed_GCF_000008685.2	chromosome	744521	744845	324	99.0	2.941e-65
GCF_040790715.1_ASM4079071v1_genomic	NZ_CP161144.1	741916	742948	1032	renamed_GCF_000008685.2	chromosome	745301	746333	1032	98.8	6.089e-226
GCF_040790715.1_ASM4079071v1_genomic	NZ_CP161144.1	744738	746634	1896	renamed_GCF_000008685.2	chromosome	748122	750018	1896	100.0	0.0
GCF_040790715.1_ASM4079071v1_genomic	NZ_CP161144.1	746646	747405	759	renamed_GCF_000008685.2	chromosome	750030	750789	759	100.0	2.255e-165
GCF_040790715.1_ASM4079071v1_genomic	NZ_CP161144.1	747806	748775	969	renamed_GCF_000008685.2	chromosome	751190	752159	969	100.0	4.772e-218
GCF_040790715.1_ASM4079071v1_genomic	NZ_CP161144.1	748785	749835	1050	renamed_GCF_000008685.2	chromosome	752169	753219	1050	100.0	6.109e-229
GCF_040790715.1_ASM4079071v1_genomic	NZ_CP161144.1	80826	81252	426	renamed_GCF_000008685.2	chromosome	80982	81408	426	99.2	2.643e-91
GCF_040790715.1_ASM4079071v1_genomic	NZ_CP161144.1	83764	82813	951	renamed_GCF_000008685.2	chromosome	83920	82969	951	99.6	3.736e-209
GCF_040790715.1_ASM4079071v1_genomic	NZ_CP161144.1	85564	83884	1680	renamed_GCF_000008685.2	chromosome	85720	84040	1680	100.0	0.0
GCF_040790715.1_ASM4079071v1_genomic	NZ_CP161144.1	89652	89043	609	renamed_GCF_000008685.2	chromosome	89808	89199	609	100.0	1.275e-129
GCF_040790715.1_ASM4079071v1_genomic	NZ_CP161144.1	105274	103606	1668	renamed_GCF_000008685.2	chromosome	105299	103763	1668	100.0	0.0
GCF_040790715.1_ASM4079071v1_genomic	NZ_CP161144.1	106737	105726	1011	renamed_GCF_000008685.2	chromosome	106894	105883	1011	100.0	4.14e-218
GCF_040790715.1_ASM4079071v1_genomic	NZ_CP161144.1	108149	109514	1365	renamed_GCF_000008685.2	chromosome	108306	109671	1365	100.0	4.349e-312
GCF_040790715.1_ASM4079071v1_genomic	NZ_CP161144.1	111410	110888	522	renamed_GCF_000008685.2	chromosome	111567	111045	522	100.0	1.783e-111
GCF_040790715.1_ASM4079071v1_genomic	NZ_CP161144.1	148502	147491	1011	renamed_GCF_000008685.2	chromosome	148659	147648	1011	99.7	2.697e-214
GCF_040790715.1_ASM4079071v1_genomic	NZ_CP161144.1	150812	152018	1206	renamed_GCF_000008685.2	chromosome	150973	152179	1206	99.7	1.095e-274
GCF_040790715.1_ASM4079071v1_genomic	NZ_CP161144.1	153525	152913	612	renamed_GCF_000008685.2	chromosome	153686	153074	612	100.0	4.712e-141
GCF_040790715.1_ASM4079071v1_genomic	NZ_CP161144.1	156300	157437	1137	renamed_GCF_000008685.2	chromosome	156461	157598	1137	100.0	1.164e-253
GCF_040790715.1_ASM4079071v1_genomic	NZ_CP161144.1	157896	158313	417	renamed_GCF_000008685.2	chromosome	158075	158474	417	100.0	2.72e-81
GCF_040790715.1_ASM4079071v1_genomic	NZ_CP161144.1	171089	171323	234	renamed_GCF_000008685.2	chromosome	171262	171484	234	97.2	1.134e-44
GCF_040790715.1_ASM4079071v1_genomic	NZ_CP161144.1	173955	173367	588	renamed_GCF_000008685.2	chromosome	174116	173528	588	100.0	1.529e-132
GCF_040790715.1_ASM4079071v1_genomic	NZ_CP161144.1	174923	173936	987	renamed_GCF_000008685.2	chromosome	174970	174097	987	99.6	1.701e-189
GCF_040790715.1_ASM4079071v1_genomic	NZ_CP161144.1	177692	176816	876	renamed_GCF_000008685.2	chromosome	177853	176977	876	100.0	9.427e-195
GCF_040790715.1_ASM4079071v1_genomic	NZ_CP161144.1	179382	178755	627	renamed_GCF_000008685.2	chromosome	179543	178916	627	98.0	7.618e-130
GCF_040790715.1_ASM4079071v1_genomic	NZ_CP161144.1	202433	200906	1527	renamed_GCF_000008685.2	chromosome	202578	201051	1527	99.6	0.0
GCF_040790715.1_ASM4079071v1_genomic	NZ_CP161144.1	203991	204927	936	renamed_GCF_000008685.2	chromosome	204136	205072	936	100.0	4.7e-204
GCF_040790715.1_ASM4079071v1_genomic	NZ_CP161144.1	206383	207934	1551	renamed_GCF_000008685.2	chromosome	206528	208106	1551	99.6	0.0
GCF_040790715.1_ASM4079071v1_genomic	NZ_CP161144.1	226464	224679	1785	renamed_GCF_000008685.2	chromosome	226610	224825	1785	99.4	0.0
GCF_040790715.1_ASM4079071v1_genomic	NZ_CP161144.1	228375	227667	708	renamed_GCF_000008685.2	chromosome	228521	227813	708	100.0	8.763e-159
GCF_040790715.1_ASM4079071v1_genomic	NZ_CP161144.1	231345	230067	1278	renamed_GCF_000008685.2	chromosome	231491	230213	1278	99.7	4.58e-288
GCF_040790715.1_ASM4079071v1_genomic	NZ_CP161144.1	272533	270340	2193	renamed_GCF_000008685.2	chromosome	272641	270487	2193	99.8	0.0
GCF_040790715.1_ASM4079071v1_genomic	NZ_CP161144.1	273706	275089	1383	renamed_GCF_000008685.2	chromosome	273856	275236	1383	99.5	1.314e-302
GCF_040790715.1_ASM4079071v1_genomic	NZ_CP161144.1	276410	276917	507	renamed_GCF_000008685.2	chromosome	276671	277064	507	100.0	6.298e-87
GCF_040790715.1_ASM4079071v1_genomic	NZ_CP161144.1	278911	278389	522	renamed_GCF_000008685.2	chromosome	279058	278536	522	100.0	3.966e-111
GCF_040790715.1_ASM4079071v1_genomic	NZ_CP161144.1	281164	279259	1905	renamed_GCF_000008685.2	chromosome	281311	279406	1905	99.8	0.0
GCF_040790715.1_ASM4079071v1_genomic	NZ_CP161144.1	282540	281652	888	renamed_GCF_000008685.2	chromosome	282687	281799	888	100.0	4.025e-189
GCF_040790715.1_ASM4079071v1_genomic	NZ_CP161144.1	293061	292278	783	renamed_GCF_000008685.2	chromosome	293208	292425	783	100.0	6.057e-167
GCF_040790715.1_ASM4079071v1_genomic	NZ_CP161144.1	294632	293303	1329	renamed_GCF_000008685.2	chromosome	294780	293451	1329	99.5	2.627e-294
GCF_040790715.1_ASM4079071v1_genomic	NZ_CP161144.1	296272	295093	1179	renamed_GCF_000008685.2	chromosome	296420	295241	1179	99.4	2.611e-260
GCF_040790715.1_ASM4079071v1_genomic	NZ_CP161144.1	297321	296889	432	renamed_GCF_000008685.2	chromosome	297469	297037	432	99.3	2.176e-94
GCF_040790715.1_ASM4079071v1_genomic	NZ_CP161144.1	320111	319532	579	renamed_GCF_000008685.2	chromosome	320249	319679	579	98.9	3.43e-122
GCF_040790715.1_ASM4079071v1_genomic	NZ_CP161144.1	320161	321205	1044	renamed_GCF_000008685.2	chromosome	320308	321352	1044	99.4	3.304e-226
GCF_040790715.1_ASM4079071v1_genomic	NZ_CP161144.1	321204	321891	687	renamed_GCF_000008685.2	chromosome	321351	322038	687	100.0	1.336e-150
GCF_040790715.1_ASM4079071v1_genomic	NZ_CP161144.1	322699	321892	807	renamed_GCF_000008685.2	chromosome	322846	322039	807	99.6	2.064e-174
GCF_040790715.1_ASM4079071v1_genomic	NZ_CP161144.1	323632	322699	933	renamed_GCF_000008685.2	chromosome	323779	322846	933	99.3	9.965e-204
GCF_040790715.1_ASM4079071v1_genomic	NZ_CP161144.1	325089	323628	1461	renamed_GCF_000008685.2	chromosome	325236	323775	1461	99.7	0.0
GCF_040790715.1_ASM4079071v1_genomic	NZ_CP161144.1	326141	325088	1053	renamed_GCF_000008685.2	chromosome	326288	325235	1053	99.4	2.184e-232
GCF_040790715.1_ASM4079071v1_genomic	NZ_CP161144.1	327579	326550	1029	renamed_GCF_000008685.2	chromosome	327757	326698	1029	99.4	1.646e-231
GCF_040790715.1_ASM4079071v1_genomic	NZ_CP161144.1	327883	329020	1137	renamed_GCF_000008685.2	chromosome	328031	329165	1137	99.4	6.912e-251
GCF_040790715.1_ASM4079071v1_genomic	NZ_CP161144.1	329116	329476	360	renamed_GCF_000008685.2	chromosome	329261	329621	360	100.0	1.609e-77
GCF_040790715.1_ASM4079071v1_genomic	NZ_CP161144.1	365466	364977	489	renamed_GCF_000008685.2	chromosome	365603	365114	489	100.0	3.787e-106
GCF_040790715.1_ASM4079071v1_genomic	NZ_CP161144.1	366823	366091	732	renamed_GCF_000008685.2	chromosome	366960	366228	732	97.9	6.321e-158
GCF_040790715.1_ASM4079071v1_genomic	NZ_CP161144.1	368318	368744	426	renamed_GCF_000008685.2	chromosome	368455	368881	426	98.5	9.562e-86
GCF_040790715.1_ASM4079071v1_genomic	NZ_CP161144.1	368747	369890	1143	renamed_GCF_000008685.2	chromosome	368884	370027	1143	99.4	7.822e-242
GCF_040790715.1_ASM4079071v1_genomic	NZ_CP161144.1	369889	370876	987	renamed_GCF_000008685.2	chromosome	370026	371013	987	99.6	8.057e-224
GCF_040790715.1_ASM4079071v1_genomic	NZ_CP161144.1	370896	372909	2013	renamed_GCF_000008685.2	chromosome	371033	373046	2013	99.7	0.0
GCF_040790715.1_ASM4079071v1_genomic	NZ_CP161144.1	373002	373383	381	renamed_GCF_000008685.2	chromosome	373139	373520	381	100.0	1.683e-80
GCF_040790715.1_ASM4079071v1_genomic	NZ_CP161144.1	374014	373429	585	renamed_GCF_000008685.2	chromosome	374151	373566	585	98.9	2.345e-127
GCF_040790715.1_ASM4079071v1_genomic	NZ_CP161144.1	374139	375516	1377	renamed_GCF_000008685.2	chromosome	374276	375653	1377	99.3	1.534e-308
GCF_040790715.1_ASM4079071v1_genomic	NZ_CP161144.1	375523	375802	279	renamed_GCF_000008685.2	chromosome	375660	375939	279	98.9	1.561e-56
GCF_040790715.1_ASM4079071v1_genomic	NZ_CP161144.1	376882	375823	1059	renamed_GCF_000008685.2	chromosome	377019	375960	1059	98.2	7.708e-228
GCF_040790715.1_ASM4079071v1_genomic	NZ_CP161144.1	379193	376901	2292	renamed_GCF_000008685.2	chromosome	379258	377038	2292	99.3	0.0
GCF_040790715.1_ASM4079071v1_genomic	NZ_CP161144.1	380421	379203	1218	renamed_GCF_000008685.2	chromosome	380558	379340	1218	99.5	1.909e-270
GCF_040790715.1_ASM4079071v1_genomic	NZ_CP161144.1	381755	380417	1338	renamed_GCF_000008685.2	chromosome	381892	380554	1338	100.0	1.408e-311
GCF_040790715.1_ASM4079071v1_genomic	NZ_CP161144.1	383245	381772	1473	renamed_GCF_000008685.2	chromosome	383382	381909	1473	100.0	0.0
GCF_040790715.1_ASM4079071v1_genomic	NZ_CP161144.1	384025	383257	768	renamed_GCF_000008685.2	chromosome	384162	383394	768	99.6	9.689e-168
GCF_040790715.1_ASM4079071v1_genomic	NZ_CP161144.1	395029	393967	1062	renamed_GCF_000008685.2	chromosome	395166	394104	1062	99.7	9.401e-235
GCF_040790715.1_ASM4079071v1_genomic	NZ_CP161144.1	396371	395345	1026	renamed_GCF_000008685.2	chromosome	396506	395480	1026	100.0	3.003e-224
GCF_040790715.1_ASM4079071v1_genomic	NZ_CP161144.1	497259	497676	417	renamed_GCF_000008685.2	chromosome	500592	501009	417	100.0	2.778e-89
GCF_040790715.1_ASM4079071v1_genomic	NZ_CP161144.1	497881	498136	255	renamed_GCF_000008685.2	chromosome	501214	501469	255	100.0	1.745e-51
GCF_040790715.1_ASM4079071v1_genomic	NZ_CP161144.1	498546	498852	306	renamed_GCF_000008685.2	chromosome	501879	502185	306	100.0	2.959e-62
GCF_040790715.1_ASM4079071v1_genomic	NZ_CP161144.1	499422	499608	186	renamed_GCF_000008685.2	chromosome	502755	502941	186	100.0	7.664e-41
GCF_040790715.1_ASM4079071v1_genomic	NZ_CP161144.1	500032	500575	543	renamed_GCF_000008685.2	chromosome	503365	503908	543	100.0	7.636e-116
GCF_040790715.1_ASM4079071v1_genomic	NZ_CP161144.1	500964	501462	498	renamed_GCF_000008685.2	chromosome	504297	504795	498	100.0	1.785e-107
GCF_040790715.1_ASM4079071v1_genomic	NZ_CP161144.1	501770	502208	438	renamed_GCF_000008685.2	chromosome	505103	505541	438	100.0	1.186e-93
GCF_040790715.1_ASM4079071v1_genomic	NZ_CP161144.1	511190	512450	1260	renamed_GCF_000008685.2	chromosome	514523	515783	1260	98.3	1.758e-278
GCF_040790715.1_ASM4079071v1_genomic	NZ_CP161144.1	521213	522914	1701	renamed_GCF_000008685.2	chromosome	524553	526254	1701	99.1	0.0
GCF_040790715.1_ASM4079071v1_genomic	NZ_CP161144.1	527764	525856	1908	renamed_GCF_000008685.2	chromosome	531105	529197	1908	100.0	0.0
GCF_040790715.1_ASM4079071v1_genomic	NZ_CP161144.1	530960	531815	855	renamed_GCF_000008685.2	chromosome	534300	535155	855	99.6	9.843e-191
GCF_040790715.1_ASM4079071v1_genomic	NZ_CP161144.1	532363	534187	1824	renamed_GCF_000008685.2	chromosome	535703	537527	1824	99.0	0.0
GCF_040790715.1_ASM4079071v1_genomic	NZ_CP161144.1	535935	534987	948	renamed_GCF_000008685.2	chromosome	539275	538327	948	99.3	2.459e-213
GCF_040790715.1_ASM4079071v1_genomic	NZ_CP161144.1	539708	540476	768	renamed_GCF_000008685.2	chromosome	543048	543816	768	99.6	4.167e-177
GCF_040790715.1_ASM4079071v1_genomic	NZ_CP161144.1	541245	544047	2802	renamed_GCF_000008685.2	chromosome	544585	547387	2802	98.7	0.0
GCF_040790715.1_ASM4079071v1_genomic	NZ_CP161144.1	545545	545146	399	renamed_GCF_000008685.2	chromosome	548885	548486	399	99.2	3.385e-84
GCF_040790715.1_ASM4079071v1_genomic	NZ_CP161144.1	634596	635190	594	renamed_GCF_000008685.2	chromosome	637971	638556	594	99.4	7.271e-125
GCF_040790715.1_ASM4079071v1_genomic	NZ_CP161144.1	636474	638883	2409	renamed_GCF_000008685.2	chromosome	639858	642249	2409	99.3	0.0
GCF_040790715.1_ASM4079071v1_genomic	NZ_CP161144.1	639760	639133	627	renamed_GCF_000008685.2	chromosome	643126	642499	627	100.0	8.735e-137
GCF_040790715.1_ASM4079071v1_genomic	NZ_CP161144.1	641405	641774	369	renamed_GCF_000008685.2	chromosome	644771	645140	369	100.0	1.529e-79
GCF_040790715.1_ASM4079071v1_genomic	NZ_CP161144.1	642352	643315	963	renamed_GCF_000008685.2	chromosome	645718	646681	963	100.0	1.162e-215
GCF_040790715.1_ASM4079071v1_genomic	NZ_CP161144.1	645186	645741	555	renamed_GCF_000008685.2	chromosome	648552	649107	555	99.4	3.12e-119
GCF_040790715.1_ASM4079071v1_genomic	NZ_CP161144.1	650424	647046	3378	renamed_GCF_000008685.2	chromosome	653790	650412	3378	99.5	0.0
GCF_040790715.1_ASM4079071v1_genomic	NZ_CP161144.1	669974	671411	1437	renamed_GCF_000008685.2	chromosome	673341	674778	1437	99.3	0.0
GCF_040790715.1_ASM4079071v1_genomic	NZ_CP161144.1	673100	674489	1389	renamed_GCF_000008685.2	chromosome	676471	677860	1389	100.0	1.442e-302
GCF_040790715.1_ASM4079071v1_genomic	NZ_CP161144.1	676379	675587	792	renamed_GCF_000008685.2	chromosome	679750	678958	792	99.6	3.445e-166
GCF_040790715.1_ASM4079071v1_genomic	NZ_CP161144.1	707829	708270	441	renamed_GCF_000008685.2	chromosome	711210	711651	441	100.0	1.245e-93
GCF_040790715.1_ASM4079071v1_genomic	NZ_CP161144.1	709869	708822	1047	renamed_GCF_000008685.2	chromosome	713250	712203	1047	100.0	4.165e-224
GCF_040790715.1_ASM4079071v1_genomic	NZ_CP161144.1	711385	710722	663	renamed_GCF_000008685.2	chromosome	714766	714103	663	98.6	1.611e-144
GCF_040790715.1_ASM4079071v1_genomic	NZ_CP161144.1	713238	714390	1152	renamed_GCF_000008685.2	chromosome	716619	717771	1152	100.0	1.261e-246
GCF_040790715.1_ASM4079071v1_genomic	NZ_CP161144.1	715445	717704	2259	renamed_GCF_000008685.2	chromosome	718826	721088	2259	99.7	0.0
GCF_040790715.1_ASM4079071v1_genomic	NZ_CP161144.1	720746	719678	1068	renamed_GCF_000008685.2	chromosome	724130	723062	1068	99.7	1.68e-246
GCF_040790715.1_ASM4079071v1_genomic	NZ_CP161144.1	722046	723111	1065	renamed_GCF_000008685.2	chromosome	725430	726495	1065	96.0	1.425e-230
GCF_040790715.1_ASM4079071v1_genomic	NZ_CP161144.1	733826	734327	501	renamed_GCF_000008685.2	chromosome	737211	737712	501	98.1	2.269e-105
GCF_040790715.1_ASM4079071v1_genomic	NZ_CP161144.1	735020	735386	366	renamed_GCF_000008685.2	chromosome	738405	738771	366	100.0	9.695e-76
GCF_040790715.1_ASM4079071v1_genomic	NZ_CP161144.1	736299	736791	492	renamed_GCF_000008685.2	chromosome	739684	740176	492	99.3	2.164e-104
GCF_040790715.1_ASM4079071v1_genomic	NZ_CP161144.1	773400	774189	789	renamed_GCF_000008685.2	chromosome	776784	777573	789	99.6	1.876e-172
GCF_040790715.1_ASM4079071v1_genomic	NZ_CP161144.1	775373	778001	2628	renamed_GCF_000008685.2	chromosome	778757	781385	2628	98.8	0.0
GCF_040790715.1_ASM4079071v1_genomic	NZ_CP161144.1	779864	779591	273	renamed_GCF_000008685.2	chromosome	783248	782975	273	100.0	3.858e-54
GCF_040790715.1_ASM4079071v1_genomic	NZ_CP161144.1	781672	783370	1698	renamed_GCF_000008685.2	chromosome	785056	786754	1698	99.6	0.0
GCF_040790715.1_ASM4079071v1_genomic	NZ_CP161144.1	785934	786552	618	renamed_GCF_000008685.2	chromosome	789302	789938	618	99.5	3.406e-137
GCF_040790715.1_ASM4079071v1_genomic	NZ_CP161144.1	788401	787420	981	renamed_GCF_000008685.2	chromosome	791787	790806	981	99.6	2.843e-217
GCF_040790715.1_ASM4079071v1_genomic	NZ_CP161144.1	788964	790239	1275	renamed_GCF_000008685.2	chromosome	792350	793625	1275	98.1	4.931e-278
GCF_040790715.1_ASM4079071v1_genomic	NZ_CP161144.1	804581	803534	1047	renamed_GCF_000008685.2	chromosome	807966	806919	1047	100.0	5.315e-230
GCF_040790715.1_ASM4079071v1_genomic	NZ_CP161144.1	806167	805075	1092	renamed_GCF_000008685.2	chromosome	809552	808460	1092	99.7	8.623e-241
GCF_040790715.1_ASM4079071v1_genomic	NZ_CP161144.1	838484	839102	618	renamed_GCF_000008685.2	chromosome	841833	842451	618	100.0	1.393e-138
GCF_040790715.1_ASM4079071v1_genomic	NZ_CP161144.1	839653	841102	1449	renamed_GCF_000008685.2	chromosome	843002	844451	1449	99.5	1.877e-318
GCF_040790715.1_ASM4079071v1_genomic	NZ_CP161144.1	856732	855559	1173	renamed_GCF_000008685.2	chromosome	860111	858938	1173	98.9	1.696e-255
GCF_040790715.1_ASM4079071v1_genomic	NZ_CP161144.1	859320	860268	948	renamed_GCF_000008685.2	chromosome	862698	863646	948	100.0	4.292e-207
GCF_040790715.1_ASM4079071v1_genomic	NZ_CP161144.1	861683	862541	858	renamed_GCF_000008685.2	chromosome	865052	865919	858	99.6	3.329e-186
GCF_040790715.1_ASM4079071v1_genomic	NZ_CP161144.1	863115	863316	201	renamed_GCF_000008685.2	chromosome	866493	866694	201	100.0	2.206e-40
GCF_040790715.1_ASM4079071v1_genomic	NZ_CP161144.1	880835	877706	3129	renamed_GCF_000008685.2	chromosome	884213	881084	3129	99.7	0.0
GCF_040790715.1_ASM4079071v1_genomic	NZ_CP161144.1	884801	883091	1710	renamed_GCF_000008685.2	chromosome	888179	886469	1710	99.2	0.0
GCF_040790715.1_ASM4079071v1_genomic	NZ_CP161144.1	889750	893191	3441	renamed_GCF_000008685.2	chromosome	893128	896569	3441	98.5	0.0
GCF_040790715.1_ASM4079071v1_genomic	NZ_CP161154.1	7836	8766	930	renamed_GCF_000008685.2	cp26	7835	8765	930	98.0	2.319e-202
GCF_040790715.1_ASM4079071v1_genomic	NZ_CP161154.1	21845	21359	486	renamed_GCF_000008685.2	cp26	21833	21338	486	100.0	3.279e-107
GCF_040790715.1_ASM4079071v1_genomic	NZ_CP161154.1	23175	22623	552	renamed_GCF_000008685.2	cp26	23154	22602	552	99.4	6.015e-120
GCF_040790715.1_ASM4079071v1_genomic	NZ_CP161154.1	24845	26474	1629	renamed_GCF_000008685.2	cp26	24824	26453	1629	100.0	0.0
GCF_040790715.1_ASM4079071v1_genomic	NZ_CP161146.1	1305	1998	693	renamed_GCF_000008685.2	cp32-1	1305	1998	693	99.1	1.276e-143
GCF_040790715.1_ASM4079071v1_genomic	NZ_CP161146.1	19248	20346	1098	renamed_GCF_000008685.2	cp32-7	19116	20214	1098	97.2	7.872e-243
GCF_040790715.1_ASM4079071v1_genomic	NZ_CP161146.1	21730	22258	528	renamed_GCF_000008685.2	cp32-1	21560	22118	528	61.8	5.52e-75
GCF_040790715.1_ASM4079071v1_genomic	NZ_CP161146.1	24698	25124	426	renamed_GCF_000008685.2	cp32-6	24618	25044	426	100.0	8.056e-96
GCF_040790715.1_ASM4079071v1_genomic	NZ_CP161146.1	27833	27140	693	renamed_GCF_000008685.2	cp32-6	27745	27076	693	27.6	2.503e-09
GCF_040790715.1_ASM4079071v1_genomic	NZ_CP161147.1	16987	17416	429	renamed_GCF_000008685.2	cp32-1	17231	17678	429	75.6	2.858e-66
GCF_040790715.1_ASM4079071v1_genomic	NZ_CP161147.1	21992	22538	546	renamed_GCF_000008685.2	cp32-4	21414	21960	546	100.0	3.273e-117
GCF_040790715.1_ASM4079071v1_genomic	NZ_CP161148.1	8280	8736	456	renamed_GCF_000008685.2	cp32-7	8273	8729	456	99.3	4.385e-99
GCF_040790715.1_ASM4079071v1_genomic	NZ_CP161148.1	8976	10266	1290	renamed_GCF_000008685.2	lp56	12436	13732	1290	64.6	2.477e-145
GCF_040790715.1_ASM4079071v1_genomic	NZ_CP161148.1	11859	12414	555	renamed_GCF_000008685.2	cp32-6	11929	12484	555	87.5	6.44e-103
GCF_040790715.1_ASM4079071v1_genomic	NZ_CP161148.1	20154	20721	567	renamed_GCF_000008685.2	cp32-1	20223	20790	567	100.0	2.944e-130
GCF_040790715.1_ASM4079071v1_genomic	NZ_CP161148.1	22068	22647	579	renamed_GCF_000008685.2	cp32-8	22112	22691	579	99.4	7.628e-122
GCF_040790715.1_ASM4079071v1_genomic	NZ_CP161148.1	26174	27197	1023	renamed_GCF_000008685.2	lp56	29936	30974	1023	95.6	4.99e-218
GCF_040790715.1_ASM4079071v1_genomic	NZ_CP161148.1	28112	28679	567	renamed_GCF_000008685.2	cp32-3	28235	28874	567	91.4	3.303e-112
GCF_040790715.1_ASM4079071v1_genomic	NZ_CP161152.1	24024	24489	465	renamed_GCF_000008685.2	lp21	15348	15813	465	99.3	4.176e-101
GCF_040790715.1_ASM4079071v1_genomic	NZ_CP161152.1	25188	24903	285	renamed_GCF_000008685.2	lp21	16548	16227	285	98.9	2.097e-62
GCF_040790715.1_ASM4079071v1_genomic	NZ_CP161152.1	26609	27041	432	renamed_GCF_000008685.2	lp5	4387	4819	432	99.3	2.641e-92
GCF_040790715.1_ASM4079071v1_genomic	NZ_CP161151.1	21492	22242	750	renamed_GCF_000008685.2	lp28-3	21469	22219	750	99.5	6.33e-161
GCF_040790715.1_ASM4079071v1_genomic	NZ_CP161151.1	26365	25453	912	renamed_GCF_000008685.2	lp28-3	26371	25432	912	99.0	1.509e-195
GCF_040790715.1_ASM4079071v1_genomic	NZ_CP161151.1	27789	28347	558	renamed_GCF_000008685.2	lp28-4	26359	26914	558	95.1	2.369e-114
GCF_040790715.1_ASM4079071v1_genomic	NZ_CP161156.1	12296	11756	540	renamed_GCF_000008685.2	lp36	14841	14301	540	100.0	2.234e-120
GCF_040790715.1_ASM4079071v1_genomic	NZ_CP161156.1	13728	14340	612	renamed_GCF_000008685.2	lp36	16274	16886	612	100.0	9.153e-134
GCF_040790715.1_ASM4079071v1_genomic	NZ_CP161156.1	17160	17382	222	renamed_GCF_000008685.2	lp36	21911	22133	222	100.0	1.866e-45
GCF_040790715.1_ASM4079071v1_genomic	NZ_CP161156.1	17543	17717	174	renamed_GCF_000008685.2	lp36	22293	22467	174	92.9	1.178e-34
GCF_040790715.1_ASM4079071v1_genomic	NZ_CP161156.1	20451	20109	342	renamed_GCF_000008685.2	lp28-3	8017	8431	342	61.5	0.0002439
GCF_040790715.1_ASM4079071v1_genomic	NZ_CP161156.1	22789	22237	552	renamed_GCF_000008685.2	lp56	855	1407	552	96.7	3.6e-117
GCF_040790715.1_ASM4079071v1_genomic	NZ_CP161145.1	8443	8869	426	renamed_GCF_000008685.2	lp54	8441	8867	426	100.0	3.21e-89
GCF_040790715.1_ASM4079071v1_genomic	NZ_CP161145.1	10289	11180	891	renamed_GCF_000008685.2	lp54	10287	11178	891	99.3	4.629e-188
GCF_040790715.1_ASM4079071v1_genomic	NZ_CP161145.1	13052	13637	585	renamed_GCF_000008685.2	lp54	12994	13579	585	99.4	8.719e-130
GCF_040790715.1_ASM4079071v1_genomic	NZ_CP161145.1	14395	14941	546	renamed_GCF_000008685.2	lp54	14337	14883	546	100.0	1.338e-118
GCF_040790715.1_ASM4079071v1_genomic	NZ_CP161145.1	39423	38178	1245	renamed_GCF_000008685.2	lp54	39405	38160	1245	99.2	5.886e-271
GCF_040790715.1_ASM4079071v1_genomic	NZ_CP161145.1	40130	39890	240	renamed_GCF_000008685.2	lp54	40112	39872	240	100.0	3.722e-49
GCF_040790715.1_ASM4079071v1_genomic	NZ_CP161145.1	41063	40229	834	renamed_GCF_000008685.2	lp54	41045	40211	834	99.6	1.639e-181
GCF_040790715.1_ASM4079071v1_genomic	NZ_CP161145.1	42037	41413	624	renamed_GCF_000008685.2	lp54	42019	41395	624	99.5	1.532e-138
GCF_040790715.1_ASM4079071v1_genomic	NZ_CP161145.1	42284	42491	207	renamed_GCF_000008685.2	lp54	42266	42473	207	100.0	9.856e-42
GCF_040790715.1_ASM4079071v1_genomic	NZ_CP161145.1	43550	42641	909	renamed_GCF_000008685.2	lp54	43532	42623	909	99.6	5.38e-198
GCF_040790715.1_ASM4079071v1_genomic	NZ_CP161145.1	44552	43703	849	renamed_GCF_000008685.2	lp54	44533	43684	849	100.0	7.054e-185
GCF_040790715.1_ASM4079071v1_genomic	NZ_CP161145.1	45963	44730	1233	renamed_GCF_000008685.2	lp54	45947	44711	1233	97.5	6.617e-259
GCF_040790715.1_ASM4079071v1_genomic	NZ_CP161144.1	82	646	564	renamed_GCF_000008685.2	chromosome	104	677	564	96.2	6.014e-122
GCF_040790715.1_ASM4079071v1_genomic	NZ_CP161144.1	6301	5245	1056	renamed_GCF_000008685.2	chromosome	6306	5250	1056	99.1	8.56e-235
GCF_040790715.1_ASM4079071v1_genomic	NZ_CP161144.1	8310	7452	858	renamed_GCF_000008685.2	chromosome	8315	7457	858	100.0	6.472e-196
GCF_040790715.1_ASM4079071v1_genomic	NZ_CP161144.1	9196	10201	1005	renamed_GCF_000008685.2	chromosome	9201	10206	1005	99.4	1.861e-217
GCF_040790715.1_ASM4079071v1_genomic	NZ_CP161144.1	10575	11415	840	renamed_GCF_000008685.2	chromosome	10580	11420	840	100.0	7.775e-191
GCF_040790715.1_ASM4079071v1_genomic	NZ_CP161144.1	12148	12748	600	renamed_GCF_000008685.2	chromosome	12153	12753	600	98.9	1.006e-130
GCF_040790715.1_ASM4079071v1_genomic	NZ_CP161144.1	15340	14719	621	renamed_GCF_000008685.2	chromosome	15345	14724	621	100.0	3.249e-138
GCF_040790715.1_ASM4079071v1_genomic	NZ_CP161144.1	15839	16799	960	renamed_GCF_000008685.2	chromosome	15994	16804	960	98.8	1.19e-171
GCF_040790715.1_ASM4079071v1_genomic	NZ_CP161144.1	18299	17786	513	renamed_GCF_000008685.2	chromosome	18304	17791	513	99.4	1.872e-109
GCF_040790715.1_ASM4079071v1_genomic	NZ_CP161144.1	42327	41286	1041	renamed_GCF_000008685.2	chromosome	42483	41442	1041	98.8	5.309e-229
GCF_040790715.1_ASM4079071v1_genomic	NZ_CP161144.1	45198	42750	2448	renamed_GCF_000008685.2	chromosome	45354	42906	2448	99.7	0.0
GCF_040790715.1_ASM4079071v1_genomic	NZ_CP161144.1	46223	45854	369	renamed_GCF_000008685.2	chromosome	46379	46010	369	100.0	3.085e-80
GCF_040790715.1_ASM4079071v1_genomic	NZ_CP161144.1	47748	48450	702	renamed_GCF_000008685.2	chromosome	47916	48606	702	99.1	1.109e-146
GCF_040790715.1_ASM4079071v1_genomic	NZ_CP161144.1	49184	49856	672	renamed_GCF_000008685.2	chromosome	49340	50012	672	100.0	9.591e-152
GCF_040790715.1_ASM4079071v1_genomic	NZ_CP161144.1	60375	59877	498	renamed_GCF_000008685.2	chromosome	60533	60035	498	100.0	3.278e-109
GCF_040790715.1_ASM4079071v1_genomic	NZ_CP161144.1	62988	63870	882	renamed_GCF_000008685.2	chromosome	63146	64028	882	100.0	1.369e-191
GCF_040790715.1_ASM4079071v1_genomic	NZ_CP161144.1	67089	69414	2325	renamed_GCF_000008685.2	chromosome	67247	69569	2325	99.4	0.0
GCF_040790715.1_ASM4079071v1_genomic	NZ_CP161144.1	102792	101367	1425	renamed_GCF_000008685.2	chromosome	102949	101524	1425	100.0	1.009e-312
GCF_040790715.1_ASM4079071v1_genomic	NZ_CP161144.1	122332	121720	612	renamed_GCF_000008685.2	chromosome	122491	121879	612	97.0	9.656e-125
GCF_040790715.1_ASM4079071v1_genomic	NZ_CP161144.1	124655	123989	666	renamed_GCF_000008685.2	chromosome	124814	124148	666	100.0	8.347e-144
GCF_040790715.1_ASM4079071v1_genomic	NZ_CP161144.1	126142	125374	768	renamed_GCF_000008685.2	chromosome	126301	125533	768	99.2	8.033e-170
GCF_040790715.1_ASM4079071v1_genomic	NZ_CP161144.1	129973	127267	2706	renamed_GCF_000008685.2	chromosome	130132	127426	2706	99.8	0.0
GCF_040790715.1_ASM4079071v1_genomic	NZ_CP161144.1	131138	132266	1128	renamed_GCF_000008685.2	chromosome	131297	132425	1128	99.4	1.93e-246
GCF_040790715.1_ASM4079071v1_genomic	NZ_CP161144.1	159206	159881	675	renamed_GCF_000008685.2	chromosome	159367	160042	675	98.6	4.754e-143
GCF_040790715.1_ASM4079071v1_genomic	NZ_CP161144.1	162640	161038	1602	renamed_GCF_000008685.2	chromosome	162801	161199	1602	99.8	0.0
GCF_040790715.1_ASM4079071v1_genomic	NZ_CP161144.1	164659	162910	1749	renamed_GCF_000008685.2	chromosome	164820	163071	1749	99.1	0.0
GCF_040790715.1_ASM4079071v1_genomic	NZ_CP161144.1	167598	165753	1845	renamed_GCF_000008685.2	chromosome	167759	165914	1845	99.3	0.0
GCF_040790715.1_ASM4079071v1_genomic	NZ_CP161144.1	812944	812146	798	renamed_GCF_000008685.2	chromosome	816299	815501	798	100.0	1.968e-173
GCF_040790715.1_ASM4079071v1_genomic	NZ_CP161144.1	813847	812956	891	renamed_GCF_000008685.2	chromosome	817160	816311	891	99.6	1.029e-187
GCF_040790715.1_ASM4079071v1_genomic	NZ_CP161144.1	814046	814607	561	renamed_GCF_000008685.2	chromosome	817395	817956	561	99.4	1.601e-127
GCF_040790715.1_ASM4079071v1_genomic	NZ_CP161144.1	814668	815199	531	renamed_GCF_000008685.2	chromosome	818017	818548	531	100.0	1.403e-115
GCF_040790715.1_ASM4079071v1_genomic	NZ_CP161144.1	815255	815567	312	renamed_GCF_000008685.2	chromosome	818604	818916	312	99.0	2.418e-65
GCF_040790715.1_ASM4079071v1_genomic	NZ_CP161144.1	815572	815893	321	renamed_GCF_000008685.2	chromosome	819035	819242	321	97.0	1.267e-41
GCF_040790715.1_ASM4079071v1_genomic	NZ_CP161144.1	815892	816138	246	renamed_GCF_000008685.2	chromosome	819241	819487	246	100.0	8.275e-50
GCF_040790715.1_ASM4079071v1_genomic	NZ_CP161144.1	841104	843723	2619	renamed_GCF_000008685.2	chromosome	844453	847102	2619	97.6	0.0
GCF_040790715.1_ASM4079071v1_genomic	NZ_CP161144.1	843746	844109	363	renamed_GCF_000008685.2	chromosome	847125	847488	363	100.0	2.269e-74
GCF_040790715.1_ASM4079071v1_genomic	NZ_CP161144.1	844111	844960	849	renamed_GCF_000008685.2	chromosome	847490	848339	849	99.6	1.428e-185
GCF_040790715.1_ASM4079071v1_genomic	NZ_CP161144.1	866645	866129	516	renamed_GCF_000008685.2	chromosome	870023	869507	516	100.0	1.621e-111
GCF_040790715.1_ASM4079071v1_genomic	NZ_CP161144.1	869205	866733	2472	renamed_GCF_000008685.2	chromosome	872583	870111	2472	100.0	0.0
GCF_040790715.1_ASM4079071v1_genomic	NZ_CP161144.1	871754	869207	2547	renamed_GCF_000008685.2	chromosome	875132	872585	2547	100.0	0.0
GCF_040790715.1_ASM4079071v1_genomic	NZ_CP161144.1	871828	873070	1242	renamed_GCF_000008685.2	chromosome	875206	876448	1242	98.3	3.236e-277
GCF_040790715.1_ASM4079071v1_genomic	NZ_CP161144.1	873050	875903	2853	renamed_GCF_000008685.2	chromosome	876491	879281	2853	99.3	0.0
GCF_040790715.1_ASM4079071v1_genomic	NZ_CP161144.1	875936	876872	936	renamed_GCF_000008685.2	chromosome	879314	880250	936	99.6	1.601e-207
GCF_040790715.1_ASM4079071v1_genomic	NZ_CP161144.1	877713	876888	825	renamed_GCF_000008685.2	chromosome	881091	880266	825	99.6	6.405e-182
GCF_040790715.1_ASM4079071v1_genomic	NZ_CP161154.1	9275	10037	762	renamed_GCF_000008685.2	cp26	9274	10036	762	98.4	6.336e-163
GCF_040790715.1_ASM4079071v1_genomic	NZ_CP161154.1	10104	10653	549	renamed_GCF_000008685.2	cp26	10103	10652	549	98.9	7.635e-117
GCF_040790715.1_ASM4079071v1_genomic	NZ_CP161154.1	11421	10923	498	renamed_GCF_000008685.2	cp26	11417	10919	498	98.1	4.372e-106
GCF_040790715.1_ASM4079071v1_genomic	NZ_CP161148.1	2576	3344	768	renamed_GCF_000008685.2	cp32-6	2576	3344	768	98.4	1.786e-169
GCF_040790715.1_ASM4079071v1_genomic	NZ_CP161148.1	3372	3948	576	renamed_GCF_000008685.2	cp32-6	3372	3948	576	100.0	4.521e-127
GCF_040790715.1_ASM4079071v1_genomic	NZ_CP161148.1	3969	4929	960	renamed_GCF_000008685.2	lp56	7432	8392	960	100.0	6.008e-214
GCF_040790715.1_ASM4079071v1_genomic	NZ_CP161148.1	5403	5787	384	renamed_GCF_000008685.2	cp32-9	5412	5796	384	100.0	2.931e-83
GCF_040790715.1_ASM4079071v1_genomic	NZ_CP161148.1	5774	6164	390	renamed_GCF_000008685.2	cp32-9	5783	6173	390	100.0	3.229e-83
GCF_040790715.1_ASM4079071v1_genomic	NZ_CP161148.1	6160	6730	570	renamed_GCF_000008685.2	cp32-6	6160	6730	570	97.8	2.704e-123
GCF_040790715.1_ASM4079071v1_genomic	NZ_CP161148.1	15160	15364	204	renamed_GCF_000008685.2	cp32-1	15214	15418	204	100.0	2.578e-39
GCF_040790715.1_ASM4079071v1_genomic	NZ_CP161157.1	12588	11925	663	renamed_GCF_000008685.2	lp17	11646	10983	663	100.0	1.005e-149
GCF_040790715.1_ASM4079071v1_genomic	NZ_CP161157.1	14348	15089	741	renamed_GCF_000008685.2	lp17	13338	14079	741	100.0	7.64e-166
GCF_040790715.1_ASM4079071v1_genomic	NZ_CP161157.1	15079	15349	270	renamed_GCF_000008685.2	lp17	14069	14339	270	100.0	1.489e-55
GCF_040790715.1_ASM4079071v1_genomic	NZ_CP161157.1	17126	16895	231	renamed_GCF_000008685.2	lp17	16119	15888	231	98.6	8.774e-47
GCF_040790715.1_ASM4079071v1_genomic	NZ_CP161152.1	282	648	366	renamed_GCF_000008685.2	lp21	252	618	366	100.0	7.218e-79
GCF_040790715.1_ASM4079071v1_genomic	NZ_CP161152.1	775	1144	369	renamed_GCF_000008685.2	lp21	745	1114	369	100.0	3.085e-80
GCF_040790715.1_ASM4079071v1_genomic	NZ_CP161152.1	1548	2658	1110	renamed_GCF_000008685.2	lp21	1485	2628	1110	98.9	8.376e-253
GCF_040790715.1_ASM4079071v1_genomic	NZ_CP161155.1	22762	22258	504	renamed_GCF_000008685.2	lp56	3622	4108	504	93.0	3.962e-83
GCF_040790715.1_ASM4079071v1_genomic	NZ_CP161155.1	23807	22937	870	renamed_GCF_000008685.2	lp28-2	1046	1928	870	97.9	2.768e-190
GCF_040790715.1_ASM4079071v1_genomic	NZ_CP161155.1	24705	23856	849	renamed_GCF_000008685.2	lp28-2	115	1009	849	98.9	9.329e-182
GCF_040790715.1_ASM4079071v1_genomic	NZ_CP161151.1	274	865	591	renamed_GCF_000008685.2	lp56	52608	52134	591	98.7	7.4e-99
GCF_040790715.1_ASM4079071v1_genomic	NZ_CP161151.1	1051	1375	324	renamed_GCF_000008685.2	lp28-3	1044	1368	324	99.0	8.87e-70
GCF_040790715.1_ASM4079071v1_genomic	NZ_CP161151.1	2976	2265	711	renamed_GCF_000008685.2	lp28-3	2970	2259	711	98.7	4.333e-150
GCF_040790715.1_ASM4079071v1_genomic	NZ_CP161151.1	7731	3894	3837	renamed_GCF_000008685.2	lp28-3	7728	3891	3837	99.8	0.0
GCF_040790715.1_ASM4079071v1_genomic	NZ_CP161151.1	8207	8003	204	renamed_GCF_000008685.2	lp36	17379	17583	204	82.0	8.778e-35
GCF_040790715.1_ASM4079071v1_genomic	NZ_CP161150.1	11867	11438	429	renamed_GCF_000008685.2	lp28-2	11491	11062	429	99.2	1.514e-89
GCF_040790715.1_ASM4079071v1_genomic	NZ_CP161150.1	12695	11876	819	renamed_GCF_000008685.2	lp28-2	12319	11500	819	98.8	1.295e-181
GCF_040790715.1_ASM4079071v1_genomic	NZ_CP161150.1	13128	12684	444	renamed_GCF_000008685.2	lp28-2	12752	12308	444	100.0	8.866e-98
GCF_040790715.1_ASM4079071v1_genomic	NZ_CP161150.1	13517	13124	393	renamed_GCF_000008685.2	lp28-2	13141	12748	393	100.0	6.841e-84
GCF_040790715.1_ASM4079071v1_genomic	NZ_CP161150.1	13871	13532	339	renamed_GCF_000008685.2	lp28-2	13495	13156	339	100.0	3.422e-74
GCF_040790715.1_ASM4079071v1_genomic	NZ_CP161150.1	14717	13883	834	renamed_GCF_000008685.2	lp28-2	14341	13507	834	99.2	1.36e-183
GCF_040790715.1_ASM4079071v1_genomic	NZ_CP161150.1	15262	14752	510	renamed_GCF_000008685.2	lp28-2	14885	14375	510	98.2	1.964e-108
GCF_040790715.1_ASM4079071v1_genomic	NZ_CP161150.1	24530	24116	414	renamed_GCF_000008685.2	lp28-2	24108	23721	414	55.6	1.931e-43
GCF_040790715.1_ASM4079071v1_genomic	NZ_CP161150.1	24899	26357	1458	renamed_GCF_000008685.2	lp28-2	24488	25955	1458	64.8	2.654e-200
GCF_040790715.1_ASM4079071v1_genomic	NZ_CP161150.1	26381	26774	393	renamed_GCF_000008685.2	lp28-2	25979	26390	393	83.8	4.469e-72
GCF_040790715.1_ASM4079071v1_genomic	NZ_CP161145.1	4258	3004	1254	renamed_GCF_000008685.2	lp54	4256	3002	1254	100.0	3.245e-279
GCF_040790715.1_ASM4079071v1_genomic	NZ_CP161145.1	5142	4668	474	renamed_GCF_000008685.2	lp54	5140	4666	474	100.0	5.31e-100
GCF_040790715.1_ASM4079071v1_genomic	NZ_CP161145.1	5315	5651	336	renamed_GCF_000008685.2	lp54	5313	5649	336	100.0	1.784e-72
GCF_040790715.1_ASM4079071v1_genomic	NZ_CP161145.1	5647	6520	873	renamed_GCF_000008685.2	lp54	5645	6518	873	99.3	2.643e-191
GCF_040790715.1_ASM4079071v1_genomic	NZ_CP161145.1	6522	7149	627	renamed_GCF_000008685.2	lp54	6520	7147	627	99.0	1.16e-133
GCF_040790715.1_ASM4079071v1_genomic	NZ_CP161145.1	7210	8245	1035	renamed_GCF_000008685.2	lp54	7208	8243	1035	100.0	8.138e-232
GCF_040790715.1_ASM4079071v1_genomic	NZ_CP161145.1	8267	8447	180	renamed_GCF_000008685.2	lp54	8265	8445	180	100.0	1.452e-33
GCF_040790715.1_ASM4079071v1_genomic	NZ_CP161145.1	27407	28016	609	renamed_GCF_000008685.2	lp54	27389	27998	609	100.0	2.346e-131
GCF_040790715.1_ASM4079071v1_genomic	NZ_CP161145.1	28031	28949	918	renamed_GCF_000008685.2	lp54	28013	28931	918	100.0	2.109e-201
GCF_040790715.1_ASM4079071v1_genomic	NZ_CP161145.1	52902	53700	798	renamed_GCF_000008685.2	lp54	52705	53503	798	99.6	6.687e-177
GCF_040790715.1_ASM4079071v1_genomic	NZ_CP161144.1	50317	49954	363	renamed_GCF_000008685.2	chromosome	50474	50111	363	99.1	1.019e-74
GCF_040790715.1_ASM4079071v1_genomic	NZ_CP161144.1	56591	56123	468	renamed_GCF_000008685.2	chromosome	56748	56280	468	99.3	1.969e-101
GCF_040790715.1_ASM4079071v1_genomic	NZ_CP161144.1	57101	57818	717	renamed_GCF_000008685.2	chromosome	57258	57975	717	98.7	3.592e-153
GCF_040790715.1_ASM4079071v1_genomic	NZ_CP161144.1	58879	57871	1008	renamed_GCF_000008685.2	chromosome	58982	58028	1008	99.3	5.908e-205
GCF_040790715.1_ASM4079071v1_genomic	NZ_CP161144.1	81248	82784	1536	renamed_GCF_000008685.2	chromosome	81404	82940	1536	100.0	0.0
GCF_040790715.1_ASM4079071v1_genomic	NZ_CP161144.1	86698	85723	975	renamed_GCF_000008685.2	chromosome	86854	85879	975	100.0	4.354e-220
GCF_040790715.1_ASM4079071v1_genomic	NZ_CP161144.1	87204	86769	435	renamed_GCF_000008685.2	chromosome	87360	86925	435	100.0	2.772e-92
GCF_040790715.1_ASM4079071v1_genomic	NZ_CP161144.1	90959	89654	1305	renamed_GCF_000008685.2	chromosome	91115	89810	1305	100.0	2.863e-289
GCF_040790715.1_ASM4079071v1_genomic	NZ_CP161144.1	103614	102858	756	renamed_GCF_000008685.2	chromosome	103771	103015	756	99.6	2.151e-165
GCF_040790715.1_ASM4079071v1_genomic	NZ_CP161144.1	137607	135714	1893	renamed_GCF_000008685.2	chromosome	137766	135873	1893	99.6	0.0
GCF_040790715.1_ASM4079071v1_genomic	NZ_CP161144.1	142775	141821	954	renamed_GCF_000008685.2	chromosome	142932	141978	954	99.3	1.665e-201
GCF_040790715.1_ASM4079071v1_genomic	NZ_CP161144.1	145301	144428	873	renamed_GCF_000008685.2	chromosome	145458	144585	873	98.9	1.511e-197
GCF_040790715.1_ASM4079071v1_genomic	NZ_CP161144.1	147338	146219	1119	renamed_GCF_000008685.2	chromosome	147495	146376	1119	100.0	3.727e-246
GCF_040790715.1_ASM4079071v1_genomic	NZ_CP161144.1	152044	152851	807	renamed_GCF_000008685.2	chromosome	152205	153012	807	99.2	2.384e-181
GCF_040790715.1_ASM4079071v1_genomic	NZ_CP161144.1	156239	153539	2700	renamed_GCF_000008685.2	chromosome	156400	153700	2700	99.8	0.0
GCF_040790715.1_ASM4079071v1_genomic	NZ_CP161144.1	157465	157900	435	renamed_GCF_000008685.2	chromosome	157626	158061	435	99.3	1.372e-91
GCF_040790715.1_ASM4079071v1_genomic	NZ_CP161144.1	189115	188914	201	renamed_GCF_000008685.2	chromosome	189276	189075	201	100.0	9.889e-41
GCF_040790715.1_ASM4079071v1_genomic	NZ_CP161144.1	189902	190556	654	renamed_GCF_000008685.2	chromosome	190186	190717	654	99.4	1.404e-110
GCF_040790715.1_ASM4079071v1_genomic	NZ_CP161144.1	192166	191356	810	renamed_GCF_000008685.2	chromosome	192327	191517	810	99.6	1.125e-181
GCF_040790715.1_ASM4079071v1_genomic	NZ_CP161144.1	195531	197535	2004	renamed_GCF_000008685.2	chromosome	195692	197696	2004	99.7	0.0
GCF_040790715.1_ASM4079071v1_genomic	NZ_CP161144.1	200905	199819	1086	renamed_GCF_000008685.2	chromosome	201050	199964	1086	99.4	6.528e-243
GCF_040790715.1_ASM4079071v1_genomic	NZ_CP161144.1	202704	203943	1239	renamed_GCF_000008685.2	chromosome	202849	204088	1239	100.0	5.514e-262
GCF_040790715.1_ASM4079071v1_genomic	NZ_CP161144.1	204927	205899	972	renamed_GCF_000008685.2	chromosome	205174	206044	972	99.6	3.289e-188
GCF_040790715.1_ASM4079071v1_genomic	NZ_CP161144.1	208474	207937	537	renamed_GCF_000008685.2	chromosome	208581	208083	537	99.3	7.373e-107
GCF_040790715.1_ASM4079071v1_genomic	NZ_CP161144.1	224639	223817	822	renamed_GCF_000008685.2	chromosome	224785	223963	822	100.0	3.638e-179
GCF_040790715.1_ASM4079071v1_genomic	NZ_CP161144.1	263840	265967	2127	renamed_GCF_000008685.2	chromosome	263987	266114	2127	99.4	0.0
GCF_040790715.1_ASM4079071v1_genomic	NZ_CP161144.1	266918	267128	210	renamed_GCF_000008685.2	chromosome	267065	267275	210	100.0	4.647e-42
GCF_040790715.1_ASM4079071v1_genomic	NZ_CP161144.1	270326	269525	801	renamed_GCF_000008685.2	chromosome	270473	269672	801	99.6	3.29e-168
GCF_040790715.1_ASM4079071v1_genomic	NZ_CP161144.1	273500	272486	1014	renamed_GCF_000008685.2	chromosome	273647	272633	1014	97.9	8.787e-219
GCF_040790715.1_ASM4079071v1_genomic	NZ_CP161144.1	276349	275095	1254	renamed_GCF_000008685.2	chromosome	276496	275242	1254	99.2	2.7e-281
GCF_040790715.1_ASM4079071v1_genomic	NZ_CP161144.1	278412	276942	1470	renamed_GCF_000008685.2	chromosome	278559	277089	1470	99.5	9.743e-321
GCF_040790715.1_ASM4079071v1_genomic	NZ_CP161144.1	279233	278930	303	renamed_GCF_000008685.2	chromosome	279380	279077	303	96.0	6.277e-62
GCF_040790715.1_ASM4079071v1_genomic	NZ_CP161144.1	281646	281166	480	renamed_GCF_000008685.2	chromosome	281793	281313	480	99.3	5.307e-101
GCF_040790715.1_ASM4079071v1_genomic	NZ_CP161144.1	292279	291496	783	renamed_GCF_000008685.2	chromosome	292426	291643	783	100.0	1.874e-171
GCF_040790715.1_ASM4079071v1_genomic	NZ_CP161144.1	416398	415720	678	renamed_GCF_000008685.2	chromosome	416478	415845	678	99.5	1.008e-143
GCF_040790715.1_ASM4079071v1_genomic	NZ_CP161144.1	425460	426588	1128	renamed_GCF_000008685.2	chromosome	425583	426711	1128	99.7	5.155e-244
GCF_040790715.1_ASM4079071v1_genomic	NZ_CP161144.1	426612	427827	1215	renamed_GCF_000008685.2	chromosome	426735	427950	1215	99.7	1.711e-262
GCF_040790715.1_ASM4079071v1_genomic	NZ_CP161144.1	427863	428499	636	renamed_GCF_000008685.2	chromosome	427986	428622	636	99.5	1.686e-139
GCF_040790715.1_ASM4079071v1_genomic	NZ_CP161144.1	428522	429551	1029	renamed_GCF_000008685.2	chromosome	428645	429674	1029	99.1	2.098e-237
GCF_040790715.1_ASM4079071v1_genomic	NZ_CP161144.1	430493	429569	924	renamed_GCF_000008685.2	chromosome	430616	429692	924	98.0	2.542e-200
GCF_040790715.1_ASM4079071v1_genomic	NZ_CP161144.1	434980	430495	4485	renamed_GCF_000008685.2	chromosome	435103	430618	4485	98.1	0.0
GCF_040790715.1_ASM4079071v1_genomic	NZ_CP161144.1	438951	438345	606	renamed_GCF_000008685.2	chromosome	442552	441712	606	99.0	2.035e-132
GCF_040790715.1_ASM4079071v1_genomic	NZ_CP161144.1	439917	439356	561	renamed_GCF_000008685.2	chromosome	443248	442687	561	99.4	1.054e-123
GCF_040790715.1_ASM4079071v1_genomic	NZ_CP161144.1	453245	454706	1461	renamed_GCF_000008685.2	chromosome	456575	458036	1461	99.5	0.0
GCF_040790715.1_ASM4079071v1_genomic	NZ_CP161144.1	466334	466058	276	renamed_GCF_000008685.2	chromosome	469665	469389	276	97.8	9.032e-54
GCF_040790715.1_ASM4079071v1_genomic	NZ_CP161144.1	466640	466346	294	renamed_GCF_000008685.2	chromosome	469971	469677	294	100.0	2.2e-63
GCF_040790715.1_ASM4079071v1_genomic	NZ_CP161144.1	467889	466629	1260	renamed_GCF_000008685.2	chromosome	471220	469960	1260	100.0	2.539e-274
GCF_040790715.1_ASM4079071v1_genomic	NZ_CP161144.1	468425	467891	534	renamed_GCF_000008685.2	chromosome	471756	471222	534	100.0	8.816e-113
GCF_040790715.1_ASM4079071v1_genomic	NZ_CP161144.1	469144	468439	705	renamed_GCF_000008685.2	chromosome	472358	471770	705	99.4	1.099e-121
GCF_040790715.1_ASM4079071v1_genomic	NZ_CP161144.1	469234	470077	843	renamed_GCF_000008685.2	chromosome	472565	473408	843	100.0	5.328e-187
GCF_040790715.1_ASM4079071v1_genomic	NZ_CP161144.1	471225	470073	1152	renamed_GCF_000008685.2	chromosome	474556	473404	1152	100.0	7.714e-261
GCF_040790715.1_ASM4079071v1_genomic	NZ_CP161144.1	471281	472271	990	renamed_GCF_000008685.2	chromosome	474612	475602	990	99.6	3.939e-215
GCF_040790715.1_ASM4079071v1_genomic	NZ_CP161144.1	472274	472880	606	renamed_GCF_000008685.2	chromosome	475605	476211	606	100.0	1.006e-131
GCF_040790715.1_ASM4079071v1_genomic	NZ_CP161144.1	496007	496370	363	renamed_GCF_000008685.2	chromosome	499340	499703	363	100.0	3.407e-78
GCF_040790715.1_ASM4079071v1_genomic	NZ_CP161144.1	497678	497879	201	renamed_GCF_000008685.2	chromosome	501014	501212	201	98.4	1.098e-39
GCF_040790715.1_ASM4079071v1_genomic	NZ_CP161144.1	498163	498532	369	renamed_GCF_000008685.2	chromosome	501496	501865	369	99.1	4.571e-76
GCF_040790715.1_ASM4079071v1_genomic	NZ_CP161144.1	498857	499406	549	renamed_GCF_000008685.2	chromosome	502190	502739	549	100.0	1.698e-116
GCF_040790715.1_ASM4079071v1_genomic	NZ_CP161144.1	499617	500016	399	renamed_GCF_000008685.2	chromosome	502950	503349	399	100.0	3.071e-85
GCF_040790715.1_ASM4079071v1_genomic	NZ_CP161144.1	500592	500952	360	renamed_GCF_000008685.2	chromosome	503925	504285	360	100.0	4.361e-75
GCF_040790715.1_ASM4079071v1_genomic	NZ_CP161144.1	501465	501771	306	renamed_GCF_000008685.2	chromosome	504798	505104	306	100.0	1.468e-61
GCF_040790715.1_ASM4079071v1_genomic	NZ_CP161144.1	502220	503525	1305	renamed_GCF_000008685.2	chromosome	505553	506858	1305	99.7	2.039e-284
GCF_040790715.1_ASM4079071v1_genomic	NZ_CP161144.1	513152	519653	6501	renamed_GCF_000008685.2	chromosome	516492	522993	6501	99.2	0.0
GCF_040790715.1_ASM4079071v1_genomic	NZ_CP161144.1	546278	545579	699	renamed_GCF_000008685.2	chromosome	549618	548919	699	100.0	1.058e-146
GCF_040790715.1_ASM4079071v1_genomic	NZ_CP161144.1	549804	550455	651	renamed_GCF_000008685.2	chromosome	553138	553789	651	100.0	1.464e-143
GCF_040790715.1_ASM4079071v1_genomic	NZ_CP161144.1	564458	564926	468	renamed_GCF_000008685.2	chromosome	567809	568277	468	100.0	1.969e-101
GCF_040790715.1_ASM4079071v1_genomic	NZ_CP161144.1	565925	566186	261	renamed_GCF_000008685.2	chromosome	569277	569538	261	100.0	9.575e-51
GCF_040790715.1_ASM4079071v1_genomic	NZ_CP161144.1	567930	568500	570	renamed_GCF_000008685.2	chromosome	571282	571852	570	100.0	1.471e-121
GCF_040790715.1_ASM4079071v1_genomic	NZ_CP161144.1	570500	571895	1395	renamed_GCF_000008685.2	chromosome	573852	575247	1395	99.5	1.406e-312
GCF_040790715.1_ASM4079071v1_genomic	NZ_CP161144.1	573174	572628	546	renamed_GCF_000008685.2	chromosome	576499	575980	546	100.0	1.781e-115
GCF_040790715.1_ASM4079071v1_genomic	NZ_CP161144.1	627403	628621	1218	renamed_GCF_000008685.2	chromosome	630795	631986	1218	99.4	4.366e-261
GCF_040790715.1_ASM4079071v1_genomic	NZ_CP161144.1	629119	631099	1980	renamed_GCF_000008685.2	chromosome	632484	634464	1980	99.2	0.0
GCF_040790715.1_ASM4079071v1_genomic	NZ_CP161144.1	677192	676382	810	renamed_GCF_000008685.2	chromosome	680557	679753	810	99.2	5.794e-172
GCF_040790715.1_ASM4079071v1_genomic	NZ_CP161144.1	679153	678313	840	renamed_GCF_000008685.2	chromosome	682524	681684	840	100.0	1.641e-182
GCF_040790715.1_ASM4079071v1_genomic	NZ_CP161144.1	680051	681596	1545	renamed_GCF_000008685.2	chromosome	683422	684967	1545	99.8	0.0
GCF_040790715.1_ASM4079071v1_genomic	NZ_CP161144.1	694058	693371	687	renamed_GCF_000008685.2	chromosome	697437	696750	687	99.1	7.255e-149
GCF_040790715.1_ASM4079071v1_genomic	NZ_CP161144.1	696586	695020	1566	renamed_GCF_000008685.2	chromosome	699965	698399	1566	99.4	0.0
GCF_040790715.1_ASM4079071v1_genomic	NZ_CP161144.1	697649	698006	357	renamed_GCF_000008685.2	chromosome	701028	701385	357	99.1	2.301e-81
GCF_040790715.1_ASM4079071v1_genomic	NZ_CP161144.1	698445	698895	450	renamed_GCF_000008685.2	chromosome	701824	702274	450	99.3	2.172e-97
GCF_040790715.1_ASM4079071v1_genomic	NZ_CP161144.1	699629	700589	960	renamed_GCF_000008685.2	chromosome	703008	703968	960	100.0	6.008e-214
GCF_040790715.1_ASM4079071v1_genomic	NZ_CP161144.1	701569	702121	552	renamed_GCF_000008685.2	chromosome	704948	705500	552	95.6	1.781e-116
GCF_040790715.1_ASM4079071v1_genomic	NZ_CP161144.1	703291	705886	2595	renamed_GCF_000008685.2	chromosome	706672	709267	2595	99.5	0.0
GCF_040790715.1_ASM4079071v1_genomic	NZ_CP161144.1	736854	737037	183	renamed_GCF_000008685.2	chromosome	740239	740422	183	100.0	1.805e-39
GCF_040790715.1_ASM4079071v1_genomic	NZ_CP161144.1	737302	738040	738	renamed_GCF_000008685.2	chromosome	740687	741425	738	100.0	4.772e-162
GCF_040790715.1_ASM4079071v1_genomic	NZ_CP161144.1	739358	741131	1773	renamed_GCF_000008685.2	chromosome	742743	744516	1773	99.3	0.0
GCF_040790715.1_ASM4079071v1_genomic	NZ_CP161144.1	756817	758263	1446	renamed_GCF_000008685.2	chromosome	760225	761647	1446	98.3	6.888e-312
GCF_040790715.1_ASM4079071v1_genomic	NZ_CP161144.1	760986	761958	972	renamed_GCF_000008685.2	chromosome	764370	765342	972	99.6	1.468e-214
GCF_040790715.1_ASM4079071v1_genomic	NZ_CP161144.1	764680	763348	1332	renamed_GCF_000008685.2	chromosome	768064	766732	1332	98.6	1.788e-290
GCF_040790715.1_ASM4079071v1_genomic	NZ_CP161144.1	767755	766162	1593	renamed_GCF_000008685.2	chromosome	771139	769546	1593	99.4	0.0
GCF_040790715.1_ASM4079071v1_genomic	NZ_CP161144.1	770984	768185	2799	renamed_GCF_000008685.2	chromosome	774368	771569	2799	99.6	0.0
GCF_040790715.1_ASM4079071v1_genomic	NZ_CP161144.1	805079	804590	489	renamed_GCF_000008685.2	chromosome	808464	807975	489	100.0	6.125e-101
GCF_040790715.1_ASM4079071v1_genomic	NZ_CP161144.1	807110	806315	795	renamed_GCF_000008685.2	chromosome	810495	809700	795	100.0	1.877e-173
GCF_040790715.1_ASM4079071v1_genomic	NZ_CP161144.1	809003	808121	882	renamed_GCF_000008685.2	chromosome	812388	811506	882	99.3	2.773e-192
GCF_040790715.1_ASM4079071v1_genomic	NZ_CP161144.1	816192	817179	987	renamed_GCF_000008685.2	chromosome	819541	820528	987	100.0	5.255e-220
GCF_040790715.1_ASM4079071v1_genomic	NZ_CP161144.1	817835	819020	1185	renamed_GCF_000008685.2	chromosome	821184	822369	1185	99.7	1.177e-261
GCF_040790715.1_ASM4079071v1_genomic	NZ_CP161144.1	819460	819754	294	renamed_GCF_000008685.2	chromosome	822809	823103	294	100.0	1.207e-61
GCF_040790715.1_ASM4079071v1_genomic	NZ_CP161144.1	820466	821033	567	renamed_GCF_000008685.2	chromosome	823815	824382	567	99.4	6.307e-122
GCF_040790715.1_ASM4079071v1_genomic	NZ_CP161144.1	822351	824271	1920	renamed_GCF_000008685.2	chromosome	825700	827620	1920	100.0	0.0
GCF_040790715.1_ASM4079071v1_genomic	NZ_CP161144.1	825868	826972	1104	renamed_GCF_000008685.2	chromosome	829217	830321	1104	99.1	5.448e-248
GCF_040790715.1_ASM4079071v1_genomic	NZ_CP161144.1	828214	827605	609	renamed_GCF_000008685.2	chromosome	831563	830954	609	100.0	7.938e-135
GCF_040790715.1_ASM4079071v1_genomic	NZ_CP161144.1	886943	889796	2853	renamed_GCF_000008685.2	chromosome	890321	893174	2853	99.7	0.0
GCF_040790715.1_ASM4079071v1_genomic	NZ_CP161144.1	893746	893200	546	renamed_GCF_000008685.2	chromosome	897127	896578	546	97.7	8.009e-116
GCF_040790715.1_ASM4079071v1_genomic	NZ_CP161144.1	895939	894322	1617	renamed_GCF_000008685.2	chromosome	899320	897703	1617	99.4	0.0
GCF_040790715.1_ASM4079071v1_genomic	NZ_CP161144.1	897417	898401	984	renamed_GCF_000008685.2	chromosome	900798	901782	984	100.0	5.014e-220
GCF_040790715.1_ASM4079071v1_genomic	NZ_CP161154.1	45	324	279	renamed_GCF_000008685.2	cp26	45	324	279	98.9	5.175e-60
GCF_040790715.1_ASM4079071v1_genomic	NZ_CP161154.1	2189	839	1350	renamed_GCF_000008685.2	cp26	2186	836	1350	98.8	9.453e-301
GCF_040790715.1_ASM4079071v1_genomic	NZ_CP161154.1	4084	4432	348	renamed_GCF_000008685.2	cp26	4083	4431	348	99.1	5.329e-71
GCF_040790715.1_ASM4079071v1_genomic	NZ_CP161146.1	8976	10314	1338	renamed_GCF_000008685.2	cp32-7	8969	10304	1338	98.2	1.677e-283
GCF_040790715.1_ASM4079071v1_genomic	NZ_CP161146.1	10971	11913	942	renamed_GCF_000008685.2	cp32-7	10961	11903	942	98.4	7.211e-209
GCF_040790715.1_ASM4079071v1_genomic	NZ_CP161146.1	12512	12845	333	renamed_GCF_000008685.2	cp32-8	12494	12827	333	100.0	8.424e-72
GCF_040790715.1_ASM4079071v1_genomic	NZ_CP161146.1	13725	14331	606	renamed_GCF_000008685.2	cp32-7	13715	14321	606	97.0	7.992e-126
GCF_040790715.1_ASM4079071v1_genomic	NZ_CP161146.1	15229	15433	204	renamed_GCF_000008685.2	cp32-7	15221	15425	204	100.0	2.578e-39
GCF_040790715.1_ASM4079071v1_genomic	NZ_CP161146.1	16559	17114	555	renamed_GCF_000008685.2	cp32-3	17088	17697	555	91.0	2.485e-113
GCF_040790715.1_ASM4079071v1_genomic	NZ_CP161146.1	18858	17910	948	renamed_GCF_000008685.2	cp32-6	18680	17732	948	98.7	4.537e-215
GCF_040790715.1_ASM4079071v1_genomic	NZ_CP161147.1	6165	6732	567	renamed_GCF_000008685.2	cp32-9	6169	6736	567	99.4	4.74e-125
GCF_040790715.1_ASM4079071v1_genomic	NZ_CP161147.1	6712	7825	1113	renamed_GCF_000008685.2	cp32-4	6710	7823	1113	98.6	2.015e-243
GCF_040790715.1_ASM4079071v1_genomic	NZ_CP161147.1	10700	11651	951	renamed_GCF_000008685.2	cp32-4	10895	11846	951	76.6	9.078e-156
GCF_040790715.1_ASM4079071v1_genomic	NZ_CP161147.1	14079	14892	813	renamed_GCF_000008685.2	cp32-8	14323	15139	813	59.9	7.62e-100
GCF_040790715.1_ASM4079071v1_genomic	NZ_CP161147.1	15175	15523	348	renamed_GCF_000008685.2	cp32-6	15437	15785	348	99.1	1.964e-73
GCF_040790715.1_ASM4079071v1_genomic	NZ_CP161147.1	16813	16330	483	renamed_GCF_000008685.2	cp32-6	17075	16592	483	69.29	4.924e-69
GCF_040790715.1_ASM4079071v1_genomic	NZ_CP161148.1	12443	12776	333	renamed_GCF_000008685.2	cp32-3	12494	12827	333	100.0	8.424e-72
GCF_040790715.1_ASM4079071v1_genomic	NZ_CP161148.1	20696	21437	741	renamed_GCF_000008685.2	cp32-8	20739	21480	741	99.5	5.003e-162
GCF_040790715.1_ASM4079071v1_genomic	NZ_CP161148.1	23140	24466	1326	renamed_GCF_000008685.2	cp32-7	23134	24460	1326	99.0	1.737e-298
GCF_040790715.1_ASM4079071v1_genomic	NZ_CP161148.1	25744	24949	795	renamed_GCF_000008685.2	cp32-4	25435	24640	795	98.4	7.691e-175
GCF_040790715.1_ASM4079071v1_genomic	NZ_CP161148.1	27360	27933	573	renamed_GCF_000008685.2	cp32-8	28250	28790	573	98.2	1.795e-111
GCF_040790715.1_ASM4079071v1_genomic	NZ_CP161157.1	7635	7056	579	renamed_GCF_000008685.2	lp17	6452	5873	579	99.4	1.16e-125
GCF_040790715.1_ASM4079071v1_genomic	NZ_CP161151.1	22700	22976	276	renamed_GCF_000008685.2	lp28-3	22677	22953	276	100.0	6.026e-58
GCF_040790715.1_ASM4079071v1_genomic	NZ_CP161151.1	27466	26998	468	renamed_GCF_000008685.2	lp28-3	27445	26977	468	99.3	1.339e-105
GCF_040790715.1_ASM4079071v1_genomic	NZ_CP161149.1	14001	14556	555	renamed_GCF_000008685.2	lp28-4	11923	12478	555	100.0	3.559e-126
GCF_040790715.1_ASM4079071v1_genomic	NZ_CP161149.1	15342	15915	573	renamed_GCF_000008685.2	lp28-4	13264	13837	573	100.0	2.579e-124
GCF_040790715.1_ASM4079071v1_genomic	NZ_CP161149.1	21258	20592	666	renamed_GCF_000008685.2	lp28-4	19183	18517	666	99.5	1.537e-145
GCF_040790715.1_ASM4079071v1_genomic	NZ_CP161149.1	25006	24169	837	renamed_GCF_000008685.2	lp28-4	22931	22094	837	98.9	7.731e-182
GCF_040790715.1_ASM4079071v1_genomic	NZ_CP161149.1	29742	28848	894	renamed_GCF_000008685.2	lp36	187	1081	894	98.6	8.951e-190
GCF_040790715.1_ASM4079071v1_genomic	NZ_CP161153.1	26030	25661	369	renamed_GCF_000008685.2	lp5	1207	1576	369	91.8	3.043e-72
GCF_040790715.1_ASM4079071v1_genomic	NZ_CP161156.1	7755	9402	1647	renamed_GCF_000008685.2	lp36	10300	11947	1647	99.8	0.0
GCF_040790715.1_ASM4079071v1_genomic	NZ_CP161156.1	11781	11031	750	renamed_GCF_000008685.2	lp36	14326	13576	750	100.0	1.062e-163
GCF_040790715.1_ASM4079071v1_genomic	NZ_CP161156.1	13215	12288	927	renamed_GCF_000008685.2	lp36	15760	14833	927	99.6	1.39e-207
GCF_040790715.1_ASM4079071v1_genomic	NZ_CP161156.1	15628	16702	1074	renamed_GCF_000008685.2	lp36	20388	21453	1074	98.5	3.995e-229
GCF_040790715.1_ASM4079071v1_genomic	NZ_CP161156.1	18348	18642	294	renamed_GCF_000008685.2	lp28-1	10895	10697	294	98.4	2.041e-40
GCF_040790715.1_ASM4079071v1_genomic	NZ_CP161156.1	22241	21392	849	renamed_GCF_000008685.2	lp36	35443	34594	849	98.2	2.634e-187
GCF_040790715.1_ASM4079071v1_genomic	NZ_CP161145.1	34402	34966	564	renamed_GCF_000008685.2	lp54	34384	34948	564	99.4	3.599e-119
GCF_040790715.1_ASM4079071v1_genomic	NZ_CP161144.1	1790	761	1029	renamed_GCF_000008685.2	chromosome	1796	767	1029	100.0	4.829e-228
GCF_040790715.1_ASM4079071v1_genomic	NZ_CP161144.1	3389	5183	1794	renamed_GCF_000008685.2	chromosome	3418	5188	1794	99.3	0.0
GCF_040790715.1_ASM4079071v1_genomic	NZ_CP161144.1	7392	6303	1089	renamed_GCF_000008685.2	chromosome	7397	6308	1089	99.7	9.025e-240
GCF_040790715.1_ASM4079071v1_genomic	NZ_CP161144.1	8421	9192	771	renamed_GCF_000008685.2	chromosome	8426	9197	771	100.0	1.781e-161
GCF_040790715.1_ASM4079071v1_genomic	NZ_CP161144.1	10197	10572	375	renamed_GCF_000008685.2	chromosome	10202	10577	375	99.1	8.349e-79
GCF_040790715.1_ASM4079071v1_genomic	NZ_CP161144.1	11415	12156	741	renamed_GCF_000008685.2	chromosome	11420	12161	741	99.1	4.555e-163
GCF_040790715.1_ASM4079071v1_genomic	NZ_CP161144.1	12740	14723	1983	renamed_GCF_000008685.2	chromosome	12745	14728	1983	99.5	0.0
GCF_040790715.1_ASM4079071v1_genomic	NZ_CP161144.1	15717	15339	378	renamed_GCF_000008685.2	chromosome	15716	15344	378	99.1	3.937e-79
GCF_040790715.1_ASM4079071v1_genomic	NZ_CP161144.1	39669	40521	852	renamed_GCF_000008685.2	chromosome	39825	40677	852	99.6	5.092e-189
GCF_040790715.1_ASM4079071v1_genomic	NZ_CP161144.1	41276	40604	672	renamed_GCF_000008685.2	chromosome	41432	40760	672	100.0	1.856e-144
GCF_040790715.1_ASM4079071v1_genomic	NZ_CP161144.1	42725	42323	402	renamed_GCF_000008685.2	chromosome	42881	42479	402	100.0	2.405e-88
GCF_040790715.1_ASM4079071v1_genomic	NZ_CP161144.1	45289	45835	546	renamed_GCF_000008685.2	chromosome	45445	45991	546	100.0	3.273e-117
GCF_040790715.1_ASM4079071v1_genomic	NZ_CP161144.1	47010	47685	675	renamed_GCF_000008685.2	chromosome	47166	47841	675	98.6	2.138e-143
GCF_040790715.1_ASM4079071v1_genomic	NZ_CP161144.1	49103	48446	657	renamed_GCF_000008685.2	chromosome	49259	48602	657	99.0	5.221e-139
GCF_040790715.1_ASM4079071v1_genomic	NZ_CP161144.1	59881	58942	939	renamed_GCF_000008685.2	chromosome	60039	59100	939	99.3	9.091e-206
GCF_040790715.1_ASM4079071v1_genomic	NZ_CP161144.1	61099	60409	690	renamed_GCF_000008685.2	chromosome	61257	60567	690	98.6	3.759e-148
GCF_040790715.1_ASM4079071v1_genomic	NZ_CP161144.1	63879	65118	1239	renamed_GCF_000008685.2	chromosome	64037	65276	1239	100.0	5.707e-279
GCF_040790715.1_ASM4079071v1_genomic	NZ_CP161144.1	65132	65594	462	renamed_GCF_000008685.2	chromosome	65290	65752	462	100.0	3.193e-95
GCF_040790715.1_ASM4079071v1_genomic	NZ_CP161144.1	121664	120941	723	renamed_GCF_000008685.2	chromosome	121823	121100	723	98.7	4.546e-160
GCF_040790715.1_ASM4079071v1_genomic	NZ_CP161144.1	123987	122331	1656	renamed_GCF_000008685.2	chromosome	124146	122490	1656	99.2	0.0
GCF_040790715.1_ASM4079071v1_genomic	NZ_CP161144.1	125388	124638	750	renamed_GCF_000008685.2	chromosome	125547	124797	750	100.0	1.281e-161
GCF_040790715.1_ASM4079071v1_genomic	NZ_CP161144.1	127254	126156	1098	renamed_GCF_000008685.2	chromosome	127413	126315	1098	100.0	1.369e-236
GCF_040790715.1_ASM4079071v1_genomic	NZ_CP161144.1	130955	130010	945	renamed_GCF_000008685.2	chromosome	131114	130169	945	100.0	6.888e-210
GCF_040790715.1_ASM4079071v1_genomic	NZ_CP161144.1	158466	159183	717	renamed_GCF_000008685.2	chromosome	158627	159344	717	97.0	3.592e-153
GCF_040790715.1_ASM4079071v1_genomic	NZ_CP161144.1	159928	161047	1119	renamed_GCF_000008685.2	chromosome	160089	161208	1119	99.7	1.16e-250
GCF_040790715.1_ASM4079071v1_genomic	NZ_CP161144.1	162716	162884	168	renamed_GCF_000008685.2	chromosome	162877	163045	168	100.0	5.294e-34
GCF_040790715.1_ASM4079071v1_genomic	NZ_CP161144.1	165726	164739	987	renamed_GCF_000008685.2	chromosome	165887	164900	987	100.0	2.687e-210
GCF_040790715.1_ASM4079071v1_genomic	NZ_CP161144.1	169238	167717	1521	renamed_GCF_000008685.2	chromosome	169399	167878	1521	99.6	0.0
GCF_040790715.1_ASM4079071v1_genomic	NZ_CP161144.1	341136	342186	1050	renamed_GCF_000008685.2	chromosome	341273	342323	1050	100.0	1.489e-227
GCF_040790715.1_ASM4079071v1_genomic	NZ_CP161144.1	343070	344042	972	renamed_GCF_000008685.2	chromosome	343207	344179	972	100.0	3.579e-213
GCF_040790715.1_ASM4079071v1_genomic	NZ_CP161144.1	346703	346292	411	renamed_GCF_000008685.2	chromosome	346841	346430	411	100.0	6.821e-87
GCF_040790715.1_ASM4079071v1_genomic	NZ_CP161144.1	348022	347212	810	renamed_GCF_000008685.2	chromosome	348160	347350	810	99.6	4.196e-184
GCF_040790715.1_ASM4079071v1_genomic	NZ_CP161144.1	350910	349461	1449	renamed_GCF_000008685.2	chromosome	351045	349599	1449	99.7	6.4e-322
GCF_040790715.1_ASM4079071v1_genomic	NZ_CP161144.1	385311	386025	714	renamed_GCF_000008685.2	chromosome	385448	386162	714	100.0	3.427e-153
GCF_040790715.1_ASM4079071v1_genomic	NZ_CP161144.1	387196	387670	474	renamed_GCF_000008685.2	chromosome	387333	387807	474	100.0	1.339e-106
GCF_040790715.1_ASM4079071v1_genomic	NZ_CP161144.1	388789	388369	420	renamed_GCF_000008685.2	chromosome	388926	388506	420	100.0	9.787e-93
GCF_040790715.1_ASM4079071v1_genomic	NZ_CP161144.1	391682	390257	1425	renamed_GCF_000008685.2	chromosome	391819	390391	1425	99.5	0.0
GCF_040790715.1_ASM4079071v1_genomic	NZ_CP161144.1	393926	392906	1020	renamed_GCF_000008685.2	chromosome	394063	393043	1020	100.0	6.665e-223
GCF_040790715.1_ASM4079071v1_genomic	NZ_CP161144.1	486157	486385	228	renamed_GCF_000008685.2	chromosome	489539	489719	228	100.0	1.455e-33
GCF_040790715.1_ASM4079071v1_genomic	NZ_CP161144.1	487309	488593	1284	renamed_GCF_000008685.2	chromosome	490643	491927	1284	100.0	9.564e-281
GCF_040790715.1_ASM4079071v1_genomic	NZ_CP161144.1	491205	490815	390	renamed_GCF_000008685.2	chromosome	494539	494149	390	99.2	2.146e-79
GCF_040790715.1_ASM4079071v1_genomic	NZ_CP161144.1	492934	493246	312	renamed_GCF_000008685.2	chromosome	496267	496579	312	100.0	2.953e-63
GCF_040790715.1_ASM4079071v1_genomic	NZ_CP161144.1	493281	493902	621	renamed_GCF_000008685.2	chromosome	496614	497235	621	100.0	8.732e-136
GCF_040790715.1_ASM4079071v1_genomic	NZ_CP161144.1	503668	504046	378	renamed_GCF_000008685.2	chromosome	507001	507379	378	100.0	8.763e-79
GCF_040790715.1_ASM4079071v1_genomic	NZ_CP161144.1	504480	505515	1035	renamed_GCF_000008685.2	chromosome	507813	508848	1035	100.0	4.156e-222
GCF_040790715.1_ASM4079071v1_genomic	NZ_CP161144.1	505536	505908	372	renamed_GCF_000008685.2	chromosome	508869	509241	372	100.0	8.775e-78
GCF_040790715.1_ASM4079071v1_genomic	NZ_CP161144.1	505980	507513	1533	renamed_GCF_000008685.2	chromosome	509313	510846	1533	100.0	0.0
GCF_040790715.1_ASM4079071v1_genomic	NZ_CP161144.1	507502	508291	789	renamed_GCF_000008685.2	chromosome	510835	511624	789	100.0	3.149e-175
GCF_040790715.1_ASM4079071v1_genomic	NZ_CP161144.1	558591	558210	381	renamed_GCF_000008685.2	chromosome	561943	561562	381	99.2	5.027e-77
GCF_040790715.1_ASM4079071v1_genomic	NZ_CP161144.1	558832	560815	1983	renamed_GCF_000008685.2	chromosome	562184	564167	1983	99.6	0.0
GCF_040790715.1_ASM4079071v1_genomic	NZ_CP161144.1	573835	573229	606	renamed_GCF_000008685.2	chromosome	577187	576581	606	99.5	4.975e-131
GCF_040790715.1_ASM4079071v1_genomic	NZ_CP161144.1	574041	574584	543	renamed_GCF_000008685.2	chromosome	577394	577937	543	100.0	3.121e-117
GCF_040790715.1_ASM4079071v1_genomic	NZ_CP161144.1	574596	574908	312	renamed_GCF_000008685.2	chromosome	577949	578261	312	100.0	5.387e-65
GCF_040790715.1_ASM4079071v1_genomic	NZ_CP161144.1	574923	577068	2145	renamed_GCF_000008685.2	chromosome	578276	580421	2145	99.7	0.0
GCF_040790715.1_ASM4079071v1_genomic	NZ_CP161144.1	577125	578283	1158	renamed_GCF_000008685.2	chromosome	580485	581643	1158	100.0	7.971e-253
GCF_040790715.1_ASM4079071v1_genomic	NZ_CP161144.1	578284	580057	1773	renamed_GCF_000008685.2	chromosome	581644	583417	1773	99.4	0.0
GCF_040790715.1_ASM4079071v1_genomic	NZ_CP161144.1	580097	580472	375	renamed_GCF_000008685.2	chromosome	583457	583832	375	99.1	1.859e-78
GCF_040790715.1_ASM4079071v1_genomic	NZ_CP161144.1	593165	595226	2061	renamed_GCF_000008685.2	chromosome	596530	598591	2061	100.0	0.0
GCF_040790715.1_ASM4079071v1_genomic	NZ_CP161144.1	596011	595222	789	renamed_GCF_000008685.2	chromosome	599376	598587	789	99.2	5.285e-178
GCF_040790715.1_ASM4079071v1_genomic	NZ_CP161144.1	596129	597479	1350	renamed_GCF_000008685.2	chromosome	599494	600844	1350	100.0	3.989e-293
GCF_040790715.1_ASM4079071v1_genomic	NZ_CP161144.1	597644	598979	1335	renamed_GCF_000008685.2	chromosome	601009	602344	1335	100.0	3.161e-293
GCF_040790715.1_ASM4079071v1_genomic	NZ_CP161144.1	599008	600364	1356	renamed_GCF_000008685.2	chromosome	602373	603729	1356	99.3	1.137e-299
GCF_040790715.1_ASM4079071v1_genomic	NZ_CP161144.1	601404	600360	1044	renamed_GCF_000008685.2	chromosome	604769	603725	1044	99.4	3.503e-234
GCF_040790715.1_ASM4079071v1_genomic	NZ_CP161144.1	603618	601413	2205	renamed_GCF_000008685.2	chromosome	606983	604778	2205	99.8	0.0
GCF_040790715.1_ASM4079071v1_genomic	NZ_CP161144.1	603772	604570	798	renamed_GCF_000008685.2	chromosome	607137	607935	798	97.7	6.355e-169
GCF_040790715.1_ASM4079071v1_genomic	NZ_CP161144.1	606541	605695	846	renamed_GCF_000008685.2	chromosome	609906	609060	846	100.0	3.324e-184
GCF_040790715.1_ASM4079071v1_genomic	NZ_CP161144.1	621641	622895	1254	renamed_GCF_000008685.2	chromosome	625006	626260	1254	100.0	1.925e-276
GCF_040790715.1_ASM4079071v1_genomic	NZ_CP161144.1	622920	623673	753	renamed_GCF_000008685.2	chromosome	626285	627038	753	100.0	9.23e-166
GCF_040790715.1_ASM4079071v1_genomic	NZ_CP161144.1	625583	623726	1857	renamed_GCF_000008685.2	chromosome	628948	627091	1857	100.0	0.0
GCF_040790715.1_ASM4079071v1_genomic	NZ_CP161144.1	651442	653536	2094	renamed_GCF_000008685.2	chromosome	654862	656902	2094	98.9	0.0
GCF_040790715.1_ASM4079071v1_genomic	NZ_CP161144.1	655531	656257	726	renamed_GCF_000008685.2	chromosome	658897	659623	726	99.1	3.767e-154
GCF_040790715.1_ASM4079071v1_genomic	NZ_CP161144.1	658149	656277	1872	renamed_GCF_000008685.2	chromosome	661515	659643	1872	99.0	0.0
GCF_040790715.1_ASM4079071v1_genomic	NZ_CP161144.1	658239	659163	924	renamed_GCF_000008685.2	chromosome	661605	662529	924	99.6	1.144e-200
GCF_040790715.1_ASM4079071v1_genomic	NZ_CP161144.1	659551	659236	315	renamed_GCF_000008685.2	chromosome	662917	662602	315	99.0	2.806e-64
GCF_040790715.1_ASM4079071v1_genomic	NZ_CP161144.1	661645	659812	1833	renamed_GCF_000008685.2	chromosome	665011	663178	1833	99.6	0.0
GCF_040790715.1_ASM4079071v1_genomic	NZ_CP161144.1	689258	690158	900	renamed_GCF_000008685.2	chromosome	692628	693528	900	99.3	9.829e-190
GCF_040790715.1_ASM4079071v1_genomic	NZ_CP161144.1	690183	691326	1143	renamed_GCF_000008685.2	chromosome	693553	694696	1143	100.0	3.979e-258
GCF_040790715.1_ASM4079071v1_genomic	NZ_CP161144.1	692153	691322	831	renamed_GCF_000008685.2	chromosome	695523	694692	831	99.2	6.41e-183
GCF_040790715.1_ASM4079071v1_genomic	NZ_CP161144.1	724352	725291	939	renamed_GCF_000008685.2	chromosome	727736	728675	939	100.0	1.678e-207
GCF_040790715.1_ASM4079071v1_genomic	NZ_CP161144.1	725281	726235	954	renamed_GCF_000008685.2	chromosome	728665	729619	954	98.7	7.929e-210
GCF_040790715.1_ASM4079071v1_genomic	NZ_CP161144.1	726228	727122	894	renamed_GCF_000008685.2	chromosome	729612	730506	894	98.9	3.048e-193
GCF_040790715.1_ASM4079071v1_genomic	NZ_CP161144.1	727715	727247	468	renamed_GCF_000008685.2	chromosome	731099	730631	468	98.0	1.073e-99
GCF_040790715.1_ASM4079071v1_genomic	NZ_CP161144.1	727799	728336	537	renamed_GCF_000008685.2	chromosome	731183	731720	537	100.0	1.936e-121
GCF_040790715.1_ASM4079071v1_genomic	NZ_CP161144.1	728409	730419	2010	renamed_GCF_000008685.2	chromosome	731793	733803	2010	99.4	0.0
GCF_040790715.1_ASM4079071v1_genomic	NZ_CP161144.1	730695	731904	1209	renamed_GCF_000008685.2	chromosome	734080	735289	1209	100.0	8.188e-270
GCF_040790715.1_ASM4079071v1_genomic	NZ_CP161144.1	749838	750684	846	renamed_GCF_000008685.2	chromosome	753291	754068	846	99.6	1.473e-167
GCF_040790715.1_ASM4079071v1_genomic	NZ_CP161144.1	750683	751166	483	renamed_GCF_000008685.2	chromosome	754067	754550	483	99.3	6.952e-107
GCF_040790715.1_ASM4079071v1_genomic	NZ_CP161144.1	751165	752965	1800	renamed_GCF_000008685.2	chromosome	754636	756349	1800	100.0	0.0
GCF_040790715.1_ASM4079071v1_genomic	NZ_CP161144.1	791469	790455	1014	renamed_GCF_000008685.2	chromosome	794855	793841	1014	98.8	1.021e-225
GCF_040790715.1_ASM4079071v1_genomic	NZ_CP161144.1	51094	50332	762	renamed_GCF_000008685.2	chromosome	51251	50489	762	98.8	6.336e-163
GCF_040790715.1_ASM4079071v1_genomic	NZ_CP161144.1	52277	51095	1182	renamed_GCF_000008685.2	chromosome	52434	51252	1182	99.4	1.623e-257
GCF_040790715.1_ASM4079071v1_genomic	NZ_CP161144.1	53304	52296	1008	renamed_GCF_000008685.2	chromosome	53461	52453	1008	99.7	1.478e-220
GCF_040790715.1_ASM4079071v1_genomic	NZ_CP161144.1	55347	53376	1971	renamed_GCF_000008685.2	chromosome	55504	53533	1971	99.6	0.0
GCF_040790715.1_ASM4079071v1_genomic	NZ_CP161144.1	56123	55343	780	renamed_GCF_000008685.2	chromosome	56280	55500	780	99.6	1.628e-172
GCF_040790715.1_ASM4079071v1_genomic	NZ_CP161144.1	57028	56674	354	renamed_GCF_000008685.2	chromosome	57185	56831	354	99.1	6.554e-78
GCF_040790715.1_ASM4079071v1_genomic	NZ_CP161144.1	112180	111730	450	renamed_GCF_000008685.2	chromosome	112338	111888	450	99.3	9.762e-98
GCF_040790715.1_ASM4079071v1_genomic	NZ_CP161144.1	114445	112750	1695	renamed_GCF_000008685.2	chromosome	114603	112908	1695	100.0	0.0
GCF_040790715.1_ASM4079071v1_genomic	NZ_CP161144.1	116648	115346	1302	renamed_GCF_000008685.2	chromosome	116806	115504	1302	98.3	1.154e-281
GCF_040790715.1_ASM4079071v1_genomic	NZ_CP161144.1	118212	117519	693	renamed_GCF_000008685.2	chromosome	118370	117677	693	98.2	1.337e-151
GCF_040790715.1_ASM4079071v1_genomic	NZ_CP161144.1	119645	118805	840	renamed_GCF_000008685.2	chromosome	119803	118963	840	97.1	3.15e-175
GCF_040790715.1_ASM4079071v1_genomic	NZ_CP161144.1	120923	120644	279	renamed_GCF_000008685.2	chromosome	121082	120803	279	96.7	3.477e-56
GCF_040790715.1_ASM4079071v1_genomic	NZ_CP161144.1	133815	135705	1890	renamed_GCF_000008685.2	chromosome	133974	135864	1890	99.2	0.0
GCF_040790715.1_ASM4079071v1_genomic	NZ_CP161144.1	138586	138274	312	renamed_GCF_000008685.2	chromosome	138745	138433	312	99.0	2.189e-66
GCF_040790715.1_ASM4079071v1_genomic	NZ_CP161144.1	144109	142786	1323	renamed_GCF_000008685.2	chromosome	144230	142943	1323	99.2	4.26e-279
GCF_040790715.1_ASM4079071v1_genomic	NZ_CP161144.1	146213	145313	900	renamed_GCF_000008685.2	chromosome	146370	145470	900	100.0	6.779e-194
GCF_040790715.1_ASM4079071v1_genomic	NZ_CP161144.1	182641	181246	1395	renamed_GCF_000008685.2	chromosome	182802	181407	1395	100.0	4.219e-300
GCF_040790715.1_ASM4079071v1_genomic	NZ_CP161144.1	186787	187033	246	renamed_GCF_000008685.2	chromosome	186948	187194	246	100.0	9.168e-49
GCF_040790715.1_ASM4079071v1_genomic	NZ_CP161144.1	188076	187662	414	renamed_GCF_000008685.2	chromosome	188237	187823	414	99.2	2.918e-88
GCF_040790715.1_ASM4079071v1_genomic	NZ_CP161144.1	189698	189137	561	renamed_GCF_000008685.2	chromosome	189859	189298	561	99.4	2.836e-121
GCF_040790715.1_ASM4079071v1_genomic	NZ_CP161144.1	190557	191298	741	renamed_GCF_000008685.2	chromosome	190718	191459	741	99.1	1.777e-156
GCF_040790715.1_ASM4079071v1_genomic	NZ_CP161144.1	193302	192162	1140	renamed_GCF_000008685.2	chromosome	193463	192323	1140	99.7	9.252e-257
GCF_040790715.1_ASM4079071v1_genomic	NZ_CP161144.1	194714	195575	861	renamed_GCF_000008685.2	chromosome	194875	195736	861	98.9	3.489e-186
GCF_040790715.1_ASM4079071v1_genomic	NZ_CP161144.1	232191	235107	2916	renamed_GCF_000008685.2	chromosome	232337	235253	2916	99.8	0.0
GCF_040790715.1_ASM4079071v1_genomic	NZ_CP161144.1	236996	235448	1548	renamed_GCF_000008685.2	chromosome	237142	235594	1548	99.8	0.0
GCF_040790715.1_ASM4079071v1_genomic	NZ_CP161144.1	237810	237483	327	renamed_GCF_000008685.2	chromosome	237956	237629	327	100.0	8.435e-71
GCF_040790715.1_ASM4079071v1_genomic	NZ_CP161144.1	238982	238154	828	renamed_GCF_000008685.2	chromosome	239128	238300	828	99.6	1.027e-185
GCF_040790715.1_ASM4079071v1_genomic	NZ_CP161144.1	242143	240136	2007	renamed_GCF_000008685.2	chromosome	242289	240282	2007	99.7	0.0
GCF_040790715.1_ASM4079071v1_genomic	NZ_CP161144.1	244567	243796	771	renamed_GCF_000008685.2	chromosome	244713	243942	771	100.0	4.161e-169
GCF_040790715.1_ASM4079071v1_genomic	NZ_CP161144.1	256315	258838	2523	renamed_GCF_000008685.2	chromosome	256462	258985	2523	98.3	0.0
GCF_040790715.1_ASM4079071v1_genomic	NZ_CP161144.1	263565	261144	2421	renamed_GCF_000008685.2	chromosome	263712	261291	2421	100.0	0.0
GCF_040790715.1_ASM4079071v1_genomic	NZ_CP161144.1	265959	266904	945	renamed_GCF_000008685.2	chromosome	266106	267051	945	100.0	6.277e-211
GCF_040790715.1_ASM4079071v1_genomic	NZ_CP161144.1	299567	298646	921	renamed_GCF_000008685.2	chromosome	299715	298794	921	99.6	2.293e-192
GCF_040790715.1_ASM4079071v1_genomic	NZ_CP161144.1	302341	300631	1710	renamed_GCF_000008685.2	chromosome	302489	300779	1710	100.0	0.0
GCF_040790715.1_ASM4079071v1_genomic	NZ_CP161144.1	303161	302702	459	renamed_GCF_000008685.2	chromosome	303309	302850	459	100.0	4.601e-99
GCF_040790715.1_ASM4079071v1_genomic	NZ_CP161144.1	304972	303625	1347	renamed_GCF_000008685.2	chromosome	305120	303773	1347	100.0	1.016e-290
GCF_040790715.1_ASM4079071v1_genomic	NZ_CP161144.1	305513	304964	549	renamed_GCF_000008685.2	chromosome	305661	305112	549	100.0	9.24e-115
GCF_040790715.1_ASM4079071v1_genomic	NZ_CP161144.1	306470	305522	948	renamed_GCF_000008685.2	chromosome	306615	305670	948	99.6	1.604e-209
GCF_040790715.1_ASM4079071v1_genomic	NZ_CP161144.1	307169	306476	693	renamed_GCF_000008685.2	chromosome	307317	306624	693	100.0	2.971e-151
GCF_040790715.1_ASM4079071v1_genomic	NZ_CP161144.1	308369	307169	1200	renamed_GCF_000008685.2	chromosome	308517	307317	1200	99.7	1.629e-260
GCF_040790715.1_ASM4079071v1_genomic	NZ_CP161144.1	318969	318129	840	renamed_GCF_000008685.2	chromosome	319116	318276	840	99.6	1.977e-180
GCF_040790715.1_ASM4079071v1_genomic	NZ_CP161144.1	319489	318958	531	renamed_GCF_000008685.2	chromosome	319636	319105	531	100.0	1.699e-113
GCF_040790715.1_ASM4079071v1_genomic	NZ_CP161144.1	330607	329497	1110	renamed_GCF_000008685.2	chromosome	330752	329642	1110	100.0	1.105e-249
GCF_040790715.1_ASM4079071v1_genomic	NZ_CP161144.1	333462	330657	2805	renamed_GCF_000008685.2	chromosome	333598	330802	2805	99.6	0.0
GCF_040790715.1_ASM4079071v1_genomic	NZ_CP161144.1	334379	333482	897	renamed_GCF_000008685.2	chromosome	334515	333618	897	100.0	1.666e-200
GCF_040790715.1_ASM4079071v1_genomic	NZ_CP161144.1	334800	336372	1572	renamed_GCF_000008685.2	chromosome	334936	336508	1572	99.8	0.0
GCF_040790715.1_ASM4079071v1_genomic	NZ_CP161144.1	338220	339846	1626	renamed_GCF_000008685.2	chromosome	338357	339983	1626	99.8	0.0
GCF_040790715.1_ASM4079071v1_genomic	NZ_CP161144.1	340203	341124	921	renamed_GCF_000008685.2	chromosome	340340	341261	921	98.6	3.516e-196
GCF_040790715.1_ASM4079071v1_genomic	NZ_CP161144.1	351193	350917	276	renamed_GCF_000008685.2	chromosome	351331	351055	276	98.9	1.819e-54
GCF_040790715.1_ASM4079071v1_genomic	NZ_CP161144.1	353302	351202	2100	renamed_GCF_000008685.2	chromosome	353437	351340	2100	98.1	0.0
GCF_040790715.1_ASM4079071v1_genomic	NZ_CP161144.1	354498	353301	1197	renamed_GCF_000008685.2	chromosome	354636	353439	1197	100.0	5.312e-264
GCF_040790715.1_ASM4079071v1_genomic	NZ_CP161144.1	355160	354509	651	renamed_GCF_000008685.2	chromosome	355298	354647	651	100.0	1.769e-141
GCF_040790715.1_ASM4079071v1_genomic	NZ_CP161144.1	355352	356771	1419	renamed_GCF_000008685.2	chromosome	355490	356909	1419	99.7	6.982e-316
GCF_040790715.1_ASM4079071v1_genomic	NZ_CP161144.1	356868	358302	1434	renamed_GCF_000008685.2	chromosome	357006	358440	1434	99.7	4.764e-314
GCF_040790715.1_ASM4079071v1_genomic	NZ_CP161144.1	358319	359060	741	renamed_GCF_000008685.2	chromosome	358457	359198	741	98.7	1.112e-161
GCF_040790715.1_ASM4079071v1_genomic	NZ_CP161144.1	359357	359078	279	renamed_GCF_000008685.2	chromosome	359495	359216	279	100.0	2.841e-58
GCF_040790715.1_ASM4079071v1_genomic	NZ_CP161144.1	360940	359374	1566	renamed_GCF_000008685.2	chromosome	361078	359512	1566	99.6	0.0
GCF_040790715.1_ASM4079071v1_genomic	NZ_CP161144.1	361061	362183	1122	renamed_GCF_000008685.2	chromosome	361187	362321	1122	99.4	1.215e-250
GCF_040790715.1_ASM4079071v1_genomic	NZ_CP161144.1	363979	362179	1800	renamed_GCF_000008685.2	chromosome	364117	362317	1800	99.8	0.0
GCF_040790715.1_ASM4079071v1_genomic	NZ_CP161144.1	364942	363991	951	renamed_GCF_000008685.2	chromosome	364972	364129	951	99.2	5.797e-187
GCF_040790715.1_ASM4079071v1_genomic	NZ_CP161144.1	396942	396468	474	renamed_GCF_000008685.2	chromosome	397077	396603	474	100.0	4.822e-101
GCF_040790715.1_ASM4079071v1_genomic	NZ_CP161144.1	397341	396966	375	renamed_GCF_000008685.2	chromosome	397476	397101	375	100.0	1.385e-81
GCF_040790715.1_ASM4079071v1_genomic	NZ_CP161144.1	401542	397408	4134	renamed_GCF_000008685.2	chromosome	401677	397543	4134	99.8	0.0
GCF_040790715.1_ASM4079071v1_genomic	NZ_CP161144.1	405482	405107	375	renamed_GCF_000008685.2	chromosome	405617	405242	375	99.1	2.753e-74
GCF_040790715.1_ASM4079071v1_genomic	NZ_CP161144.1	406041	405552	489	renamed_GCF_000008685.2	chromosome	406176	405687	489	99.3	6.125e-101
GCF_040790715.1_ASM4079071v1_genomic	NZ_CP161144.1	406726	406045	681	renamed_GCF_000008685.2	chromosome	406861	406180	681	100.0	2.702e-150
GCF_040790715.1_ASM4079071v1_genomic	NZ_CP161144.1	407157	406725	432	renamed_GCF_000008685.2	chromosome	407292	406860	432	99.3	1.75e-88
GCF_040790715.1_ASM4079071v1_genomic	NZ_CP161144.1	407763	407208	555	renamed_GCF_000008685.2	chromosome	407898	407343	555	99.4	1.275e-120
GCF_040790715.1_ASM4079071v1_genomic	NZ_CP161144.1	407957	407786	171	renamed_GCF_000008685.2	chromosome	408092	407921	171	98.2	2.497e-34
GCF_040790715.1_ASM4079071v1_genomic	NZ_CP161144.1	408255	408075	180	renamed_GCF_000008685.2	chromosome	408380	408200	180	100.0	2.118e-37
GCF_040790715.1_ASM4079071v1_genomic	NZ_CP161144.1	409277	408428	849	renamed_GCF_000008685.2	chromosome	409402	408553	849	99.6	2.186e-189
GCF_040790715.1_ASM4079071v1_genomic	NZ_CP161144.1	410322	409290	1032	renamed_GCF_000008685.2	chromosome	410447	409415	1032	97.3	8.518e-231
GCF_040790715.1_ASM4079071v1_genomic	NZ_CP161144.1	410661	411321	660	renamed_GCF_000008685.2	chromosome	410786	411446	660	98.6	2.462e-139
GCF_040790715.1_ASM4079071v1_genomic	NZ_CP161144.1	480952	481252	300	renamed_GCF_000008685.2	chromosome	484286	484586	300	98.9	5.976e-62
GCF_040790715.1_ASM4079071v1_genomic	NZ_CP161144.1	482215	482743	528	renamed_GCF_000008685.2	chromosome	485549	486077	528	100.0	1.004e-118
GCF_040790715.1_ASM4079071v1_genomic	NZ_CP161144.1	483382	484204	822	renamed_GCF_000008685.2	chromosome	486746	487538	822	99.6	9.243e-169
GCF_040790715.1_ASM4079071v1_genomic	NZ_CP161144.1	493911	494541	630	renamed_GCF_000008685.2	chromosome	497244	497874	630	100.0	4.528e-136
GCF_040790715.1_ASM4079071v1_genomic	NZ_CP161144.1	494879	495713	834	renamed_GCF_000008685.2	chromosome	498212	499046	834	100.0	1.895e-188
GCF_040790715.1_ASM4079071v1_genomic	NZ_CP161144.1	496373	497255	882	renamed_GCF_000008685.2	chromosome	499706	500588	882	100.0	1.248e-192
GCF_040790715.1_ASM4079071v1_genomic	NZ_CP161144.1	548383	546301	2082	renamed_GCF_000008685.2	chromosome	551723	549641	2082	99.8	0.0
GCF_040790715.1_ASM4079071v1_genomic	NZ_CP161144.1	562618	564472	1854	renamed_GCF_000008685.2	chromosome	565954	567823	1854	99.6	0.0
GCF_040790715.1_ASM4079071v1_genomic	NZ_CP161144.1	564918	565788	870	renamed_GCF_000008685.2	chromosome	568269	569139	870	99.6	3.86e-195
GCF_040790715.1_ASM4079071v1_genomic	NZ_CP161144.1	566206	567928	1722	renamed_GCF_000008685.2	chromosome	569558	571280	1722	99.8	0.0
GCF_040790715.1_ASM4079071v1_genomic	NZ_CP161144.1	570388	568537	1851	renamed_GCF_000008685.2	chromosome	573740	571889	1851	100.0	0.0
GCF_040790715.1_ASM4079071v1_genomic	NZ_CP161144.1	572464	571921	543	renamed_GCF_000008685.2	chromosome	575816	575273	543	100.0	3.121e-117
GCF_040790715.1_ASM4079071v1_genomic	NZ_CP161144.1	627333	625830	1503	renamed_GCF_000008685.2	chromosome	630698	629195	1503	100.0	0.0
GCF_040790715.1_ASM4079071v1_genomic	NZ_CP161144.1	628625	629117	492	renamed_GCF_000008685.2	chromosome	631990	632482	492	100.0	1.786e-106
GCF_040790715.1_ASM4079071v1_genomic	NZ_CP161144.1	631215	632646	1431	renamed_GCF_000008685.2	chromosome	634580	636011	1431	95.5	1.916e-306
GCF_040790715.1_ASM4079071v1_genomic	NZ_CP161144.1	678235	677191	1044	renamed_GCF_000008685.2	chromosome	681606	680562	1044	100.0	8.539e-233
GCF_040790715.1_ASM4079071v1_genomic	NZ_CP161144.1	679307	680006	699	renamed_GCF_000008685.2	chromosome	682678	683377	699	100.0	1.337e-152
GCF_040790715.1_ASM4079071v1_genomic	NZ_CP161144.1	692251	693385	1134	renamed_GCF_000008685.2	chromosome	695630	696764	1134	98.9	3.791e-257
GCF_040790715.1_ASM4079071v1_genomic	NZ_CP161144.1	694206	694953	747	renamed_GCF_000008685.2	chromosome	697585	698332	747	99.5	7.646e-167
GCF_040790715.1_ASM4079071v1_genomic	NZ_CP161144.1	697545	696672	873	renamed_GCF_000008685.2	chromosome	700924	700051	873	99.3	1.433e-189
GCF_040790715.1_ASM4079071v1_genomic	NZ_CP161144.1	698015	698426	411	renamed_GCF_000008685.2	chromosome	701394	701805	411	98.5	1.377e-87
GCF_040790715.1_ASM4079071v1_genomic	NZ_CP161144.1	699587	698903	684	renamed_GCF_000008685.2	chromosome	702951	702282	684	99.5	1.009e-144
GCF_040790715.1_ASM4079071v1_genomic	NZ_CP161144.1	700551	701580	1029	renamed_GCF_000008685.2	chromosome	703960	704959	1029	98.7	4.152e-221
GCF_040790715.1_ASM4079071v1_genomic	NZ_CP161144.1	702198	703224	1026	renamed_GCF_000008685.2	chromosome	705579	706605	1026	100.0	2.737e-225
GCF_040790715.1_ASM4079071v1_genomic	NZ_CP161144.1	705892	707293	1401	renamed_GCF_000008685.2	chromosome	709273	710674	1401	98.4	5.94e-306
GCF_040790715.1_ASM4079071v1_genomic	NZ_CP161144.1	737060	737303	243	renamed_GCF_000008685.2	chromosome	740445	740688	243	100.0	1.755e-49
GCF_040790715.1_ASM4079071v1_genomic	NZ_CP161144.1	739243	738010	1233	renamed_GCF_000008685.2	chromosome	742628	741395	1233	99.5	1.829e-273
GCF_040790715.1_ASM4079071v1_genomic	NZ_CP161144.1	752969	754286	1317	renamed_GCF_000008685.2	chromosome	756353	757670	1317	99.7	1.293e-291
GCF_040790715.1_ASM4079071v1_genomic	NZ_CP161144.1	756201	756831	630	renamed_GCF_000008685.2	chromosome	759585	760215	630	98.0	4.528e-136
GCF_040790715.1_ASM4079071v1_genomic	NZ_CP161144.1	760194	760977	783	renamed_GCF_000008685.2	chromosome	763578	764361	783	99.6	1.874e-171
GCF_040790715.1_ASM4079071v1_genomic	NZ_CP161144.1	761988	763332	1344	renamed_GCF_000008685.2	chromosome	765372	766716	1344	100.0	2.685e-305
GCF_040790715.1_ASM4079071v1_genomic	NZ_CP161144.1	766086	764694	1392	renamed_GCF_000008685.2	chromosome	769470	768078	1392	100.0	1.696e-292
GCF_040790715.1_ASM4079071v1_genomic	NZ_CP161144.1	768179	767777	402	renamed_GCF_000008685.2	chromosome	771563	771161	402	100.0	3.917e-83
GCF_040790715.1_ASM4079071v1_genomic	NZ_CP161144.1	771292	772078	786	renamed_GCF_000008685.2	chromosome	774676	775462	786	100.0	1.17e-168
GCF_040790715.1_ASM4079071v1_genomic	NZ_CP161144.1	808125	807084	1041	renamed_GCF_000008685.2	chromosome	811510	810469	1041	99.7	3.047e-235
GCF_040790715.1_ASM4079071v1_genomic	NZ_CP161144.1	809854	809053	801	renamed_GCF_000008685.2	chromosome	813239	812438	801	100.0	9.279e-174
GCF_040790715.1_ASM4079071v1_genomic	NZ_CP161144.1	817257	817839	582	renamed_GCF_000008685.2	chromosome	820606	821188	582	100.0	9.143e-129
GCF_040790715.1_ASM4079071v1_genomic	NZ_CP161144.1	818994	819345	351	renamed_GCF_000008685.2	chromosome	822343	822694	351	99.1	1.534e-76
GCF_040790715.1_ASM4079071v1_genomic	NZ_CP161144.1	819913	820462	549	renamed_GCF_000008685.2	chromosome	823262	823811	549	97.2	4.57e-114
GCF_040790715.1_ASM4079071v1_genomic	NZ_CP161144.1	821032	822355	1323	renamed_GCF_000008685.2	chromosome	824381	825704	1323	100.0	8.966e-297
GCF_040790715.1_ASM4079071v1_genomic	NZ_CP161144.1	824281	825763	1482	renamed_GCF_000008685.2	chromosome	827630	829112	1482	98.9	0.0
GCF_040790715.1_ASM4079071v1_genomic	NZ_CP161144.1	827592	826968	624	renamed_GCF_000008685.2	chromosome	830941	830317	624	98.5	1.394e-139
GCF_040790715.1_ASM4079071v1_genomic	NZ_CP161144.1	835197	835731	534	renamed_GCF_000008685.2	chromosome	838546	839080	534	100.0	7.282e-115
GCF_040790715.1_ASM4079071v1_genomic	NZ_CP161144.1	894314	893714	600	renamed_GCF_000008685.2	chromosome	897695	897095	600	99.4	6.881e-135
GCF_040790715.1_ASM4079071v1_genomic	NZ_CP161144.1	896117	897350	1233	renamed_GCF_000008685.2	chromosome	899498	900731	1233	100.0	1.522e-275
GCF_040790715.1_ASM4079071v1_genomic	NZ_CP161144.1	898452	899877	1425	renamed_GCF_000008685.2	chromosome	901833	903258	1425	99.7	2.69e-310
GCF_040790715.1_ASM4079071v1_genomic	NZ_CP161144.1	901519	900547	972	renamed_GCF_000008685.2	chromosome	904900	903928	972	99.6	1.152e-208
GCF_040790715.1_ASM4079071v1_genomic	NZ_CP161144.1	907496	908549	1053	renamed_GCF_000008685.2	lp28-1	26996	28073	1053	30.6	1.943e-30
GCF_040790715.1_ASM4079071v1_genomic	NZ_CP161154.1	754	307	447	renamed_GCF_000008685.2	cp26	751	307	447	97.2	1.025e-96
GCF_040790715.1_ASM4079071v1_genomic	NZ_CP161154.1	3799	2476	1323	renamed_GCF_000008685.2	cp26	3798	2475	1323	99.5	7.001e-291
GCF_040790715.1_ASM4079071v1_genomic	NZ_CP161154.1	4440	4758	318	renamed_GCF_000008685.2	cp26	4481	4757	318	97.8	1.616e-54
GCF_040790715.1_ASM4079071v1_genomic	NZ_CP161146.1	7837	8266	429	renamed_GCF_000008685.2	cp32-6	7837	8266	429	100.0	5.601e-92
GCF_040790715.1_ASM4079071v1_genomic	NZ_CP161146.1	10326	10968	642	renamed_GCF_000008685.2	cp32-7	10316	10958	642	95.7	1.337e-134
GCF_040790715.1_ASM4079071v1_genomic	NZ_CP161146.1	11937	12483	546	renamed_GCF_000008685.2	cp32-8	11919	12465	546	95.5	5.802e-111
GCF_040790715.1_ASM4079071v1_genomic	NZ_CP161146.1	12841	13720	879	renamed_GCF_000008685.2	cp32-7	12831	13710	879	96.9	9.361e-187
GCF_040790715.1_ASM4079071v1_genomic	NZ_CP161146.1	15436	15784	348	renamed_GCF_000008685.2	lp56	18919	19267	348	99.1	4.373e-73
GCF_040790715.1_ASM4079071v1_genomic	NZ_CP161146.1	16101	16455	354	renamed_GCF_000008685.2	cp32-7	16093	16447	354	99.1	3.249e-77
GCF_040790715.1_ASM4079071v1_genomic	NZ_CP161146.1	17219	17834	615	renamed_GCF_000008685.2	lp56	20843	21455	615	89.2	1.012e-124
GCF_040790715.1_ASM4079071v1_genomic	NZ_CP161147.1	5779	6169	390	renamed_GCF_000008685.2	cp32-4	5777	6167	390	100.0	3.229e-83
GCF_040790715.1_ASM4079071v1_genomic	NZ_CP161147.1	8736	8973	237	renamed_GCF_000008685.2	cp32-6	8733	8970	237	97.4	8.748e-48
GCF_040790715.1_ASM4079071v1_genomic	NZ_CP161147.1	12248	12581	333	renamed_GCF_000008685.2	cp32-9	12592	12925	333	100.0	1.876e-71
GCF_040790715.1_ASM4079071v1_genomic	NZ_CP161147.1	14968	15172	204	renamed_GCF_000008685.2	lp56	18712	18916	204	100.0	2.578e-39
GCF_040790715.1_ASM4079071v1_genomic	NZ_CP161157.1	6227	6911	684	renamed_GCF_000008685.2	lp17	5055	5739	684	99.5	1.274e-150
GCF_040790715.1_ASM4079071v1_genomic	NZ_CP161152.1	12574	12859	285	renamed_GCF_000008685.2	cp9	4788	4503	285	96.8	3.136e-58
GCF_040790715.1_ASM4079071v1_genomic	NZ_CP161152.1	14565	13653	912	renamed_GCF_000008685.2	cp9	2803	3712	912	99.3	1.323e-205
GCF_040790715.1_ASM4079071v1_genomic	NZ_CP161152.1	16669	17230	561	renamed_GCF_000008685.2	cp9	1891	2452	561	96.2	1.697e-118
GCF_040790715.1_ASM4079071v1_genomic	NZ_CP161149.1	14531	15284	753	renamed_GCF_000008685.2	lp28-4	12453	13206	753	100.0	4.561e-165
GCF_040790715.1_ASM4079071v1_genomic	NZ_CP161149.1	17432	18611	1179	renamed_GCF_000008685.2	lp28-4	15351	16530	1179	99.2	5.451e-252
GCF_040790715.1_ASM4079071v1_genomic	NZ_CP161149.1	23637	22884	753	renamed_GCF_000008685.2	lp28-4	21562	20770	753	98.3	1.223e-162
GCF_040790715.1_ASM4079071v1_genomic	NZ_CP161149.1	26100	25233	867	renamed_GCF_000008685.2	lp28-4	25089	24222	867	96.1	1.236e-181
GCF_040790715.1_ASM4079071v1_genomic	NZ_CP161150.1	16859	15833	1026	renamed_GCF_000008685.2	lp28-2	16482	15456	1026	99.4	8.508e-230
GCF_040790715.1_ASM4079071v1_genomic	NZ_CP161150.1	18396	18057	339	renamed_GCF_000008685.2	lp28-2	18019	17680	339	100.0	5.085e-70
GCF_040790715.1_ASM4079071v1_genomic	NZ_CP161150.1	19978	19195	783	renamed_GCF_000008685.2	lp28-2	19619	18836	783	89.6	1.346e-166
GCF_040790715.1_ASM4079071v1_genomic	NZ_CP161150.1	23058	22671	387	renamed_GCF_000008685.2	lp28-2	22659	22272	387	72.6	4.416e-63
GCF_040790715.1_ASM4079071v1_genomic	NZ_CP161150.1	24124	23431	693	renamed_GCF_000008685.2	lp28-2	23725	23032	693	83.4	3.937e-131
GCF_040790715.1_ASM4079071v1_genomic	NZ_CP161156.1	6826	7225	399	renamed_GCF_000008685.2	lp36	9372	9999	399	99.1	1.114e-79
GCF_040790715.1_ASM4079071v1_genomic	NZ_CP161156.1	10056	10692	636	renamed_GCF_000008685.2	lp36	12601	13237	636	100.0	3.41e-140
GCF_040790715.1_ASM4079071v1_genomic	NZ_CP161145.1	15427	15859	432	renamed_GCF_000008685.2	lp54	15369	15801	432	99.3	3.987e-96
GCF_040790715.1_ASM4079071v1_genomic	NZ_CP161145.1	17339	16775	564	renamed_GCF_000008685.2	lp54	17259	16695	564	99.4	5.267e-115
GCF_040790715.1_ASM4079071v1_genomic	NZ_CP161145.1	18804	20157	1353	renamed_GCF_000008685.2	lp54	18724	20077	1353	100.0	1.524e-304
GCF_040790715.1_ASM4079071v1_genomic	NZ_CP161145.1	21111	21651	540	renamed_GCF_000008685.2	lp54	21086	21626	540	98.8	4.36e-113
GCF_040790715.1_ASM4079071v1_genomic	NZ_CP161145.1	23801	24443	642	renamed_GCF_000008685.2	lp54	23776	24415	642	99.0	1.217e-135
GCF_040790715.1_ASM4079071v1_genomic	NZ_CP161145.1	25480	26722	1242	renamed_GCF_000008685.2	lp54	25467	26694	1242	100.0	1.5e-268
GCF_040790715.1_ASM4079071v1_genomic	NZ_CP161145.1	35005	35851	846	renamed_GCF_000008685.2	lp54	34987	35833	846	99.2	1.362e-185
GCF_040790715.1_ASM4079071v1_genomic	NZ_CP161145.1	35971	36247	276	renamed_GCF_000008685.2	lp54	35953	36229	276	100.0	3.31e-56
GCF_040790715.1_ASM4079071v1_genomic	NZ_CP161145.1	36285	36552	267	renamed_GCF_000008685.2	lp54	36255	36534	267	98.8	1.568e-54
GCF_040790715.1_ASM4079071v1_genomic	NZ_CP161145.1	48373	47617	756	renamed_GCF_000008685.2	lp54	47228	46472	756	98.4	1.282e-162
GCF_040790715.1_ASM4079071v1_genomic	NZ_CP161145.1	49412	48620	792	renamed_GCF_000008685.2	lp54	48267	47475	792	98.8	2.603e-169