QUERY_ID	QUERY_NAME	QUERY_START	QUERY_END	QUERY_LENGTH	REF_ID	REF_NAME	REF_START	REF_END	REF_LENGTH	IDENTITY	EVALUE
UNY1128P	contig_1	23528	23120	408	renamed_GCF_000008685.2	chromosome	237629	237221	408	100.0	2.649e-88
UNY1128P	contig_1	24125	23867	258	renamed_GCF_000008685.2	chromosome	238226	237968	258	100.0	9.113e-51
UNY1128P	contig_1	26149	25042	1107	renamed_GCF_000008685.2	chromosome	240250	239143	1107	99.7	3.718e-244
UNY1128P	contig_1	28336	29902	1566	renamed_GCF_000008685.2	chromosome	242437	244003	1566	99.4	0.0
UNY1128P	contig_1	31278	30675	603	renamed_GCF_000008685.2	chromosome	245382	244776	603	99.5	7.936e-134
UNY1128P	contig_1	31688	32453	765	renamed_GCF_000008685.2	chromosome	245789	246554	765	100.0	7.663e-170
UNY1128P	contig_1	34425	35988	1563	renamed_GCF_000008685.2	chromosome	248505	250089	1563	100.0	0.0
UNY1128P	contig_1	37110	36555	555	renamed_GCF_000008685.2	chromosome	251211	250656	555	100.0	3.12e-119
UNY1128P	contig_1	38332	38938	606	renamed_GCF_000008685.2	chromosome	252433	253039	606	99.0	4.975e-131
UNY1128P	contig_1	40843	41548	705	renamed_GCF_000008685.2	chromosome	254944	255649	705	100.0	7.263e-152
UNY1128P	contig_1	96420	95676	744	renamed_GCF_000008685.2	chromosome	310523	309779	744	100.0	5.245e-162
UNY1128P	contig_1	98612	97556	1056	renamed_GCF_000008685.2	chromosome	312715	311659	1056	100.0	1.239e-230
UNY1128P	contig_1	100326	100044	282	renamed_GCF_000008685.2	chromosome	314427	314145	282	100.0	2.699e-59
UNY1128P	contig_1	102042	101205	837	renamed_GCF_000008685.2	chromosome	316143	315306	837	98.9	3.479e-182
UNY1128P	contig_1	103904	103145	759	renamed_GCF_000008685.2	chromosome	318005	317246	759	99.2	6.638e-162
UNY1128P	contig_1	115160	115520	360	renamed_GCF_000008685.2	chromosome	329261	329621	360	100.0	1.609e-77
UNY1128P	contig_1	119506	116701	2805	renamed_GCF_000008685.2	chromosome	333598	330802	2805	99.6	0.0
UNY1128P	contig_1	120844	122416	1572	renamed_GCF_000008685.2	chromosome	334936	336508	1572	99.4	0.0
UNY1128P	contig_1	124265	125891	1626	renamed_GCF_000008685.2	chromosome	338357	339983	1626	99.6	0.0
UNY1128P	contig_1	127181	128231	1050	renamed_GCF_000008685.2	chromosome	341273	342323	1050	100.0	1.489e-227
UNY1128P	contig_1	182991	182517	474	renamed_GCF_000008685.2	chromosome	397077	396603	474	100.0	4.822e-101
UNY1128P	contig_1	187591	183457	4134	renamed_GCF_000008685.2	chromosome	401677	397543	4134	99.8	0.0
UNY1128P	contig_1	192090	191601	489	renamed_GCF_000008685.2	chromosome	406176	405687	489	99.3	2.753e-101
UNY1128P	contig_1	193206	192774	432	renamed_GCF_000008685.2	chromosome	407292	406860	432	99.3	1.75e-88
UNY1128P	contig_1	194294	194114	180	renamed_GCF_000008685.2	chromosome	408380	408200	180	100.0	2.118e-37
UNY1128P	contig_1	207294	205416	1878	renamed_GCF_000008685.2	chromosome	421380	419502	1878	99.2	0.0
UNY1128P	contig_1	208971	209751	780	renamed_GCF_000008685.2	chromosome	423054	423834	780	99.6	1.628e-172
UNY1128P	contig_1	210609	211467	858	renamed_GCF_000008685.2	chromosome	424693	425551	858	99.6	7.8e-194
UNY1128P	contig_1	212651	213866	1215	renamed_GCF_000008685.2	chromosome	426735	427950	1215	99.5	3.802e-262
UNY1128P	contig_1	235335	236088	753	renamed_GCF_000008685.2	chromosome	449418	450171	753	99.2	8.002e-159
UNY1128P	contig_1	240389	237956	2433	renamed_GCF_000008685.2	chromosome	454472	452039	2433	100.0	0.0
UNY1128P	contig_1	242492	243953	1461	renamed_GCF_000008685.2	chromosome	456575	458036	1461	99.7	0.0
UNY1128P	contig_1	245441	245741	300	renamed_GCF_000008685.2	chromosome	459524	459824	300	95.9	4.432e-57
UNY1128P	contig_1	245968	246328	360	renamed_GCF_000008685.2	chromosome	460051	460411	360	99.1	5.311e-73
UNY1128P	contig_1	258470	259313	843	renamed_GCF_000008685.2	chromosome	472565	473408	843	100.0	5.328e-187
UNY1128P	contig_1	260517	261507	990	renamed_GCF_000008685.2	chromosome	474612	475602	990	98.4	1.155e-211
UNY1128P	contig_1	263979	262167	1812	renamed_GCF_000008685.2	chromosome	478005	476262	1812	99.8	0.0
UNY1128P	contig_1	265610	266921	1311	renamed_GCF_000008685.2	chromosome	479708	481019	1311	100.0	7.438e-297
UNY1128P	contig_1	268501	270184	1683	renamed_GCF_000008685.2	chromosome	482599	484282	1683	99.1	0.0
UNY1128P	contig_1	278489	279854	1365	renamed_GCF_000008685.2	chromosome	492587	493952	1365	100.0	1.721e-296
UNY1128P	contig_1	280935	282120	1185	renamed_GCF_000008685.2	chromosome	495032	496217	1185	100.0	4.832e-263
UNY1128P	contig_1	282517	283138	621	renamed_GCF_000008685.2	chromosome	496614	497235	621	100.0	8.732e-136
UNY1128P	contig_1	283797	284094	297	renamed_GCF_000008685.2	chromosome	497894	498191	297	100.0	5.69e-62
UNY1128P	contig_1	284958	285237	279	renamed_GCF_000008685.2	chromosome	499055	499334	279	100.0	1.411e-57
UNY1128P	contig_1	289828	290188	360	renamed_GCF_000008685.2	chromosome	503925	504285	360	98.3	4.812e-74
UNY1128P	contig_1	290701	291007	306	renamed_GCF_000008685.2	chromosome	504798	505104	306	98.0	7.287e-61
UNY1128P	contig_1	291456	292761	1305	renamed_GCF_000008685.2	chromosome	505553	506858	1305	99.3	2.235e-283
UNY1128P	contig_1	292904	293282	378	renamed_GCF_000008685.2	chromosome	507001	507379	378	99.2	1.951e-78
UNY1128P	contig_1	293716	294751	1035	renamed_GCF_000008685.2	chromosome	507813	508848	1035	98.5	5.483e-219
UNY1128P	contig_1	317000	315092	1908	renamed_GCF_000008685.2	chromosome	531105	529197	1908	100.0	0.0
UNY1128P	contig_1	321495	321072	423	renamed_GCF_000008685.2	chromosome	535600	535177	423	100.0	5.606e-91
UNY1128P	contig_1	323414	324203	789	renamed_GCF_000008685.2	chromosome	537543	538308	789	99.2	1.479e-166
UNY1128P	contig_1	337618	335536	2082	renamed_GCF_000008685.2	chromosome	551723	549641	2082	99.8	0.0
UNY1128P	contig_1	339039	339690	651	renamed_GCF_000008685.2	chromosome	553138	553789	651	100.0	1.464e-143
UNY1128P	contig_1	341115	342480	1365	renamed_GCF_000008685.2	chromosome	555215	556580	1365	99.1	1.676e-305
UNY1128P	contig_1	343924	343306	618	renamed_GCF_000008685.2	chromosome	558024	557406	618	100.0	1.216e-131
UNY1128P	contig_1	357182	357752	570	renamed_GCF_000008685.2	chromosome	571282	571852	570	100.0	1.471e-121
UNY1128P	contig_1	359750	361145	1395	renamed_GCF_000008685.2	chromosome	573852	575247	1395	98.9	1.541e-311
UNY1128P	contig_1	362424	361878	546	renamed_GCF_000008685.2	chromosome	576499	575980	546	100.0	1.781e-115
UNY1128P	contig_1	363292	363835	543	renamed_GCF_000008685.2	chromosome	577394	577937	543	100.0	3.121e-117
UNY1128P	contig_1	364174	366319	2145	renamed_GCF_000008685.2	chromosome	578276	580421	2145	99.5	0.0
UNY1128P	contig_1	378395	381839	3444	renamed_GCF_000008685.2	chromosome	592445	595931	3444	99.6	0.0
UNY1128P	contig_1	385284	384495	789	renamed_GCF_000008685.2	chromosome	599376	598587	789	99.2	2.611e-177
UNY1128P	contig_1	385402	386752	1350	renamed_GCF_000008685.2	chromosome	599494	600844	1350	100.0	3.989e-293
UNY1128P	contig_1	386917	388252	1335	renamed_GCF_000008685.2	chromosome	601009	602344	1335	100.0	3.161e-293
UNY1128P	contig_1	388281	389637	1356	renamed_GCF_000008685.2	chromosome	602373	603729	1356	99.3	1.247e-298
UNY1128P	contig_1	390677	389633	1044	renamed_GCF_000008685.2	chromosome	604769	603725	1044	99.1	7.784e-234
UNY1128P	contig_1	392891	390686	2205	renamed_GCF_000008685.2	chromosome	606983	604778	2205	99.5	0.0
UNY1128P	contig_1	393045	393843	798	renamed_GCF_000008685.2	chromosome	607137	607935	798	99.6	4.801e-172
UNY1128P	contig_1	407912	409355	1443	renamed_GCF_000008685.2	chromosome	622004	623447	1443	98.7	0.0
UNY1128P	contig_1	409358	410915	1557	renamed_GCF_000008685.2	chromosome	623450	625007	1557	99.6	0.0
UNY1128P	contig_1	410914	412168	1254	renamed_GCF_000008685.2	chromosome	625006	626260	1254	99.7	1.925e-276
UNY1128P	contig_1	412193	412946	753	renamed_GCF_000008685.2	chromosome	626285	627038	753	100.0	9.23e-166
UNY1128P	contig_1	414856	412999	1857	renamed_GCF_000008685.2	chromosome	628948	627091	1857	99.8	0.0
UNY1128P	contig_1	416606	415103	1503	renamed_GCF_000008685.2	chromosome	630698	629195	1503	100.0	0.0
UNY1128P	contig_1	416676	417894	1218	renamed_GCF_000008685.2	chromosome	630795	631986	1218	99.4	4.366e-261
UNY1128P	contig_1	417898	418390	492	renamed_GCF_000008685.2	chromosome	631990	632482	492	100.0	1.786e-106
UNY1128P	contig_1	418392	420372	1980	renamed_GCF_000008685.2	chromosome	632484	634464	1980	98.9	0.0
UNY1128P	contig_1	420488	421919	1431	renamed_GCF_000008685.2	chromosome	634580	636011	1431	99.7	2.877e-319
UNY1128P	contig_1	434239	432571	1668	renamed_GCF_000008685.2	chromosome	648254	646658	1668	99.6	0.0
UNY1128P	contig_1	434465	435020	555	renamed_GCF_000008685.2	chromosome	648552	649107	555	100.0	3.12e-119
UNY1128P	contig_1	436293	435075	1218	renamed_GCF_000008685.2	chromosome	650387	649169	1218	99.2	1.492e-264
UNY1128P	contig_1	439696	436318	3378	renamed_GCF_000008685.2	chromosome	653790	650412	3378	99.6	0.0
UNY1128P	contig_1	439792	440755	963	renamed_GCF_000008685.2	chromosome	653886	654849	963	100.0	5.23e-216
UNY1128P	contig_1	440714	442808	2094	renamed_GCF_000008685.2	chromosome	654862	656902	2094	98.9	0.0
UNY1128P	contig_1	444803	445529	726	renamed_GCF_000008685.2	chromosome	658897	659623	726	99.5	1.694e-154
UNY1128P	contig_1	474399	476037	1638	renamed_GCF_000008685.2	chromosome	688489	690127	1638	100.0	0.0
UNY1128P	contig_1	476102	476399	297	renamed_GCF_000008685.2	chromosome	690192	690489	297	100.0	1.037e-63
UNY1128P	contig_1	486929	487286	357	renamed_GCF_000008685.2	chromosome	701028	701385	357	99.1	2.301e-81
UNY1128P	contig_1	487295	487706	411	renamed_GCF_000008685.2	chromosome	701394	701805	411	98.5	3.065e-87
UNY1128P	contig_1	487725	488175	450	renamed_GCF_000008685.2	chromosome	701824	702274	450	99.3	2.172e-97
UNY1128P	contig_1	488867	488183	684	renamed_GCF_000008685.2	chromosome	702951	702282	684	100.0	4.537e-145
UNY1128P	contig_1	488909	489869	960	renamed_GCF_000008685.2	chromosome	703008	703968	960	99.0	1.607e-211
UNY1128P	contig_1	489831	490860	1029	renamed_GCF_000008685.2	chromosome	703960	704959	1029	98.7	4.152e-221
UNY1128P	contig_1	490849	491401	552	renamed_GCF_000008685.2	chromosome	704948	705500	552	95.0	1.781e-116
UNY1128P	contig_1	491478	492504	1026	renamed_GCF_000008685.2	chromosome	705579	706605	1026	100.0	2.737e-225
UNY1128P	contig_1	525040	525580	540	renamed_GCF_000008685.2	chromosome	739143	739683	540	100.0	2.458e-119
UNY1128P	contig_1	525581	526073	492	renamed_GCF_000008685.2	chromosome	739684	740176	492	99.3	9.73e-105
UNY1128P	contig_1	537088	538057	969	renamed_GCF_000008685.2	chromosome	751190	752159	969	100.0	4.772e-218
UNY1128P	contig_1	538067	539117	1050	renamed_GCF_000008685.2	chromosome	752169	753219	1050	100.0	6.109e-229
UNY1128P	contig_1	539120	539966	846	renamed_GCF_000008685.2	chromosome	753291	754068	846	99.2	1.473e-167
UNY1128P	contig_1	539965	540448	483	renamed_GCF_000008685.2	chromosome	754067	754550	483	98.7	1.547e-106
UNY1128P	contig_1	540447	542247	1800	renamed_GCF_000008685.2	chromosome	754636	756349	1800	99.8	0.0
UNY1128P	contig_1	542251	543568	1317	renamed_GCF_000008685.2	chromosome	756353	757670	1317	99.7	1.293e-291
UNY1128P	contig_1	545483	546113	630	renamed_GCF_000008685.2	chromosome	759585	760215	630	99.5	1.853e-137
UNY1128P	contig_1	570954	572652	1698	renamed_GCF_000008685.2	chromosome	785056	786754	1698	99.2	0.0
UNY1128P	contig_1	572757	574860	2103	renamed_GCF_000008685.2	chromosome	786859	788962	2103	99.5	0.0
UNY1128P	contig_1	586173	585105	1068	renamed_GCF_000008685.2	chromosome	800275	799207	1068	99.7	8.292e-246
UNY1128P	contig_1	586373	586970	597	renamed_GCF_000008685.2	chromosome	800475	801072	597	99.4	1.402e-126
UNY1128P	contig_1	586908	587676	768	renamed_GCF_000008685.2	chromosome	801118	801778	768	98.6	1.322e-138
UNY1128P	contig_1	588697	587839	858	renamed_GCF_000008685.2	chromosome	802798	801940	858	99.6	7.692e-177
UNY1128P	contig_1	589066	588736	330	renamed_GCF_000008685.2	chromosome	803167	802837	330	100.0	2.178e-69
UNY1128P	contig_1	592822	591673	1149	renamed_GCF_000008685.2	chromosome	806923	805774	1149	99.7	5.42e-247
UNY1128P	contig_1	634420	634687	267	renamed_GCF_000008685.2	chromosome	848537	848804	267	98.8	1.736e-53
UNY1128P	contig_1	634701	636870	2169	renamed_GCF_000008685.2	chromosome	848836	850987	2169	99.8	0.0
UNY1128P	contig_1	649522	650929	1407	renamed_GCF_000008685.2	chromosome	863635	865042	1407	99.3	6.96e-314
UNY1128P	contig_1	650948	651806	858	renamed_GCF_000008685.2	chromosome	865052	865919	858	99.6	3.329e-186
UNY1128P	contig_1	651802	652345	543	renamed_GCF_000008685.2	chromosome	865915	866458	543	98.8	6.309e-118
UNY1128P	contig_1	652380	652581	201	renamed_GCF_000008685.2	chromosome	866493	866694	201	100.0	2.206e-40
UNY1128P	contig_1	652567	653488	921	renamed_GCF_000008685.2	chromosome	866680	867601	921	99.3	3.387e-205
UNY1128P	contig_1	654002	653630	372	renamed_GCF_000008685.2	chromosome	868114	867742	372	99.1	1.771e-78
UNY1128P	contig_1	654082	654628	546	renamed_GCF_000008685.2	chromosome	868194	868740	546	99.4	2.031e-122
UNY1128P	contig_1	655403	654620	783	renamed_GCF_000008685.2	chromosome	869380	868732	783	99.5	1.931e-145
UNY1128P	contig_1	694296	695481	1185	renamed_GCF_000008685.2	chromosome	908406	909591	1185	100.0	8.142e-266
UNY1128P	contig_1	708526	709081	555	renamed_GCF_000008685.2	lp36	35867	36422	555	96.7	2.054e-115
UNY1128P	contig_2	2667	1899	768	renamed_GCF_000008685.2	chromosome	211300	212068	768	100.0	8.822e-169
UNY1128P	contig_2	5347	5884	537	renamed_GCF_000008685.2	chromosome	208581	208083	537	99.3	7.373e-107
UNY1128P	contig_2	7438	5887	1551	renamed_GCF_000008685.2	chromosome	206528	208106	1551	99.8	0.0
UNY1128P	contig_2	8895	7923	972	renamed_GCF_000008685.2	chromosome	205174	206044	972	99.6	3.289e-188
UNY1128P	contig_2	9831	8895	936	renamed_GCF_000008685.2	chromosome	204136	205072	936	100.0	4.7e-204
UNY1128P	contig_2	11118	9879	1239	renamed_GCF_000008685.2	chromosome	202849	204088	1239	99.7	1.225e-261
UNY1128P	contig_2	24126	24687	561	renamed_GCF_000008685.2	chromosome	189859	189298	561	100.0	1.275e-121
UNY1128P	contig_2	24709	24910	201	renamed_GCF_000008685.2	chromosome	189276	189075	201	100.0	9.889e-41
UNY1128P	contig_2	25491	25752	261	renamed_GCF_000008685.2	chromosome	188494	188233	261	100.0	7.054e-54
UNY1128P	contig_2	25748	26162	414	renamed_GCF_000008685.2	chromosome	188237	187823	414	100.0	2.918e-88
UNY1128P	contig_2	26154	26808	654	renamed_GCF_000008685.2	chromosome	187831	187177	654	99.5	3.106e-144
UNY1128P	contig_2	27037	26791	246	renamed_GCF_000008685.2	chromosome	186948	187194	246	100.0	9.168e-49
UNY1128P	contig_2	27432	27039	393	renamed_GCF_000008685.2	chromosome	186553	186946	393	100.0	5.626e-86
UNY1128P	contig_2	105819	107016	1197	renamed_GCF_000008685.2	chromosome	108170	106973	1197	99.7	1.869e-258
UNY1128P	contig_2	107095	108106	1011	renamed_GCF_000008685.2	chromosome	106894	105883	1011	100.0	4.14e-218
UNY1128P	contig_2	119383	119770	387	renamed_GCF_000008685.2	chromosome	94605	94218	387	100.0	1.031e-86
UNY1128P	contig_2	119956	120556	600	renamed_GCF_000008685.2	chromosome	94032	93432	600	100.0	1.47e-126
UNY1128P	contig_2	120565	121111	546	renamed_GCF_000008685.2	chromosome	93423	92877	546	98.8	6.015e-119
UNY1128P	contig_2	122873	124178	1305	renamed_GCF_000008685.2	chromosome	91115	89810	1305	100.0	2.863e-289
UNY1128P	contig_2	124180	124789	609	renamed_GCF_000008685.2	chromosome	89808	89199	609	100.0	1.275e-129
UNY1128P	contig_2	126628	127063	435	renamed_GCF_000008685.2	chromosome	87360	86925	435	100.0	2.772e-92
UNY1128P	contig_2	150839	149957	882	renamed_GCF_000008685.2	chromosome	63146	64028	882	99.6	6.762e-191
UNY1128P	contig_2	161555	162737	1182	renamed_GCF_000008685.2	chromosome	52434	51252	1182	99.4	1.623e-257
UNY1128P	contig_2	162738	163500	762	renamed_GCF_000008685.2	chromosome	51251	50489	762	100.0	1.168e-164
UNY1128P	contig_2	163515	163878	363	renamed_GCF_000008685.2	chromosome	50474	50111	363	100.0	4.578e-75
UNY1128P	contig_2	164649	163977	672	renamed_GCF_000008685.2	chromosome	49340	50012	672	100.0	9.591e-152
UNY1128P	contig_2	164730	165387	657	renamed_GCF_000008685.2	chromosome	49259	48602	657	99.5	1.056e-139
UNY1128P	contig_2	166085	165383	702	renamed_GCF_000008685.2	chromosome	47916	48606	702	100.0	4.54e-148
UNY1128P	contig_2	166823	166148	675	renamed_GCF_000008685.2	chromosome	47166	47841	675	99.5	1.946e-144
UNY1128P	contig_2	167610	167979	369	renamed_GCF_000008685.2	chromosome	46379	46010	369	100.0	3.085e-80
UNY1128P	contig_2	179949	181830	1881	renamed_GCF_000008685.2	chromosome	34037	32156	1881	99.6	0.0
UNY1128P	contig_2	181897	182437	540	renamed_GCF_000008685.2	chromosome	32089	31549	540	98.8	8.011e-115
UNY1128P	contig_2	191257	191851	594	renamed_GCF_000008685.2	chromosome	22739	22145	594	99.4	7.271e-125
UNY1128P	contig_2	191895	192939	1044	renamed_GCF_000008685.2	chromosome	22101	21057	1044	100.0	6.693e-227
UNY1128P	contig_2	195534	196047	513	renamed_GCF_000008685.2	chromosome	18304	17791	513	98.8	4.582e-108
UNY1128P	contig_2	197844	197034	810	renamed_GCF_000008685.2	chromosome	15994	16804	810	99.6	1.068e-173
UNY1128P	contig_2	198116	198494	378	renamed_GCF_000008685.2	chromosome	15716	15344	378	98.3	9.667e-78
UNY1128P	contig_3	3151	2803	348	renamed_GCF_000008685.2	cp32-1	15421	15769	348	99.1	4.373e-73
UNY1128P	contig_3	3358	3154	204	renamed_GCF_000008685.2	cp32-1	15214	15418	204	100.0	2.578e-39
UNY1128P	contig_3	9303	9066	237	renamed_GCF_000008685.2	cp32-6	8733	8970	237	97.4	8.748e-48
UNY1128P	contig_3	11326	10213	1113	renamed_GCF_000008685.2	cp32-4	6710	7823	1113	98.6	1.837e-244
UNY1128P	contig_3	11873	11306	567	renamed_GCF_000008685.2	cp32-3	6153	6720	567	99.4	2.344e-124
UNY1128P	contig_3	12259	11869	390	renamed_GCF_000008685.2	cp32-9	5783	6173	390	100.0	3.229e-83
UNY1128P	contig_3	12630	12246	384	renamed_GCF_000008685.2	cp32-9	5412	5796	384	100.0	2.931e-83
UNY1128P	contig_4	1231	2230	999	renamed_GCF_000008685.2	lp28-1	466	1465	999	99.3	3.766e-217
UNY1128P	contig_4	16002	16755	753	renamed_GCF_000008685.2	lp28-4	12453	13206	753	100.0	4.561e-165
UNY1128P	contig_4	16813	17386	573	renamed_GCF_000008685.2	lp28-4	13264	13837	573	98.9	3.119e-122
UNY1128P	contig_4	18900	19593	693	renamed_GCF_000008685.2	lp28-4	15351	16530	693	99.1	9.625e-147
UNY1128P	contig_4	22734	22068	666	renamed_GCF_000008685.2	lp28-4	19183	18517	666	100.0	3.109e-146
UNY1128P	contig_4	23660	23165	495	renamed_GCF_000008685.2	lp56	3622	4108	495	64.8	2.033e-55
UNY1128P	contig_4	46228	46849	621	renamed_GCF_000008685.2	lp25	10187	9566	621	97.0	1.766e-136
UNY1128P	contig_5	42662	41771	891	renamed_GCF_000008685.2	lp54	10287	11178	891	100.0	1.898e-189
UNY1128P	contig_5	43493	42671	822	renamed_GCF_000008685.2	lp54	9456	10278	822	98.9	1.553e-171
UNY1128P	contig_5	44508	44082	426	renamed_GCF_000008685.2	lp54	8441	8867	426	99.2	3.538e-88
UNY1128P	contig_5	44684	44504	180	renamed_GCF_000008685.2	lp54	8265	8445	180	98.3	3.242e-33
UNY1128P	contig_5	45741	44706	1035	renamed_GCF_000008685.2	lp54	7208	8243	1035	100.0	8.138e-232
UNY1128P	contig_5	46429	45802	627	renamed_GCF_000008685.2	lp54	6520	7147	627	99.0	1.16e-133
UNY1128P	contig_6	4012	4954	942	renamed_GCF_000008685.2	cp32-7	10961	11903	942	97.4	1.758e-207
UNY1128P	contig_6	8279	8483	204	renamed_GCF_000008685.2	cp32-7	15221	15425	204	100.0	2.578e-39
UNY1128P	contig_6	26292	26868	576	renamed_GCF_000008685.2	lp56	6835	7411	576	97.9	5.468e-125
UNY1128P	contig_6	26889	27849	960	renamed_GCF_000008685.2	cp32-6	3969	4929	960	100.0	6.008e-214
UNY1128P	contig_6	27868	28324	456	renamed_GCF_000008685.2	cp32-6	4948	5404	456	99.3	5.32e-97
UNY1128P	contig_6	29080	29647	567	renamed_GCF_000008685.2	cp32-9	6169	6736	567	98.4	2.579e-123
UNY1128P	contig_6	29627	30740	1113	renamed_GCF_000008685.2	cp32-1	6700	7813	1113	98.3	4.476e-243
UNY1128P	contig_6	30754	31183	429	renamed_GCF_000008685.2	lp56	11296	11725	429	99.2	2.774e-91
UNY1128P	contig_6	31198	31654	456	renamed_GCF_000008685.2	cp32-7	8273	8729	456	97.3	4.83e-98
UNY1128P	contig_7	6147	5925	222	renamed_GCF_000008685.2	lp36	21911	22133	222	100.0	1.866e-45
UNY1128P	contig_7	7437	6372	1065	renamed_GCF_000008685.2	lp36	20388	21453	1065	99.4	6.416e-231
UNY1128P	contig_7	9338	8726	612	renamed_GCF_000008685.2	lp36	16274	16886	612	100.0	9.153e-134
UNY1128P	contig_7	9851	10778	927	renamed_GCF_000008685.2	lp36	15760	14833	927	98.7	3.39e-206
UNY1128P	contig_7	10770	11310	540	renamed_GCF_000008685.2	lp36	14841	14301	540	100.0	2.234e-120
UNY1128P	contig_7	11285	12035	750	renamed_GCF_000008685.2	lp36	14326	13576	750	100.0	1.062e-163
UNY1128P	contig_7	13010	12374	636	renamed_GCF_000008685.2	lp36	12601	13237	636	100.0	3.41e-140
UNY1128P	contig_8	13811	14144	333	renamed_GCF_000008685.2	cp32-8	12494	12827	333	100.0	8.424e-72
UNY1128P	contig_8	21984	22725	741	renamed_GCF_000008685.2	cp32-8	20739	21480	741	100.0	2.251e-162
UNY1128P	contig_8	24604	25930	1326	renamed_GCF_000008685.2	cp32-8	23365	24691	1326	99.7	7.132e-300
UNY1128P	contig_8	27190	26413	777	renamed_GCF_000008685.2	cp32-1	25816	25039	777	100.0	2.863e-174
UNY1128P	contig_8	28166	29279	1113	renamed_GCF_000008685.2	cp32-1	26795	27932	1113	95.2	2.278e-233
UNY1128P	contig_9	16292	17189	897	renamed_GCF_000008685.2	lp28-3	16518	17415	897	100.0	1.518e-201
UNY1128P	contig_9	17720	18476	756	renamed_GCF_000008685.2	lp28-3	17946	18702	756	100.0	8.81e-167
UNY1128P	contig_9	21245	21995	750	renamed_GCF_000008685.2	lp28-3	21469	22219	750	99.5	6.33e-161
UNY1128P	contig_11	7064	6617	447	renamed_GCF_000008685.2	cp26	751	307	447	99.3	1.706e-99
UNY1128P	contig_11	17732	17234	498	renamed_GCF_000008685.2	cp26	11417	10919	498	98.1	4.372e-106
UNY1128P	contig_11	21422	20207	1215	renamed_GCF_000008685.2	cp26	15107	13892	1215	99.0	6.41e-265
UNY1128P	contig_11	23217	23850	633	renamed_GCF_000008685.2	cp26	16902	17535	633	81.0	4.784e-102
UNY1128P	contig_12	1906	1378	528	renamed_GCF_000008685.2	cp32-4	27675	28203	528	90.8	6.396e-107
UNY1128P	contig_12	13424	12956	468	renamed_GCF_000008685.2	cp32-4	16496	16997	468	89.7	1.044e-91
UNY1128P	contig_12	14210	13874	336	renamed_GCF_000008685.2	lp56	19256	19592	336	100.0	5.348e-69
UNY1128P	contig_16	9262	8485	777	renamed_GCF_000008685.2	cp32-3	26276	25499	777	100.0	3.144e-173
UNY1128P	contig_16	11223	11790	567	renamed_GCF_000008685.2	cp32-7	28884	29451	567	100.0	5.734e-123
UNY1128P	contig_18	9078	7977	1101	renamed_GCF_000008685.2	cp32-6	19068	20169	1101	94.2	7.765e-235
UNY1128P	contig_20	802	1390	588	renamed_GCF_000008685.2	lp21	14647	15235	588	100.0	4.973e-128
UNY1128P	contig_20	4118	5111	993	renamed_GCF_000008685.2	lp5	3339	4332	993	99.6	4.128e-215
UNY1128P	contig_1	74072	73808	264	renamed_GCF_000008685.2	chromosome	288173	287909	264	98.8	1.006e-50
UNY1128P	contig_1	89207	88748	459	renamed_GCF_000008685.2	chromosome	303309	302850	459	100.0	4.601e-99
UNY1128P	contig_1	91018	89671	1347	renamed_GCF_000008685.2	chromosome	305120	303773	1347	99.7	5.012e-290
UNY1128P	contig_1	92515	91567	948	renamed_GCF_000008685.2	chromosome	306615	305670	948	99.0	1.931e-207
UNY1128P	contig_1	94414	93214	1200	renamed_GCF_000008685.2	chromosome	308517	307317	1200	99.7	1.629e-260
UNY1128P	contig_1	105535	105004	531	renamed_GCF_000008685.2	chromosome	319636	319105	531	100.0	1.699e-113
UNY1128P	contig_1	106207	107251	1044	renamed_GCF_000008685.2	chromosome	320308	321352	1044	99.4	3.304e-226
UNY1128P	contig_1	108745	107938	807	renamed_GCF_000008685.2	chromosome	322846	322039	807	99.6	2.064e-174
UNY1128P	contig_1	111135	109674	1461	renamed_GCF_000008685.2	chromosome	325236	323775	1461	99.7	0.0
UNY1128P	contig_1	113626	112597	1029	renamed_GCF_000008685.2	chromosome	327757	326698	1029	98.8	1.806e-230
UNY1128P	contig_1	173244	173718	474	renamed_GCF_000008685.2	chromosome	387333	387807	474	100.0	1.339e-106
UNY1128P	contig_1	174837	174417	420	renamed_GCF_000008685.2	chromosome	388926	388506	420	100.0	9.787e-93
UNY1128P	contig_1	177730	176305	1425	renamed_GCF_000008685.2	chromosome	391819	390391	1425	99.5	0.0
UNY1128P	contig_1	179974	178954	1020	renamed_GCF_000008685.2	chromosome	394063	393043	1020	100.0	6.665e-223
UNY1128P	contig_1	182420	181394	1026	renamed_GCF_000008685.2	chromosome	396506	395480	1026	100.0	3.003e-224
UNY1128P	contig_1	196361	195329	1032	renamed_GCF_000008685.2	chromosome	410447	409415	1032	97.9	7.078e-233
UNY1128P	contig_1	198914	197369	1545	renamed_GCF_000008685.2	chromosome	413006	411455	1545	99.2	0.0
UNY1128P	contig_1	201707	200240	1467	renamed_GCF_000008685.2	chromosome	415793	414326	1467	99.3	0.0
UNY1128P	contig_1	202602	203019	417	renamed_GCF_000008685.2	chromosome	416688	417105	417	100.0	1.248e-89
UNY1128P	contig_1	203637	204249	612	renamed_GCF_000008685.2	chromosome	417723	418335	612	99.0	1.684e-135
UNY1128P	contig_1	270664	271168	504	renamed_GCF_000008685.2	chromosome	484756	485266	504	98.8	1.338e-111
UNY1128P	contig_1	271975	272671	696	renamed_GCF_000008685.2	chromosome	486073	486769	696	99.5	1.401e-151
UNY1128P	contig_1	273436	274126	690	renamed_GCF_000008685.2	chromosome	487534	488224	690	99.1	2.347e-153
UNY1128P	contig_1	274884	275397	513	renamed_GCF_000008685.2	chromosome	488982	489495	513	100.0	1.545e-111
UNY1128P	contig_1	275634	276456	822	renamed_GCF_000008685.2	chromosome	489732	490554	822	99.2	6.708e-181
UNY1128P	contig_1	285609	286491	882	renamed_GCF_000008685.2	chromosome	499706	500588	882	99.6	1.369e-191
UNY1128P	contig_1	286914	287115	201	renamed_GCF_000008685.2	chromosome	501014	501212	201	96.9	5.468e-39
UNY1128P	contig_1	287399	287768	369	renamed_GCF_000008685.2	chromosome	501496	501865	369	99.1	4.571e-76
UNY1128P	contig_1	288093	288642	549	renamed_GCF_000008685.2	chromosome	502190	502739	549	100.0	1.698e-116
UNY1128P	contig_1	288853	289252	399	renamed_GCF_000008685.2	chromosome	502950	503349	399	95.4	4.116e-82
UNY1128P	contig_1	347454	347016	438	renamed_GCF_000008685.2	chromosome	561554	561116	438	100.0	1.44e-91
UNY1128P	contig_1	348084	350067	1983	renamed_GCF_000008685.2	chromosome	562184	564167	1983	99.5	0.0
UNY1128P	contig_1	351861	352671	810	renamed_GCF_000008685.2	chromosome	565954	567823	810	98.1	3.013e-179
UNY1128P	contig_1	353710	354184	474	renamed_GCF_000008685.2	chromosome	567809	568277	474	100.0	2.168e-101
UNY1128P	contig_1	355177	355438	261	renamed_GCF_000008685.2	chromosome	569277	569538	261	100.0	9.575e-51
UNY1128P	contig_1	367542	369315	1773	renamed_GCF_000008685.2	chromosome	581644	583417	1773	99.4	0.0
UNY1128P	contig_1	370778	370088	690	renamed_GCF_000008685.2	chromosome	584880	584190	690	99.5	9.609e-155
UNY1128P	contig_1	373963	375565	1602	renamed_GCF_000008685.2	chromosome	588065	589667	1602	100.0	0.0
UNY1128P	contig_1	376245	376833	588	renamed_GCF_000008685.2	chromosome	590347	590935	588	100.0	4.112e-130
UNY1128P	contig_1	496582	497068	486	renamed_GCF_000008685.2	chromosome	710685	711171	486	100.0	5.304e-102
UNY1128P	contig_1	498104	497588	516	renamed_GCF_000008685.2	chromosome	712207	711691	516	99.4	8.019e-111
UNY1128P	contig_1	500004	499140	864	renamed_GCF_000008685.2	chromosome	714107	713243	864	100.0	1.134e-190
UNY1128P	contig_1	500905	502516	1611	renamed_GCF_000008685.2	chromosome	715008	716619	1611	99.8	0.0
UNY1128P	contig_1	503639	504566	927	renamed_GCF_000008685.2	chromosome	717742	718669	927	100.0	3.519e-197
UNY1128P	contig_1	507015	508917	1902	renamed_GCF_000008685.2	chromosome	721118	723020	1902	100.0	0.0
UNY1128P	contig_1	510120	511344	1224	renamed_GCF_000008685.2	chromosome	724223	725447	1224	99.5	7.158e-274
UNY1128P	contig_1	526136	526319	183	renamed_GCF_000008685.2	chromosome	740239	740422	183	100.0	1.805e-39
UNY1128P	contig_1	526584	527322	738	renamed_GCF_000008685.2	chromosome	740687	741425	738	100.0	4.772e-162
UNY1128P	contig_1	528640	530413	1773	renamed_GCF_000008685.2	chromosome	742743	744516	1773	99.1	0.0
UNY1128P	contig_1	583946	583016	930	renamed_GCF_000008685.2	chromosome	798048	797118	930	100.0	3.063e-199
UNY1128P	contig_1	603308	603869	561	renamed_GCF_000008685.2	chromosome	817395	817956	561	99.4	1.601e-127
UNY1128P	contig_1	604517	604829	312	renamed_GCF_000008685.2	chromosome	818604	818916	312	100.0	1.086e-65
UNY1128P	contig_1	605154	605400	246	renamed_GCF_000008685.2	chromosome	819241	819487	246	100.0	8.275e-50
UNY1128P	contig_1	606519	607101	582	renamed_GCF_000008685.2	chromosome	820606	821188	582	99.4	1.005e-127
UNY1128P	contig_1	608256	608607	351	renamed_GCF_000008685.2	chromosome	822343	822694	351	98.2	7.603e-76
UNY1128P	contig_1	609175	609724	549	renamed_GCF_000008685.2	chromosome	823262	823811	549	99.4	8.399e-116
UNY1128P	contig_1	610294	611617	1323	renamed_GCF_000008685.2	chromosome	824381	825704	1323	100.0	8.966e-297
UNY1128P	contig_1	613543	615025	1482	renamed_GCF_000008685.2	chromosome	827630	829112	1482	98.7	0.0
UNY1128P	contig_1	616854	616230	624	renamed_GCF_000008685.2	chromosome	830941	830317	624	99.0	2.819e-140
UNY1128P	contig_1	636876	638397	1521	renamed_GCF_000008685.2	chromosome	850993	852514	1521	99.4	0.0
UNY1128P	contig_1	639657	640725	1068	renamed_GCF_000008685.2	chromosome	853774	854842	1068	99.7	1.362e-231
UNY1128P	contig_1	641873	643394	1521	renamed_GCF_000008685.2	chromosome	855988	857509	1521	99.6	0.0
UNY1128P	contig_1	645996	644823	1173	renamed_GCF_000008685.2	chromosome	860111	858938	1173	98.7	1.696e-255
UNY1128P	contig_1	648585	649533	948	renamed_GCF_000008685.2	chromosome	862698	863646	948	99.6	9.536e-207
UNY1128P	contig_1	661094	662336	1242	renamed_GCF_000008685.2	chromosome	875206	876448	1242	99.7	2.455e-280
UNY1128P	contig_1	665202	666138	936	renamed_GCF_000008685.2	chromosome	879314	880250	936	100.0	3.242e-208
UNY1128P	contig_1	670101	666972	3129	renamed_GCF_000008685.2	chromosome	884213	881084	3129	99.7	0.0
UNY1128P	contig_2	38901	39888	987	renamed_GCF_000008685.2	chromosome	174970	174097	987	99.6	1.701e-189
UNY1128P	contig_2	39869	40457	588	renamed_GCF_000008685.2	chromosome	174116	173528	588	99.4	1.682e-131
UNY1128P	contig_2	40405	42454	2049	renamed_GCF_000008685.2	chromosome	173535	171531	2049	98.9	0.0
UNY1128P	contig_2	42735	42501	234	renamed_GCF_000008685.2	chromosome	171262	171484	234	98.6	1.134e-44
UNY1128P	contig_2	42888	43266	378	renamed_GCF_000008685.2	chromosome	171097	170719	378	99.2	3.569e-80
UNY1128P	contig_2	44447	43277	1170	renamed_GCF_000008685.2	chromosome	169562	170708	1170	99.2	2.992e-257
UNY1128P	contig_2	56359	55924	435	renamed_GCF_000008685.2	chromosome	157626	158061	435	99.3	1.372e-91
UNY1128P	contig_2	57524	56387	1137	renamed_GCF_000008685.2	chromosome	156461	157598	1137	99.7	1.277e-252
UNY1128P	contig_2	57586	60286	2700	renamed_GCF_000008685.2	chromosome	156400	153700	2700	100.0	0.0
UNY1128P	contig_2	60300	60912	612	renamed_GCF_000008685.2	chromosome	153686	153074	612	100.0	4.712e-141
UNY1128P	contig_2	61781	60974	807	renamed_GCF_000008685.2	chromosome	152205	153012	807	99.6	4.826e-182
UNY1128P	contig_2	63013	61807	1206	renamed_GCF_000008685.2	chromosome	150973	152179	1206	100.0	4.93e-275
UNY1128P	contig_2	65327	66338	1011	renamed_GCF_000008685.2	chromosome	148659	147648	1011	100.0	5.463e-215
UNY1128P	contig_2	66491	67610	1119	renamed_GCF_000008685.2	chromosome	147495	146376	1119	100.0	3.727e-246
UNY1128P	contig_2	67616	68516	900	renamed_GCF_000008685.2	chromosome	146370	145470	900	100.0	6.779e-194
UNY1128P	contig_2	82874	83819	945	renamed_GCF_000008685.2	chromosome	131114	130169	945	100.0	6.888e-210
UNY1128P	contig_2	83856	86562	2706	renamed_GCF_000008685.2	chromosome	130132	127426	2706	99.8	0.0
UNY1128P	contig_2	86575	87673	1098	renamed_GCF_000008685.2	chromosome	127413	126315	1098	99.7	3.042e-236
UNY1128P	contig_2	87687	88455	768	renamed_GCF_000008685.2	chromosome	126301	125533	768	100.0	3.291e-171
UNY1128P	contig_2	88441	89191	750	renamed_GCF_000008685.2	chromosome	125547	124797	750	99.1	3.127e-160
UNY1128P	contig_2	89174	89840	666	renamed_GCF_000008685.2	chromosome	124814	124148	666	98.6	2.241e-141
UNY1128P	contig_2	89842	91498	1656	renamed_GCF_000008685.2	chromosome	124146	122490	1656	99.6	0.0
UNY1128P	contig_2	91497	92109	612	renamed_GCF_000008685.2	chromosome	122491	121879	612	97.0	9.656e-125
UNY1128P	contig_2	92165	92888	723	renamed_GCF_000008685.2	chromosome	121823	121100	723	99.1	9.2e-161
UNY1128P	contig_2	92906	93185	279	renamed_GCF_000008685.2	chromosome	121082	120803	279	100.0	1.411e-57
UNY1128P	contig_2	112650	113244	594	renamed_GCF_000008685.2	chromosome	101339	100745	594	100.0	6.255e-135
UNY1128P	contig_2	113762	113240	522	renamed_GCF_000008685.2	chromosome	100227	100749	522	98.2	3.604e-112
UNY1128P	contig_2	115173	113784	1389	renamed_GCF_000008685.2	chromosome	98816	100205	1389	99.5	1.066e-314
UNY1128P	contig_2	115208	116126	918	renamed_GCF_000008685.2	chromosome	98648	97862	918	99.6	1.055e-174
UNY1128P	contig_2	116122	117046	924	renamed_GCF_000008685.2	chromosome	97866	96942	924	100.0	7.888e-205
UNY1128P	contig_2	117035	119378	2343	renamed_GCF_000008685.2	chromosome	96953	94610	2343	99.8	0.0
UNY1128P	contig_2	130068	131019	951	renamed_GCF_000008685.2	chromosome	83920	82969	951	99.6	3.736e-209
UNY1128P	contig_2	132585	131049	1536	renamed_GCF_000008685.2	chromosome	81404	82940	1536	100.0	0.0
UNY1128P	contig_2	133007	132581	426	renamed_GCF_000008685.2	chromosome	80982	81408	426	98.5	2.913e-90
UNY1128P	contig_2	134484	133215	1269	renamed_GCF_000008685.2	chromosome	79504	80773	1269	100.0	1.4e-282
UNY1128P	contig_2	156731	156014	717	renamed_GCF_000008685.2	chromosome	57258	57975	717	98.7	3.592e-153
UNY1128P	contig_2	156804	157158	354	renamed_GCF_000008685.2	chromosome	57185	56831	354	99.1	6.554e-78
UNY1128P	contig_2	157241	157709	468	renamed_GCF_000008685.2	chromosome	56748	56280	468	98.7	9.748e-101
UNY1128P	contig_2	157709	158489	780	renamed_GCF_000008685.2	chromosome	56280	55500	780	99.6	1.628e-172
UNY1128P	contig_2	158485	160456	1971	renamed_GCF_000008685.2	chromosome	55504	53533	1971	99.3	0.0
UNY1128P	contig_2	160528	161536	1008	renamed_GCF_000008685.2	chromosome	53461	52453	1008	100.0	6.65e-221
UNY1128P	contig_2	182966	182507	459	renamed_GCF_000008685.2	chromosome	31026	31479	459	99.3	5.582e-97
UNY1128P	contig_2	184453	182971	1482	renamed_GCF_000008685.2	chromosome	29542	31015	1482	96.9	2e-323
UNY1128P	contig_2	184524	185505	981	renamed_GCF_000008685.2	chromosome	29472	28491	981	99.3	9.688e-221
UNY1128P	contig_2	185506	186142	636	renamed_GCF_000008685.2	chromosome	28490	27854	636	100.0	8.334e-139
UNY1128P	contig_2	204637	203632	1005	renamed_GCF_000008685.2	chromosome	9201	10206	1005	99.7	3.77e-218
UNY1128P	contig_2	205412	204641	771	renamed_GCF_000008685.2	chromosome	8426	9197	771	100.0	1.781e-161
UNY1128P	contig_2	205523	206381	858	renamed_GCF_000008685.2	chromosome	8315	7457	858	99.6	1.438e-195
UNY1128P	contig_2	206441	207530	1089	renamed_GCF_000008685.2	chromosome	7397	6308	1089	99.7	9.025e-240
UNY1128P	contig_2	207532	208588	1056	renamed_GCF_000008685.2	chromosome	6306	5250	1056	99.4	3.853e-235
UNY1128P	contig_2	210444	208650	1794	renamed_GCF_000008685.2	chromosome	3418	5188	1794	99.4	0.0
UNY1128P	contig_3	4247	3434	813	renamed_GCF_000008685.2	cp32-4	14276	15092	813	63.9	5.328e-104
UNY1128P	contig_3	20676	20103	573	renamed_GCF_000008685.2	lp56	31167	31710	573	98.8	1.35e-114
UNY1128P	contig_3	21862	20839	1023	renamed_GCF_000008685.2	lp56	29936	30974	1023	95.6	4.99e-218
UNY1128P	contig_3	22292	23087	795	renamed_GCF_000008685.2	cp32-4	25435	24640	795	98.4	7.691e-175
UNY1128P	contig_3	32908	32704	204	renamed_GCF_000008685.2	lp56	18712	18916	204	100.0	2.578e-39
UNY1128P	contig_3	35296	34417	879	renamed_GCF_000008685.2	cp32-7	12831	13710	879	96.2	1.027e-185
UNY1128P	contig_3	50629	51322	693	renamed_GCF_000008685.2	cp32-6	27745	27076	693	28.1	1.185e-09
UNY1128P	contig_4	4144	4501	357	renamed_GCF_000008685.2	lp17	1409	1766	357	84.5	4.502e-58
UNY1128P	contig_4	5914	6730	816	renamed_GCF_000008685.2	lp28-4	2535	3351	816	99.6	3.991e-177
UNY1128P	contig_4	31219	30325	894	renamed_GCF_000008685.2	lp36	187	1081	894	98.6	4.42e-189
UNY1128P	contig_4	31668	32562	894	renamed_GCF_000008685.2	lp28-2	115	1009	894	99.3	3.345e-192
UNY1128P	contig_4	32611	33481	870	renamed_GCF_000008685.2	lp28-2	1046	1928	870	97.9	2.768e-190
UNY1128P	contig_4	36141	36870	729	renamed_GCF_000008685.2	lp25	22677	21945	729	83.9	1.391e-131
UNY1128P	contig_5	1957	1183	774	renamed_GCF_000008685.2	lp54	51705	52479	774	100.0	9.219e-161
UNY1128P	contig_5	3585	3810	225	renamed_GCF_000008685.2	lp54	50077	49852	225	98.6	4.854e-44
UNY1128P	contig_5	4702	5494	792	renamed_GCF_000008685.2	lp54	48267	47475	792	97.7	1.412e-167
UNY1128P	contig_5	7024	8260	1236	renamed_GCF_000008685.2	lp54	45947	44711	1236	99.0	1.8e-265
UNY1128P	contig_5	23590	23215	375	renamed_GCF_000008685.2	lp54	29383	29758	375	100.0	1.685e-79
UNY1128P	contig_5	24960	24042	918	renamed_GCF_000008685.2	lp54	28013	28931	918	99.6	1.041e-200
UNY1128P	contig_5	28466	27860	606	renamed_GCF_000008685.2	lp54	24497	25103	606	99.5	1.47e-127
UNY1128P	contig_5	36343	36910	567	renamed_GCF_000008685.2	lp54	16576	16000	567	92.9	6.424e-105
UNY1128P	contig_5	38604	38058	546	renamed_GCF_000008685.2	lp54	14337	14883	546	100.0	1.338e-118
UNY1128P	contig_5	39947	39362	585	renamed_GCF_000008685.2	lp54	12994	13579	585	100.0	1.763e-130
UNY1128P	contig_7	19250	18965	285	renamed_GCF_000008685.2	lp36	6365	6650	285	100.0	1.151e-60
UNY1128P	contig_7	23558	23924	366	renamed_GCF_000008685.2	lp21	252	618	366	100.0	7.218e-79
UNY1128P	contig_8	3344	3902	558	renamed_GCF_000008685.2	cp32-7	2009	2567	558	100.0	1.105e-122
UNY1128P	contig_8	6730	7114	384	renamed_GCF_000008685.2	cp32-6	5403	5787	384	100.0	2.931e-83
UNY1128P	contig_8	7101	7491	390	renamed_GCF_000008685.2	cp32-6	5774	6164	390	99.2	3.229e-83
UNY1128P	contig_10	9404	8975	429	renamed_GCF_000008685.2	lp28-2	11491	11062	429	99.2	1.514e-89
UNY1128P	contig_10	10665	10221	444	renamed_GCF_000008685.2	lp28-2	12752	12308	444	100.0	8.866e-98
UNY1128P	contig_10	20613	20226	387	renamed_GCF_000008685.2	lp28-2	22659	22272	387	72.6	9.831e-63
UNY1128P	contig_10	21679	20986	693	renamed_GCF_000008685.2	lp28-2	23725	23032	693	83.0	8.75e-131
UNY1128P	contig_10	22396	23914	1518	renamed_GCF_000008685.2	lp28-2	24488	25955	1518	64.8	2.831e-200
UNY1128P	contig_10	24482	25019	537	renamed_GCF_000008685.2	lp28-2	26569	27085	537	52.2	3.419e-56
UNY1128P	contig_11	10396	10744	348	renamed_GCF_000008685.2	cp26	4083	4431	348	99.1	5.329e-71
UNY1128P	contig_12	19666	19024	642	renamed_GCF_000008685.2	cp32-7	10316	10958	642	95.7	1.337e-134
UNY1128P	contig_13	2629	2005	624	renamed_GCF_000008685.2	cp32-3	26707	27298	624	54.2	6.274e-63
UNY1128P	contig_13	20026	19789	237	renamed_GCF_000008685.2	cp32-7	8725	8962	237	100.0	7.893e-49
UNY1128P	contig_17	2484	1890	594	renamed_GCF_000008685.2	lp38	11105	10517	594	89.3	1.877e-114
UNY1128P	contig_17	3267	2529	738	renamed_GCF_000008685.2	lp38	11889	11151	738	91.8	4.993e-153
UNY1128P	contig_17	3830	3239	591	renamed_GCF_000008685.2	lp38	12452	11861	591	89.6	1.347e-117
UNY1128P	contig_17	4824	3822	1002	renamed_GCF_000008685.2	lp38	13440	12444	1002	81.2	2.007e-181
UNY1128P	contig_17	7306	8113	807	renamed_GCF_000008685.2	lp56	2743	3496	807	55.3	2.863e-83
UNY1128P	contig_22	1852	1327	525	renamed_GCF_000008685.2	cp9	4377	3852	525	94.8	1.357e-106
UNY1128P	contig_22	2259	1974	285	renamed_GCF_000008685.2	cp9	4788	4503	285	98.9	1.273e-59
UNY1128P	contig_24	84	882	798	renamed_GCF_000008685.2	cp9	6973	7771	798	99.2	6.687e-177
UNY1128P	contig_27	173	1133	960	renamed_GCF_000008685.2	cp32-1	3962	4922	960	99.3	3.255e-212
UNY1128P	contig_1	1325	3158	1833	renamed_GCF_000008685.2	chromosome	215426	217259	1833	99.5	0.0
UNY1128P	contig_1	23855	23528	327	renamed_GCF_000008685.2	chromosome	237956	237629	327	99.0	9.315e-70
UNY1128P	contig_1	25027	24199	828	renamed_GCF_000008685.2	chromosome	239128	238300	828	99.2	2.283e-185
UNY1128P	contig_1	28188	26181	2007	renamed_GCF_000008685.2	chromosome	242289	240282	2007	99.7	0.0
UNY1128P	contig_1	30612	29841	771	renamed_GCF_000008685.2	chromosome	244713	243942	771	100.0	4.161e-169
UNY1128P	contig_1	32495	34001	1506	renamed_GCF_000008685.2	chromosome	246596	248102	1506	100.0	0.0
UNY1128P	contig_1	36569	36074	495	renamed_GCF_000008685.2	chromosome	250670	250175	495	100.0	5.051e-104
UNY1128P	contig_1	38136	37110	1026	renamed_GCF_000008685.2	chromosome	252237	251211	1026	99.4	2.737e-225
UNY1128P	contig_1	39057	40830	1773	renamed_GCF_000008685.2	chromosome	253158	254931	1773	98.9	0.0
UNY1128P	contig_1	41544	42159	615	renamed_GCF_000008685.2	chromosome	255645	256260	615	100.0	1.16e-131
UNY1128P	contig_1	62395	61141	1254	renamed_GCF_000008685.2	chromosome	276496	275242	1254	99.7	2.463e-282
UNY1128P	contig_1	100022	98630	1392	renamed_GCF_000008685.2	chromosome	314123	312728	1392	99.5	5.662e-305
UNY1128P	contig_1	101213	100322	891	renamed_GCF_000008685.2	chromosome	315314	314423	891	99.3	2.2e-196
UNY1128P	contig_1	103115	102038	1077	renamed_GCF_000008685.2	chromosome	317216	316139	1077	100.0	1.824e-238
UNY1128P	contig_1	105015	104175	840	renamed_GCF_000008685.2	chromosome	319116	318276	840	99.6	1.977e-180
UNY1128P	contig_1	116651	115541	1110	renamed_GCF_000008685.2	chromosome	330752	329642	1110	99.7	1.105e-249
UNY1128P	contig_1	120423	119526	897	renamed_GCF_000008685.2	chromosome	334515	333618	897	100.0	1.666e-200
UNY1128P	contig_1	126248	127169	921	renamed_GCF_000008685.2	chromosome	340340	341261	921	99.0	1.582e-196
UNY1128P	contig_1	128242	129115	873	renamed_GCF_000008685.2	chromosome	342334	343207	873	100.0	1.573e-188
UNY1128P	contig_1	141209	140558	651	renamed_GCF_000008685.2	chromosome	355298	354647	651	100.0	1.769e-141
UNY1128P	contig_1	191531	191156	375	renamed_GCF_000008685.2	chromosome	405617	405242	375	98.3	1.364e-73
UNY1128P	contig_1	192775	192094	681	renamed_GCF_000008685.2	chromosome	406861	406180	681	99.5	1.335e-149
UNY1128P	contig_1	193812	193257	555	renamed_GCF_000008685.2	chromosome	407898	407343	555	99.4	1.275e-120
UNY1128P	contig_1	205420	204301	1119	renamed_GCF_000008685.2	chromosome	419506	418387	1119	100.0	8.015e-255
UNY1128P	contig_1	207467	208097	630	renamed_GCF_000008685.2	chromosome	421553	422183	630	99.0	6.272e-141
UNY1128P	contig_1	210362	209738	624	renamed_GCF_000008685.2	chromosome	424442	423821	624	99.5	4.527e-135
UNY1128P	contig_1	211499	212627	1128	renamed_GCF_000008685.2	chromosome	425583	426711	1128	99.7	5.155e-244
UNY1128P	contig_1	213902	214538	636	renamed_GCF_000008685.2	chromosome	427986	428622	636	99.5	1.686e-139
UNY1128P	contig_1	280444	280051	393	renamed_GCF_000008685.2	chromosome	494539	494149	393	99.2	2.252e-79
UNY1128P	contig_1	282170	282482	312	renamed_GCF_000008685.2	chromosome	496267	496579	312	100.0	2.953e-63
UNY1128P	contig_1	283147	283777	630	renamed_GCF_000008685.2	chromosome	497244	497874	630	100.0	4.528e-136
UNY1128P	contig_1	284115	284949	834	renamed_GCF_000008685.2	chromosome	498212	499046	834	100.0	1.895e-188
UNY1128P	contig_1	289268	289811	543	renamed_GCF_000008685.2	chromosome	503365	503908	543	99.4	1.698e-115
UNY1128P	contig_1	290200	290698	498	renamed_GCF_000008685.2	chromosome	504297	504795	498	99.3	1.965e-106
UNY1128P	contig_1	291006	291444	438	renamed_GCF_000008685.2	chromosome	505103	505541	438	98.6	5.873e-93
UNY1128P	contig_1	292773	292887	114	renamed_GCF_000008685.2	chromosome	506864	506984	114	100.0	7.638e-22
UNY1128P	contig_1	293308	293701	393	renamed_GCF_000008685.2	chromosome	507405	507798	393	100.0	3.073e-84
UNY1128P	contig_1	310449	312150	1701	renamed_GCF_000008685.2	chromosome	524553	526254	1701	99.2	0.0
UNY1128P	contig_1	359638	357787	1851	renamed_GCF_000008685.2	chromosome	573740	571889	1851	100.0	0.0
UNY1128P	contig_1	361714	361171	543	renamed_GCF_000008685.2	chromosome	575816	575273	543	99.4	6.941e-117
UNY1128P	contig_1	363085	362479	606	renamed_GCF_000008685.2	chromosome	577187	576581	606	99.5	4.975e-131
UNY1128P	contig_1	363847	364159	312	renamed_GCF_000008685.2	chromosome	577949	578261	312	100.0	5.387e-65
UNY1128P	contig_1	366383	367541	1158	renamed_GCF_000008685.2	chromosome	580485	581643	1158	100.0	7.971e-253
UNY1128P	contig_1	381850	382429	579	renamed_GCF_000008685.2	chromosome	595942	596521	579	99.4	1.865e-120
UNY1128P	contig_1	382438	384499	2061	renamed_GCF_000008685.2	chromosome	596530	598591	2061	100.0	0.0
UNY1128P	contig_8	14140	15016	876	renamed_GCF_000008685.2	cp32-3	12823	13699	876	100.0	5.609e-192
UNY1128P	contig_8	21442	22009	567	renamed_GCF_000008685.2	cp32-8	20197	20764	567	100.0	6.547e-130
UNY1128P	contig_8	23357	23936	579	renamed_GCF_000008685.2	cp32-8	22112	22691	579	100.0	3.43e-122
UNY1128P	contig_10	14396	13370	1026	renamed_GCF_000008685.2	lp28-2	16482	15456	1026	99.7	8.508e-230
UNY1128P	contig_10	15933	15594	339	renamed_GCF_000008685.2	lp28-2	18019	17680	339	100.0	5.085e-70
UNY1128P	contig_10	17533	16750	783	renamed_GCF_000008685.2	lp28-2	19619	18836	783	90.3	1.346e-166
UNY1128P	contig_11	1176	669	507	renamed_GCF_000008685.2	cp26	21364	20857	507	99.4	1.545e-110
UNY1128P	contig_11	1709	2405	696	renamed_GCF_000008685.2	cp26	21897	22593	696	99.1	3.423e-150
UNY1128P	contig_11	3066	4311	1245	renamed_GCF_000008685.2	cp26	23254	24499	1245	98.7	6.871e-278
UNY1128P	contig_11	6355	6634	279	renamed_GCF_000008685.2	cp26	45	324	279	100.0	2.323e-60
UNY1128P	contig_11	8499	7149	1350	renamed_GCF_000008685.2	cp26	2186	836	1350	100.0	7.868e-303
UNY1128P	contig_11	18328	19921	1593	renamed_GCF_000008685.2	cp26	12013	13606	1593	99.4	0.0
UNY1128P	contig_11	22985	21446	1539	renamed_GCF_000008685.2	cp26	16667	15131	1539	99.0	0.0
UNY1128P	contig_13	13039	12703	336	renamed_GCF_000008685.2	cp32-8	15758	16094	336	100.0	5.348e-69
UNY1128P	contig_13	15087	14481	606	renamed_GCF_000008685.2	cp32-8	13708	14314	606	99.0	2.973e-128
UNY1128P	contig_14	7634	7055	579	renamed_GCF_000008685.2	lp17	6452	5873	579	99.4	2.579e-125
UNY1128P	contig_14	8966	9293	327	renamed_GCF_000008685.2	lp17	7784	8111	327	100.0	1.029e-68
UNY1128P	contig_14	11069	10772	297	renamed_GCF_000008685.2	lp17	9980	9590	297	94.8	1.268e-61
UNY1128P	contig_14	14197	14938	741	renamed_GCF_000008685.2	lp17	13338	14079	741	100.0	7.64e-166
UNY1128P	contig_20	1503	1968	465	renamed_GCF_000008685.2	lp21	15348	15813	465	98.7	9.291e-101
UNY1128P	contig_20	3745	3460	285	renamed_GCF_000008685.2	lp21	16548	16227	285	100.0	4.225e-63
UNY1128P	contig_20	5166	5598	432	renamed_GCF_000008685.2	lp5	4387	4819	432	98.6	1.308e-91
UNY1128P	contig_21	697	1798	1101	renamed_GCF_000008685.2	cp32-1	19113	20214	1101	95.9	8.249e-243
UNY1128P	contig_21	3148	3727	579	renamed_GCF_000008685.2	cp32-6	21519	22098	579	100.0	5.735e-125
UNY1128P	contig_1	75816	75474	342	renamed_GCF_000008685.2	chromosome	289917	289575	342	99.1	5.339e-70
UNY1128P	contig_1	76920	75861	1059	renamed_GCF_000008685.2	chromosome	291021	289962	1059	100.0	3.164e-229
UNY1128P	contig_1	77494	76957	537	renamed_GCF_000008685.2	chromosome	291595	291058	537	99.4	3.778e-114
UNY1128P	contig_1	78325	77542	783	renamed_GCF_000008685.2	chromosome	292426	291643	783	100.0	1.874e-171
UNY1128P	contig_1	88387	86677	1710	renamed_GCF_000008685.2	chromosome	302489	300779	1710	100.0	0.0
UNY1128P	contig_1	88734	88401	333	renamed_GCF_000008685.2	chromosome	302839	302503	333	99.0	1.253e-67
UNY1128P	contig_1	89638	89230	408	renamed_GCF_000008685.2	chromosome	303740	303332	408	99.2	2.649e-88
UNY1128P	contig_1	91559	91010	549	renamed_GCF_000008685.2	chromosome	305661	305112	549	100.0	9.24e-115
UNY1128P	contig_1	93214	92521	693	renamed_GCF_000008685.2	chromosome	307317	306624	693	100.0	2.971e-151
UNY1128P	contig_1	95677	94435	1242	renamed_GCF_000008685.2	chromosome	309780	308538	1242	100.0	1.368e-269
UNY1128P	contig_1	151514	151025	489	renamed_GCF_000008685.2	chromosome	365603	365114	489	100.0	3.787e-106
UNY1128P	contig_1	154366	154792	426	renamed_GCF_000008685.2	chromosome	368455	368881	426	98.5	4.297e-86
UNY1128P	contig_1	155937	156924	987	renamed_GCF_000008685.2	chromosome	370026	371013	987	99.6	8.057e-224
UNY1128P	contig_1	159050	159431	381	renamed_GCF_000008685.2	chromosome	373139	373520	381	100.0	1.683e-80
UNY1128P	contig_1	172069	173248	1179	renamed_GCF_000008685.2	chromosome	386158	387337	1179	100.0	1.981e-263
UNY1128P	contig_1	174391	173728	663	renamed_GCF_000008685.2	chromosome	388480	387817	663	98.6	5.998e-147
UNY1128P	contig_1	176252	174887	1365	renamed_GCF_000008685.2	chromosome	390341	388976	1365	99.3	3.579e-288
UNY1128P	contig_1	178868	177842	1026	renamed_GCF_000008685.2	chromosome	392957	391931	1026	99.1	6.672e-224
UNY1128P	contig_1	181077	180015	1062	renamed_GCF_000008685.2	chromosome	395166	394104	1062	100.0	1.904e-235
UNY1128P	contig_1	248735	249803	1068	renamed_GCF_000008685.2	chromosome	462818	463886	1068	100.0	4.491e-244
UNY1128P	contig_1	253183	251422	1761	renamed_GCF_000008685.2	chromosome	467278	465517	1761	99.4	0.0
UNY1128P	contig_1	255570	255294	276	renamed_GCF_000008685.2	chromosome	469665	469389	276	100.0	1.644e-55
UNY1128P	contig_1	257125	255865	1260	renamed_GCF_000008685.2	chromosome	471220	469960	1260	99.2	1.373e-272
UNY1128P	contig_1	270188	270488	300	renamed_GCF_000008685.2	chromosome	484286	484586	300	98.9	5.976e-62
UNY1128P	contig_1	271451	271979	528	renamed_GCF_000008685.2	chromosome	485549	486077	528	100.0	1.004e-118
UNY1128P	contig_1	272618	273440	822	renamed_GCF_000008685.2	chromosome	486746	487538	822	100.0	1.872e-169
UNY1128P	contig_1	274127	274874	747	renamed_GCF_000008685.2	chromosome	488225	488972	747	99.5	1.867e-165
UNY1128P	contig_1	275393	275621	228	renamed_GCF_000008685.2	chromosome	489539	489719	228	96.6	3.611e-32
UNY1128P	contig_1	328943	329711	768	renamed_GCF_000008685.2	chromosome	543048	543816	768	99.2	2.059e-176
UNY1128P	contig_1	329726	330500	774	renamed_GCF_000008685.2	chromosome	543831	544605	774	99.2	1.962e-169
UNY1128P	contig_1	334385	333740	645	renamed_GCF_000008685.2	chromosome	548490	547845	645	100.0	1.056e-137
UNY1128P	contig_1	347027	346628	399	renamed_GCF_000008685.2	chromosome	561127	560728	399	100.0	7.535e-84
UNY1128P	contig_1	347843	347462	381	renamed_GCF_000008685.2	chromosome	561943	561562	381	100.0	2.258e-77
UNY1128P	contig_1	354170	355040	870	renamed_GCF_000008685.2	chromosome	568269	569139	870	100.0	1.737e-195
UNY1128P	contig_1	355458	357180	1722	renamed_GCF_000008685.2	chromosome	569558	571280	1722	100.0	0.0
UNY1128P	contig_1	423869	424463	594	renamed_GCF_000008685.2	chromosome	637971	638556	594	100.0	1.47e-125
UNY1128P	contig_1	425747	428156	2409	renamed_GCF_000008685.2	chromosome	639858	642249	2409	99.7	0.0
UNY1128P	contig_1	429034	428407	627	renamed_GCF_000008685.2	chromosome	643126	642499	627	100.0	8.735e-137
UNY1128P	contig_1	430684	431053	369	renamed_GCF_000008685.2	chromosome	644771	645140	369	100.0	1.529e-79
UNY1128P	contig_1	431631	432594	963	renamed_GCF_000008685.2	chromosome	645718	646681	963	100.0	1.162e-215
UNY1128P	contig_1	450916	449083	1833	renamed_GCF_000008685.2	chromosome	665011	663178	1833	99.8	0.0
UNY1128P	contig_1	459245	460682	1437	renamed_GCF_000008685.2	chromosome	673341	674778	1437	99.3	0.0
UNY1128P	contig_1	462380	463769	1389	renamed_GCF_000008685.2	chromosome	676471	677860	1389	100.0	1.442e-302
UNY1128P	contig_1	465659	464867	792	renamed_GCF_000008685.2	chromosome	679750	678958	792	100.0	1.55e-166
UNY1128P	contig_1	510027	508959	1068	renamed_GCF_000008685.2	chromosome	724130	723062	1068	99.7	7.559e-247
UNY1128P	contig_1	511327	512392	1065	renamed_GCF_000008685.2	chromosome	725430	726495	1065	99.4	8.981e-236
UNY1128P	contig_1	512354	513650	1296	renamed_GCF_000008685.2	chromosome	726457	727753	1296	98.3	1.152e-280
UNY1128P	contig_1	513633	514572	939	renamed_GCF_000008685.2	chromosome	727736	728675	939	99.6	8.285e-207
UNY1128P	contig_1	514562	515516	954	renamed_GCF_000008685.2	chromosome	728665	729619	954	98.4	1.762e-209
UNY1128P	contig_1	515509	516403	894	renamed_GCF_000008685.2	chromosome	729612	730506	894	98.9	6.773e-193
UNY1128P	contig_1	516996	516528	468	renamed_GCF_000008685.2	chromosome	731099	730631	468	98.0	4.825e-100
UNY1128P	contig_1	517080	517617	537	renamed_GCF_000008685.2	chromosome	731183	731720	537	99.4	4.305e-121
UNY1128P	contig_1	526342	526585	243	renamed_GCF_000008685.2	chromosome	740445	740688	243	100.0	1.755e-49
UNY1128P	contig_1	528525	527292	1233	renamed_GCF_000008685.2	chromosome	742628	741395	1233	99.2	4.064e-273
UNY1128P	contig_1	580753	579760	993	renamed_GCF_000008685.2	chromosome	794855	793841	993	99.3	4.795e-222
UNY1128P	contig_1	584914	583954	960	renamed_GCF_000008685.2	chromosome	799016	798056	960	99.6	2.967e-213
UNY1128P	contig_1	603930	604461	531	renamed_GCF_000008685.2	chromosome	818017	818548	531	100.0	1.403e-115
UNY1128P	contig_1	604834	605155	321	renamed_GCF_000008685.2	chromosome	819035	819242	321	95.5	6.293e-41
UNY1128P	contig_1	605454	606441	987	renamed_GCF_000008685.2	chromosome	819541	820528	987	100.0	5.255e-220
UNY1128P	contig_1	607097	608282	1185	renamed_GCF_000008685.2	chromosome	821184	822369	1185	99.4	5.809e-261
UNY1128P	contig_1	608722	609016	294	renamed_GCF_000008685.2	chromosome	822809	823103	294	100.0	1.207e-61
UNY1128P	contig_1	609728	610295	567	renamed_GCF_000008685.2	chromosome	823815	824382	567	99.4	1.403e-121
UNY1128P	contig_1	611613	613533	1920	renamed_GCF_000008685.2	chromosome	825700	827620	1920	100.0	0.0
UNY1128P	contig_1	615130	616234	1104	renamed_GCF_000008685.2	chromosome	829217	830321	1104	99.4	2.452e-248
UNY1128P	contig_1	674070	672357	1713	renamed_GCF_000008685.2	chromosome	888179	886469	1713	99.2	0.0
UNY1128P	contig_1	676212	679065	2853	renamed_GCF_000008685.2	chromosome	890321	893174	2853	99.5	0.0
UNY1128P	contig_1	696506	697064	558	renamed_GCF_000008685.2	lp28-1	7869	7353	558	99.4	8.805e-117
UNY1128P	contig_2	11389	12916	1527	renamed_GCF_000008685.2	chromosome	202578	201051	1527	99.8	0.0
UNY1128P	contig_2	12917	14003	1086	renamed_GCF_000008685.2	chromosome	201050	199964	1086	99.7	1.322e-243
UNY1128P	contig_2	18291	16287	2004	renamed_GCF_000008685.2	chromosome	195692	197696	2004	99.7	0.0
UNY1128P	contig_2	19108	18247	861	renamed_GCF_000008685.2	chromosome	194875	195736	861	98.9	3.489e-186
UNY1128P	contig_2	20522	21662	1140	renamed_GCF_000008685.2	chromosome	193463	192323	1140	100.0	4.164e-257
UNY1128P	contig_2	21658	22468	810	renamed_GCF_000008685.2	chromosome	192327	191517	810	99.6	1.125e-181
UNY1128P	contig_5	972	174	798	renamed_GCF_000008685.2	lp54	52705	53503	798	99.6	3.008e-177
UNY1128P	contig_5	2486	3377	891	renamed_GCF_000008685.2	lp54	51176	50285	891	98.9	4.455e-197
UNY1128P	contig_5	5743	6499	756	renamed_GCF_000008685.2	lp54	47228	46472	756	99.6	1.063e-164
UNY1128P	contig_5	8438	9287	849	renamed_GCF_000008685.2	lp54	44533	43684	849	100.0	7.054e-185
UNY1128P	contig_5	10717	10510	207	renamed_GCF_000008685.2	lp54	42266	42473	207	100.0	9.856e-42
UNY1128P	contig_5	11938	12772	834	renamed_GCF_000008685.2	lp54	41045	40211	834	99.2	8.097e-181
UNY1128P	contig_5	13578	14823	1245	renamed_GCF_000008685.2	lp54	39405	38160	1245	100.0	4.898e-273
UNY1128P	contig_5	31877	31337	540	renamed_GCF_000008685.2	lp54	21086	21626	540	97.7	2.373e-111
UNY1128P	contig_5	32246	32051	195	renamed_GCF_000008685.2	lp54	20717	20912	195	100.0	2.214e-39
UNY1128P	contig_5	34195	32842	1353	renamed_GCF_000008685.2	lp54	18724	20077	1353	99.5	1.671e-303
UNY1128P	contig_5	34792	34198	594	renamed_GCF_000008685.2	lp54	18127	18721	594	98.9	7.995e-124
UNY1128P	contig_5	35660	36224	564	renamed_GCF_000008685.2	lp54	17259	16695	564	99.4	1.171e-114
UNY1128P	contig_5	37572	37140	432	renamed_GCF_000008685.2	lp54	15369	15801	432	98.6	8.873e-96
UNY1128P	contig_5	39387	38634	753	renamed_GCF_000008685.2	lp54	13554	14307	753	100.0	4.561e-165
UNY1128P	contig_6	19037	18260	777	renamed_GCF_000008685.2	lp56	29506	28729	777	97.6	2.057e-169
UNY1128P	contig_7	22308	21936	372	renamed_GCF_000008685.2	lp5	1207	1576	372	82.1	7.026e-64
UNY1128P	contig_8	2639	3332	693	renamed_GCF_000008685.2	cp32-1	1305	1998	693	100.0	2.582e-144
UNY1128P	contig_8	3908	4673	765	renamed_GCF_000008685.2	cp32-7	2573	3338	765	99.6	3.139e-171
UNY1128P	contig_8	6275	6731	456	renamed_GCF_000008685.2	cp32-1	4941	5397	456	97.3	1.304e-95
UNY1128P	contig_8	7487	8057	570	renamed_GCF_000008685.2	cp32-6	6160	6730	570	98.4	5.468e-124
UNY1128P	contig_8	16736	17084	348	renamed_GCF_000008685.2	lp56	18919	19267	348	99.1	4.373e-73
UNY1128P	contig_8	17073	17409	336	renamed_GCF_000008685.2	cp32-9	15855	16191	336	100.0	5.348e-69
UNY1128P	contig_8	18519	18966	447	renamed_GCF_000008685.2	cp32-8	17204	17651	447	96.6	2.512e-95
UNY1128P	contig_11	16415	16964	549	renamed_GCF_000008685.2	cp26	10103	10652	549	99.4	1.544e-117
UNY1128P	contig_12	7959	7419	540	renamed_GCF_000008685.2	cp32-9	22183	22723	540	98.8	1.96e-113
UNY1128P	contig_12	9326	8570	756	renamed_GCF_000008685.2	cp32-9	20816	21572	756	99.6	4.781e-165
UNY1128P	contig_12	12851	12404	447	renamed_GCF_000008685.2	cp32-6	17246	17696	447	80.8	1.435e-76
UNY1128P	contig_12	21013	19678	1335	renamed_GCF_000008685.2	cp32-7	8969	10304	1335	89.8	1.565e-257
UNY1128P	contig_13	1894	1384	510	renamed_GCF_000008685.2	cp32-3	27409	27919	510	95.8	1.295e-104
UNY1128P	contig_15	10282	11350	1068	renamed_GCF_000008685.2	lp28-1	15451	14350	1068	96.0	6.722e-231
UNY1128P	contig_15	11941	12706	765	renamed_GCF_000008685.2	lp28-1	13793	13028	765	99.6	1.871e-168
UNY1128P	contig_16	7	691	684	renamed_GCF_000008685.2	lp56	20042	20738	684	86.1	2.703e-125
UNY1128P	contig_16	2228	1280	948	renamed_GCF_000008685.2	cp32-3	19228	18286	948	98.0	7.219e-210
UNY1128P	contig_22	4278	3750	528	renamed_GCF_000008685.2	cp9	6808	6280	528	100.0	2.158e-110
UNY1128P	contig_1	4977	4323	654	renamed_GCF_000008685.2	chromosome	219078	218424	654	98.6	2.571e-146
UNY1128P	contig_1	5698	6538	840	renamed_GCF_000008685.2	chromosome	219799	220639	840	99.6	8.103e-182
UNY1128P	contig_1	7532	9077	1545	renamed_GCF_000008685.2	chromosome	221741	223178	1545	99.3	7.02e-311
UNY1128P	contig_1	10684	9862	822	renamed_GCF_000008685.2	chromosome	224785	223963	822	100.0	3.638e-179
UNY1128P	contig_1	13726	12508	1218	renamed_GCF_000008685.2	chromosome	227827	226609	1218	99.7	3.023e-265
UNY1128P	contig_1	15115	16123	1008	renamed_GCF_000008685.2	chromosome	229216	230224	1008	99.4	2.993e-221
UNY1128P	contig_1	17519	18221	702	renamed_GCF_000008685.2	chromosome	231620	232322	702	98.2	3.117e-152
UNY1128P	contig_1	21433	21187	246	renamed_GCF_000008685.2	chromosome	235534	235288	246	98.7	3.025e-52
UNY1128P	contig_1	59752	61135	1383	renamed_GCF_000008685.2	chromosome	273856	275236	1383	99.5	1.314e-302
UNY1128P	contig_1	62456	62963	507	renamed_GCF_000008685.2	chromosome	276671	277064	507	99.2	3.116e-86
UNY1128P	contig_1	64957	64435	522	renamed_GCF_000008685.2	chromosome	279058	278536	522	99.4	1.962e-110
UNY1128P	contig_1	67210	65305	1905	renamed_GCF_000008685.2	chromosome	281311	279406	1905	99.8	0.0
UNY1128P	contig_1	68586	67698	888	renamed_GCF_000008685.2	chromosome	282687	281799	888	100.0	4.025e-189
UNY1128P	contig_1	79107	78324	783	renamed_GCF_000008685.2	chromosome	293208	292425	783	99.6	6.057e-167
UNY1128P	contig_1	80678	79349	1329	renamed_GCF_000008685.2	chromosome	294780	293451	1329	99.3	1.296e-293
UNY1128P	contig_1	82318	81139	1179	renamed_GCF_000008685.2	chromosome	296420	295241	1179	98.7	6.974e-258
UNY1128P	contig_1	83367	82935	432	renamed_GCF_000008685.2	chromosome	297469	297037	432	99.3	9.777e-95
UNY1128P	contig_1	85613	84692	921	renamed_GCF_000008685.2	chromosome	299715	298794	921	100.0	4.644e-193
UNY1128P	contig_1	140547	139347	1200	renamed_GCF_000008685.2	chromosome	354636	353439	1200	98.9	1.629e-260
UNY1128P	contig_1	141401	142820	1419	renamed_GCF_000008685.2	chromosome	355490	356909	1419	99.5	1.551e-315
UNY1128P	contig_1	144368	145109	741	renamed_GCF_000008685.2	chromosome	358457	359198	741	100.0	9.218e-164
UNY1128P	contig_1	146989	145423	1566	renamed_GCF_000008685.2	chromosome	361078	359512	1566	100.0	0.0
UNY1128P	contig_1	150028	148228	1800	renamed_GCF_000008685.2	chromosome	364117	362317	1800	99.6	0.0
UNY1128P	contig_1	160187	161564	1377	renamed_GCF_000008685.2	chromosome	374276	375653	1377	99.5	6.905e-309
UNY1128P	contig_1	162930	161871	1059	renamed_GCF_000008685.2	chromosome	377019	375960	1059	98.2	7.708e-228
UNY1128P	contig_1	166469	165251	1218	renamed_GCF_000008685.2	chromosome	380558	379340	1218	99.7	4.24e-270
UNY1128P	contig_1	169293	167820	1473	renamed_GCF_000008685.2	chromosome	383382	381909	1473	100.0	0.0
UNY1128P	contig_1	170197	171337	1140	renamed_GCF_000008685.2	chromosome	384286	385426	1140	99.7	7.941e-250
UNY1128P	contig_1	447421	445549	1872	renamed_GCF_000008685.2	chromosome	661515	659643	1872	99.0	0.0
UNY1128P	contig_1	447511	448435	924	renamed_GCF_000008685.2	chromosome	661605	662529	924	99.3	2.542e-200
UNY1128P	contig_1	466472	465662	810	renamed_GCF_000008685.2	chromosome	680557	679753	810	99.6	5.278e-173
UNY1128P	contig_1	467515	466471	1044	renamed_GCF_000008685.2	chromosome	681606	680562	1044	100.0	8.539e-233
UNY1128P	contig_1	468433	467593	840	renamed_GCF_000008685.2	chromosome	682524	681684	840	99.6	3.646e-182
UNY1128P	contig_1	468587	469286	699	renamed_GCF_000008685.2	chromosome	682678	683377	699	100.0	1.337e-152
UNY1128P	contig_1	469331	470876	1545	renamed_GCF_000008685.2	chromosome	683422	684967	1545	99.6	0.0
UNY1128P	contig_1	471890	470906	984	renamed_GCF_000008685.2	chromosome	685980	684996	984	99.6	8.434e-223
UNY1128P	contig_1	472417	471886	531	renamed_GCF_000008685.2	chromosome	686507	685976	531	100.0	1.053e-118
UNY1128P	contig_1	492569	495164	2595	renamed_GCF_000008685.2	chromosome	706672	709267	2595	99.7	0.0
UNY1128P	contig_1	495170	496571	1401	renamed_GCF_000008685.2	chromosome	709273	710674	1401	98.4	1.319e-305
UNY1128P	contig_1	517690	519700	2010	renamed_GCF_000008685.2	chromosome	731793	733803	2010	99.8	0.0
UNY1128P	contig_1	519977	521186	1209	renamed_GCF_000008685.2	chromosome	734080	735289	1209	100.0	8.188e-270
UNY1128P	contig_1	521248	522583	1335	renamed_GCF_000008685.2	chromosome	735351	736686	1335	99.7	2.962e-285
UNY1128P	contig_1	522595	522856	261	renamed_GCF_000008685.2	chromosome	736698	736959	261	98.8	1.572e-53
UNY1128P	contig_1	522856	523105	249	renamed_GCF_000008685.2	chromosome	736959	737208	249	100.0	2.148e-48
UNY1128P	contig_1	523108	523609	501	renamed_GCF_000008685.2	chromosome	737211	737712	501	98.7	1.02e-105
UNY1128P	contig_1	523605	524325	720	renamed_GCF_000008685.2	chromosome	737708	738428	720	99.1	2.354e-158
UNY1128P	contig_1	524302	524668	366	renamed_GCF_000008685.2	chromosome	738405	738771	366	97.5	2.382e-74
UNY1128P	contig_1	546099	547545	1446	renamed_GCF_000008685.2	chromosome	760225	761647	1446	99.3	1.061e-315
UNY1128P	contig_1	562577	561563	1014	renamed_GCF_000008685.2	chromosome	776679	775665	1014	99.7	8.011e-220
UNY1128P	contig_1	562682	563471	789	renamed_GCF_000008685.2	chromosome	776784	777573	789	99.2	2.06e-171
UNY1128P	contig_1	563662	564652	990	renamed_GCF_000008685.2	chromosome	777764	778754	990	99.6	7.696e-225
UNY1128P	contig_1	564655	567283	2628	renamed_GCF_000008685.2	chromosome	778757	781385	2628	99.5	0.0
UNY1128P	contig_1	568727	568049	678	renamed_GCF_000008685.2	chromosome	782829	782151	678	99.5	1.055e-151
UNY1128P	contig_1	569146	568873	273	renamed_GCF_000008685.2	chromosome	783248	782975	273	98.8	4.27e-53
UNY1128P	contig_1	569287	570919	1632	renamed_GCF_000008685.2	chromosome	783389	785021	1632	99.8	0.0
UNY1128P	contig_1	593865	592818	1047	renamed_GCF_000008685.2	chromosome	807966	806919	1047	100.0	5.315e-230
UNY1128P	contig_1	594363	593874	489	renamed_GCF_000008685.2	chromosome	808464	807975	489	100.0	6.125e-101
UNY1128P	contig_1	595451	594359	1092	renamed_GCF_000008685.2	chromosome	809552	808460	1092	99.4	9.457e-240
UNY1128P	contig_1	596393	595598	795	renamed_GCF_000008685.2	chromosome	810495	809700	795	100.0	1.877e-173
UNY1128P	contig_1	597408	596367	1041	renamed_GCF_000008685.2	chromosome	811510	810469	1041	99.7	1.371e-235
UNY1128P	contig_1	598286	597404	882	renamed_GCF_000008685.2	chromosome	812388	811506	882	99.3	2.773e-192
UNY1128P	contig_1	599137	598336	801	renamed_GCF_000008685.2	chromosome	813239	812438	801	100.0	9.279e-174
UNY1128P	contig_1	599614	599287	327	renamed_GCF_000008685.2	chromosome	813706	813385	327	96.2	8.393e-63
UNY1128P	contig_1	600605	599597	1008	renamed_GCF_000008685.2	chromosome	814697	813689	1008	99.1	3.096e-212
UNY1128P	contig_1	601210	600775	435	renamed_GCF_000008685.2	chromosome	815302	814867	435	100.0	4.611e-95
UNY1128P	contig_1	602207	601409	798	renamed_GCF_000008685.2	chromosome	816299	815501	798	99.6	9.72e-173
UNY1128P	contig_1	603110	602219	891	renamed_GCF_000008685.2	chromosome	817160	816311	891	99.6	1.029e-187
UNY1128P	contig_1	624459	624993	534	renamed_GCF_000008685.2	chromosome	838546	839080	534	100.0	7.282e-115
UNY1128P	contig_1	625156	627745	2589	renamed_GCF_000008685.2	chromosome	839243	841832	2589	99.8	0.0
UNY1128P	contig_1	627746	628364	618	renamed_GCF_000008685.2	chromosome	841833	842451	618	100.0	1.393e-138
UNY1128P	contig_1	628464	628902	438	renamed_GCF_000008685.2	chromosome	842500	842989	438	99.3	1.307e-92
UNY1128P	contig_1	628915	630364	1449	renamed_GCF_000008685.2	chromosome	843002	844451	1449	99.5	1.877e-318
UNY1128P	contig_1	630366	632985	2619	renamed_GCF_000008685.2	chromosome	844453	847102	2619	97.7	0.0
UNY1128P	contig_1	633008	633371	363	renamed_GCF_000008685.2	chromosome	847125	847488	363	100.0	2.269e-74
UNY1128P	contig_1	633373	634222	849	renamed_GCF_000008685.2	chromosome	847490	848339	849	99.2	1.428e-185
UNY1128P	contig_1	655911	655395	516	renamed_GCF_000008685.2	chromosome	870023	869507	516	98.8	1.963e-109
UNY1128P	contig_1	658471	655999	2472	renamed_GCF_000008685.2	chromosome	872583	870111	2472	100.0	0.0
UNY1128P	contig_1	679019	682460	3441	renamed_GCF_000008685.2	chromosome	893128	896569	3441	98.7	0.0
UNY1128P	contig_1	683015	682469	546	renamed_GCF_000008685.2	chromosome	897127	896578	546	97.7	8.009e-116
UNY1128P	contig_1	683583	682983	600	renamed_GCF_000008685.2	chromosome	897695	897095	600	99.4	6.881e-135
UNY1128P	contig_1	685208	683591	1617	renamed_GCF_000008685.2	chromosome	899320	897703	1617	99.2	0.0
UNY1128P	contig_1	685386	686619	1233	renamed_GCF_000008685.2	chromosome	899498	900731	1233	100.0	1.522e-275
UNY1128P	contig_1	686686	687670	984	renamed_GCF_000008685.2	chromosome	900798	901782	984	100.0	5.014e-220
UNY1128P	contig_1	687721	689146	1425	renamed_GCF_000008685.2	chromosome	901833	903258	1425	99.7	2.69e-310
UNY1128P	contig_1	690756	689817	939	renamed_GCF_000008685.2	chromosome	904900	903928	939	98.7	8.592e-198
UNY1128P	contig_2	99182	98480	702	renamed_GCF_000008685.2	chromosome	114806	115508	702	99.1	2.582e-154
UNY1128P	contig_2	99385	101080	1695	renamed_GCF_000008685.2	chromosome	114603	112908	1695	99.8	0.0
UNY1128P	contig_2	101220	101640	420	renamed_GCF_000008685.2	chromosome	112769	112349	420	98.5	7.151e-88
UNY1128P	contig_2	101651	102101	450	renamed_GCF_000008685.2	chromosome	112338	111888	450	100.0	4.387e-98
UNY1128P	contig_2	102114	102405	291	renamed_GCF_000008685.2	chromosome	111875	111584	291	98.9	9.399e-64
UNY1128P	contig_2	102422	102944	522	renamed_GCF_000008685.2	chromosome	111567	111045	522	99.4	3.966e-111
UNY1128P	contig_2	102947	104315	1368	renamed_GCF_000008685.2	chromosome	111042	109674	1368	100.0	1.976e-295
UNY1128P	contig_2	104630	104318	312	renamed_GCF_000008685.2	chromosome	108306	109671	312	99.0	2.189e-66
UNY1128P	contig_2	127134	128109	975	renamed_GCF_000008685.2	chromosome	86854	85879	975	100.0	4.354e-220
UNY1128P	contig_2	128268	129948	1680	renamed_GCF_000008685.2	chromosome	85720	84040	1680	99.8	0.0
UNY1128P	contig_2	141340	140494	846	renamed_GCF_000008685.2	chromosome	72646	73492	846	99.6	1.292e-177
UNY1128P	contig_2	142786	141376	1410	renamed_GCF_000008685.2	chromosome	71200	72610	1410	99.7	5.687e-308
UNY1128P	contig_2	143577	142767	810	renamed_GCF_000008685.2	chromosome	70141	71219	810	99.2	1.356e-179
UNY1128P	contig_2	144421	143860	561	renamed_GCF_000008685.2	chromosome	69565	70126	561	99.4	8.395e-118
UNY1128P	contig_2	146739	144417	2322	renamed_GCF_000008685.2	chromosome	67247	69569	2322	99.3	0.0
UNY1128P	contig_2	148695	148233	462	renamed_GCF_000008685.2	chromosome	65290	65752	462	100.0	3.193e-95
UNY1128P	contig_2	149948	148709	1239	renamed_GCF_000008685.2	chromosome	64037	65276	1239	99.7	2.817e-278
UNY1128P	contig_2	168544	167998	546	renamed_GCF_000008685.2	chromosome	45445	45991	546	100.0	3.273e-117
UNY1128P	contig_2	168635	171083	2448	renamed_GCF_000008685.2	chromosome	45354	42906	2448	99.7	0.0
UNY1128P	contig_2	171108	171510	402	renamed_GCF_000008685.2	chromosome	42881	42479	402	100.0	2.405e-88
UNY1128P	contig_2	171506	172547	1041	renamed_GCF_000008685.2	chromosome	42483	41442	1041	99.4	2.178e-230
UNY1128P	contig_2	172557	173229	672	renamed_GCF_000008685.2	chromosome	41432	40760	672	100.0	1.856e-144
UNY1128P	contig_2	174164	173312	852	renamed_GCF_000008685.2	chromosome	39825	40677	852	99.2	2.515e-188
UNY1128P	contig_2	174351	175854	1503	renamed_GCF_000008685.2	chromosome	39638	38135	1503	99.8	0.0
UNY1128P	contig_2	177377	178130	753	renamed_GCF_000008685.2	chromosome	36609	35856	753	98.0	1.62e-159
UNY1128P	contig_2	178150	179950	1800	renamed_GCF_000008685.2	chromosome	35836	34036	1800	99.8	0.0
UNY1128P	contig_2	198493	199114	621	renamed_GCF_000008685.2	chromosome	15345	14724	621	100.0	3.249e-138
UNY1128P	contig_2	201093	199110	1983	renamed_GCF_000008685.2	chromosome	12745	14728	1983	99.6	0.0
UNY1128P	contig_2	212043	213072	1029	renamed_GCF_000008685.2	chromosome	1796	767	1029	99.1	2.615e-226
UNY1128P	contig_2	213751	213187	564	renamed_GCF_000008685.2	chromosome	104	677	564	96.2	6.014e-122
UNY1128P	contig_3	1984	1666	318	renamed_GCF_000008685.2	cp32-3	16585	16903	318	97.1	6.564e-64
UNY1128P	contig_3	2486	2132	354	renamed_GCF_000008685.2	lp56	19584	19938	354	99.1	3.249e-77
UNY1128P	contig_3	30852	30420	432	renamed_GCF_000008685.2	cp32-9	17301	17730	432	90.2	3.134e-82
UNY1128P	contig_3	31578	30957	621	renamed_GCF_000008685.2	cp32-7	16551	17139	621	89.8	2.86e-114
UNY1128P	contig_3	40307	39878	429	renamed_GCF_000008685.2	cp32-4	7837	8266	429	99.2	2.774e-91
UNY1128P	contig_3	42368	41978	390	renamed_GCF_000008685.2	cp32-4	5777	6167	390	100.0	3.229e-83
UNY1128P	contig_3	42739	42355	384	renamed_GCF_000008685.2	cp32-4	5406	5790	384	100.0	2.931e-83
UNY1128P	contig_3	44770	44194	576	renamed_GCF_000008685.2	cp32-6	3372	3948	576	97.3	6.014e-124
UNY1128P	contig_3	56274	55587	687	renamed_GCF_000008685.2	cp32-1	22130	22763	687	91.6	9.616e-129
UNY1128P	contig_3	56844	56286	558	renamed_GCF_000008685.2	cp32-1	21560	22118	558	100.0	2.975e-120
UNY1128P	contig_3	57639	56898	741	renamed_GCF_000008685.2	cp32-1	20765	21506	741	100.0	1.112e-161
UNY1128P	contig_3	58181	57614	567	renamed_GCF_000008685.2	cp32-1	20223	20790	567	99.4	6.547e-130
UNY1128P	contig_4	185	950	765	renamed_GCF_000008685.2	lp28-2	29618	28853	765	77.1	1.436e-128
UNY1128P	contig_4	25114	24595	519	renamed_GCF_000008685.2	lp28-4	21562	20770	519	97.0	1.121e-107
UNY1128P	contig_4	26483	25646	837	renamed_GCF_000008685.2	lp28-4	22931	22094	837	98.5	3.819e-181
UNY1128P	contig_4	41108	41612	504	renamed_GCF_000008685.2	lp25	15545	15041	504	93.4	3.607e-109
UNY1128P	contig_4	42180	43266	1086	renamed_GCF_000008685.2	lp25	14530	13402	1086	92.7	2.375e-228
UNY1128P	contig_4	43275	43839	564	renamed_GCF_000008685.2	lp25	13393	12829	564	94.6	2.975e-121
UNY1128P	contig_4	43814	44573	759	renamed_GCF_000008685.2	lp25	12854	12095	759	98.4	5.504e-164
UNY1128P	contig_4	44589	45171	582	renamed_GCF_000008685.2	lp25	12079	11497	582	98.9	1.106e-126
UNY1128P	contig_4	45709	46216	507	renamed_GCF_000008685.2	lp25	10694	10199	507	96.3	2.496e-105
UNY1128P	contig_5	47304	46431	873	renamed_GCF_000008685.2	lp54	5645	6518	873	99.3	2.643e-191
UNY1128P	contig_5	47636	47300	336	renamed_GCF_000008685.2	lp54	5313	5649	336	100.0	1.784e-72
UNY1128P	contig_5	47808	48282	474	renamed_GCF_000008685.2	lp54	5140	4666	474	100.0	5.31e-100
UNY1128P	contig_5	48692	49946	1254	renamed_GCF_000008685.2	lp54	4256	3002	1254	100.0	3.245e-279
UNY1128P	contig_5	50055	50904	849	renamed_GCF_000008685.2	lp54	2893	2044	849	100.0	5.332e-188
UNY1128P	contig_5	51489	50979	510	renamed_GCF_000008685.2	lp54	1460	1970	510	100.0	8.829e-109
UNY1128P	contig_5	52297	51811	486	renamed_GCF_000008685.2	lp28-3	28197	27624	486	48.4	2.052e-45
UNY1128P	contig_6	8486	8834	348	renamed_GCF_000008685.2	cp32-3	15418	15766	348	99.1	4.373e-73
UNY1128P	contig_6	8823	9159	336	renamed_GCF_000008685.2	cp32-4	15710	16046	336	100.0	5.348e-69
UNY1128P	contig_6	9609	10218	609	renamed_GCF_000008685.2	cp32-3	17088	17697	609	100.0	2.836e-129
UNY1128P	contig_6	10323	10947	624	renamed_GCF_000008685.2	lp56	20843	21455	624	81.2	3.975e-111
UNY1128P	contig_6	12037	11023	1014	renamed_GCF_000008685.2	cp32-1	18728	17714	1014	99.7	1.719e-228
UNY1128P	contig_7	15311	13664	1647	renamed_GCF_000008685.2	lp36	10300	11947	1647	99.8	0.0
UNY1128P	contig_7	24051	24420	369	renamed_GCF_000008685.2	lp21	745	1114	369	100.0	3.085e-80
UNY1128P	contig_7	24824	25619	795	renamed_GCF_000008685.2	lp21	1485	2628	795	94.2	1.018e-171
UNY1128P	contig_8	8037	9150	1113	renamed_GCF_000008685.2	lp56	10170	11283	1113	96.7	5.383e-241
UNY1128P	contig_8	9606	10062	456	renamed_GCF_000008685.2	cp32-4	8281	8737	456	96.6	1.075e-97
UNY1128P	contig_8	13236	13782	546	renamed_GCF_000008685.2	cp32-8	11919	12465	546	96.1	5.274e-112
UNY1128P	contig_9	26120	25208	912	renamed_GCF_000008685.2	lp28-3	26371	25432	912	98.6	1.509e-195
UNY1128P	contig_10	11054	10661	393	renamed_GCF_000008685.2	lp28-2	13141	12748	393	99.2	3.389e-83
UNY1128P	contig_10	12254	11420	834	renamed_GCF_000008685.2	lp28-2	14341	13507	834	96.7	1.8e-180
UNY1128P	contig_10	13345	12799	546	renamed_GCF_000008685.2	lp28-2	15431	14885	546	99.4	4.794e-113
UNY1128P	contig_10	15598	14407	1191	renamed_GCF_000008685.2	lp28-2	17684	16493	1191	99.7	6.781e-269
UNY1128P	contig_10	16741	15943	798	renamed_GCF_000008685.2	lp28-2	18827	18029	798	92.4	3.139e-168
UNY1128P	contig_11	1636	1150	486	renamed_GCF_000008685.2	cp26	21833	21338	486	100.0	3.279e-107
UNY1128P	contig_11	2966	2414	552	renamed_GCF_000008685.2	cp26	23154	22602	552	99.4	6.015e-120
UNY1128P	contig_11	4636	6265	1629	renamed_GCF_000008685.2	cp26	24824	26453	1629	99.8	0.0
UNY1128P	contig_13	8053	7297	756	renamed_GCF_000008685.2	lp56	24517	25273	756	100.0	1.063e-164
UNY1128P	contig_13	14472	13659	813	renamed_GCF_000008685.2	cp32-8	14323	15139	813	61.3	6.373e-102
UNY1128P	contig_14	6236	6920	684	renamed_GCF_000008685.2	lp17	5055	5739	684	100.0	2.578e-151
UNY1128P	contig_14	9448	10561	1113	renamed_GCF_000008685.2	lp17	8266	9379	1113	94.0	4.617e-234
UNY1128P	contig_14	12585	11922	663	renamed_GCF_000008685.2	lp17	11646	10983	663	100.0	1.005e-149
UNY1128P	contig_14	14928	15201	273	renamed_GCF_000008685.2	lp17	14069	14339	273	100.0	1.564e-55
UNY1128P	contig_16	4257	4998	741	renamed_GCF_000008685.2	cp32-3	21256	21997	741	100.0	5.003e-162
UNY1128P	contig_16	5593	6184	591	renamed_GCF_000008685.2	cp32-3	22592	23183	591	99.4	5.735e-127
UNY1128P	contig_21	2349	3099	750	renamed_GCF_000008685.2	cp32-6	20720	21470	750	99.5	9.67e-165
UNY1128P	contig_21	3730	4399	669	renamed_GCF_000008685.2	cp32-6	22101	22770	669	99.5	4.753e-142
UNY1128P	contig_1	56372	55571	801	renamed_GCF_000008685.2	chromosome	270473	269672	801	99.6	3.29e-168
UNY1128P	contig_1	59546	58532	1014	renamed_GCF_000008685.2	chromosome	273647	272633	1014	100.0	5.532e-224
UNY1128P	contig_1	72988	71869	1119	renamed_GCF_000008685.2	chromosome	287089	285970	1119	99.7	1.092e-242
UNY1128P	contig_1	129115	130087	972	renamed_GCF_000008685.2	chromosome	343207	344179	972	100.0	3.579e-213
UNY1128P	contig_1	132749	132338	411	renamed_GCF_000008685.2	chromosome	346841	346430	411	100.0	6.821e-87
UNY1128P	contig_1	134068	133258	810	renamed_GCF_000008685.2	chromosome	348160	347350	810	99.6	1.888e-184
UNY1128P	contig_1	136956	135507	1449	renamed_GCF_000008685.2	chromosome	351045	349599	1449	99.7	6.4e-322
UNY1128P	contig_1	139348	137248	2100	renamed_GCF_000008685.2	chromosome	353437	351340	2100	98.4	0.0
UNY1128P	contig_1	152871	152139	732	renamed_GCF_000008685.2	chromosome	366960	366228	732	98.7	5.755e-159
UNY1128P	contig_1	154795	155938	1143	renamed_GCF_000008685.2	chromosome	368884	370027	1143	99.7	7.135e-243
UNY1128P	contig_1	156944	158957	2013	renamed_GCF_000008685.2	chromosome	371033	373046	2013	99.4	0.0
UNY1128P	contig_1	160062	159477	585	renamed_GCF_000008685.2	chromosome	374151	373566	585	98.4	1.16e-126
UNY1128P	contig_1	216526	215608	918	renamed_GCF_000008685.2	chromosome	430616	429692	918	97.7	2.787e-198
UNY1128P	contig_1	228469	227629	840	renamed_GCF_000008685.2	chromosome	442552	441712	840	99.2	1.494e-183
UNY1128P	contig_1	232791	232242	549	renamed_GCF_000008685.2	chromosome	446875	446326	549	98.9	2.344e-121
UNY1128P	contig_1	233771	234089	318	renamed_GCF_000008685.2	chromosome	447854	448172	318	100.0	8.883e-69
UNY1128P	contig_1	234621	235227	606	renamed_GCF_000008685.2	chromosome	448707	449310	606	99.5	2.46e-130
UNY1128P	contig_1	247961	248690	729	renamed_GCF_000008685.2	chromosome	462044	462773	729	99.1	5.489e-159
UNY1128P	contig_1	249958	251038	1080	renamed_GCF_000008685.2	chromosome	464052	465132	1080	99.4	1.001e-245
UNY1128P	contig_1	255292	253186	2106	renamed_GCF_000008685.2	chromosome	469387	467281	2106	100.0	0.0
UNY1128P	contig_1	255876	255582	294	renamed_GCF_000008685.2	chromosome	469971	469677	294	100.0	2.2e-63
UNY1128P	contig_1	257661	257127	534	renamed_GCF_000008685.2	chromosome	471756	471222	534	99.4	1.961e-112
UNY1128P	contig_1	295216	296749	1533	renamed_GCF_000008685.2	chromosome	509313	510846	1533	99.8	0.0
UNY1128P	contig_1	299042	298295	747	renamed_GCF_000008685.2	chromosome	513139	512392	747	100.0	7.284e-159
UNY1128P	contig_1	300426	301686	1260	renamed_GCF_000008685.2	chromosome	514523	515783	1260	98.5	3.25e-280
UNY1128P	contig_1	325170	324222	948	renamed_GCF_000008685.2	chromosome	539275	538327	948	99.6	4.979e-214
UNY1128P	contig_1	328157	328919	762	renamed_GCF_000008685.2	chromosome	542262	543024	762	99.6	2.726e-172
UNY1128P	contig_1	330480	333282	2802	renamed_GCF_000008685.2	chromosome	544585	547387	2802	98.4	0.0
UNY1128P	contig_1	334780	334381	399	renamed_GCF_000008685.2	chromosome	548885	548486	399	98.4	1.677e-83
UNY1128P	contig_1	395814	394968	846	renamed_GCF_000008685.2	chromosome	609906	609060	846	100.0	3.324e-184
UNY1128P	contig_1	397216	397930	714	renamed_GCF_000008685.2	chromosome	611308	612022	714	100.0	1.949e-159
UNY1128P	contig_1	402298	401671	627	renamed_GCF_000008685.2	chromosome	616390	615763	627	98.0	3.426e-130
UNY1128P	contig_1	404735	406943	2208	renamed_GCF_000008685.2	chromosome	618827	621035	2208	99.5	0.0
UNY1128P	contig_1	422499	423864	1365	renamed_GCF_000008685.2	chromosome	636592	637957	1365	98.8	1.887e-295
UNY1128P	contig_1	424486	425779	1293	renamed_GCF_000008685.2	chromosome	638579	639872	1293	100.0	3.129e-286
UNY1128P	contig_1	428195	428348	153	renamed_GCF_000008685.2	chromosome	642288	642441	153	98.0	2.814e-30
UNY1128P	contig_1	430564	429202	1362	renamed_GCF_000008685.2	chromosome	644650	643294	1362	98.8	2.53e-300
UNY1128P	contig_1	431514	431049	465	renamed_GCF_000008685.2	chromosome	645601	645136	465	100.0	4.176e-101
UNY1128P	contig_1	448823	448508	315	renamed_GCF_000008685.2	chromosome	662917	662602	315	99.0	2.806e-64
UNY1128P	contig_1	454422	450912	3510	renamed_GCF_000008685.2	chromosome	668517	665007	3510	99.4	0.0
UNY1128P	contig_1	459116	457670	1446	renamed_GCF_000008685.2	chromosome	673167	671766	1446	98.7	5.364e-306
UNY1128P	contig_1	460938	462282	1344	renamed_GCF_000008685.2	chromosome	675034	676378	1344	99.3	8.848e-292
UNY1128P	contig_1	464847	463800	1047	renamed_GCF_000008685.2	chromosome	678938	677891	1047	100.0	5.633e-238
UNY1128P	contig_1	476412	476709	297	renamed_GCF_000008685.2	chromosome	690481	690799	297	98.9	6.955e-60
UNY1128P	contig_1	478537	479437	900	renamed_GCF_000008685.2	chromosome	692628	693528	900	99.3	9.829e-190
UNY1128P	contig_1	481432	480601	831	renamed_GCF_000008685.2	chromosome	695523	694692	831	99.6	1.298e-183
UNY1128P	contig_1	483337	482650	687	renamed_GCF_000008685.2	chromosome	697437	696750	687	100.0	2.97e-150
UNY1128P	contig_1	485866	484300	1566	renamed_GCF_000008685.2	chromosome	699965	698399	1566	99.4	0.0
UNY1128P	contig_1	531198	532230	1032	renamed_GCF_000008685.2	chromosome	745301	746333	1032	98.5	3.006e-225
UNY1128P	contig_1	534020	535916	1896	renamed_GCF_000008685.2	chromosome	748122	750018	1896	100.0	0.0
UNY1128P	contig_1	550268	551240	972	renamed_GCF_000008685.2	chromosome	764370	765342	972	100.0	2.973e-215
UNY1128P	contig_1	553962	552630	1332	renamed_GCF_000008685.2	chromosome	768064	766732	1332	99.0	1.632e-291
UNY1128P	contig_1	557037	555444	1593	renamed_GCF_000008685.2	chromosome	771139	769546	1593	99.4	0.0
UNY1128P	contig_1	560266	557467	2799	renamed_GCF_000008685.2	chromosome	774368	771569	2799	99.8	0.0
UNY1128P	contig_1	575218	575836	618	renamed_GCF_000008685.2	chromosome	789302	789938	618	99.5	1.684e-136
UNY1128P	contig_1	577685	576704	981	renamed_GCF_000008685.2	chromosome	791787	790806	981	99.6	2.843e-217
UNY1128P	contig_1	578248	579523	1275	renamed_GCF_000008685.2	chromosome	792350	793625	1275	98.3	9.993e-279
UNY1128P	contig_2	44586	46107	1521	renamed_GCF_000008685.2	chromosome	169399	167878	1521	99.8	0.0
UNY1128P	contig_2	46226	48071	1845	renamed_GCF_000008685.2	chromosome	167759	165914	1845	99.5	0.0
UNY1128P	contig_2	48098	49085	987	renamed_GCF_000008685.2	chromosome	165887	164900	987	99.6	2.948e-209
UNY1128P	contig_2	49165	50914	1749	renamed_GCF_000008685.2	chromosome	164820	163071	1749	98.7	0.0
UNY1128P	contig_2	51108	50940	168	renamed_GCF_000008685.2	chromosome	162877	163045	168	100.0	5.294e-34
UNY1128P	contig_2	51184	52786	1602	renamed_GCF_000008685.2	chromosome	162801	161199	1602	100.0	0.0
UNY1128P	contig_2	53896	52777	1119	renamed_GCF_000008685.2	chromosome	160089	161208	1119	100.0	2.349e-251
UNY1128P	contig_2	54618	53943	675	renamed_GCF_000008685.2	chromosome	159367	160042	675	98.2	2.35e-142
UNY1128P	contig_2	55358	54641	717	renamed_GCF_000008685.2	chromosome	158627	159344	717	96.6	7.985e-153
UNY1128P	contig_2	55928	55511	417	renamed_GCF_000008685.2	chromosome	158075	158474	417	100.0	2.72e-81
UNY1128P	contig_2	68528	69401	873	renamed_GCF_000008685.2	chromosome	145458	144585	873	98.2	8.193e-196
UNY1128P	contig_2	69807	71043	1236	renamed_GCF_000008685.2	chromosome	144230	142943	1236	99.5	6.15e-269
UNY1128P	contig_2	71054	72008	954	renamed_GCF_000008685.2	chromosome	142932	141978	954	99.3	1.665e-201
UNY1128P	contig_2	75243	75555	312	renamed_GCF_000008685.2	chromosome	138745	138433	312	99.0	1.086e-65
UNY1128P	contig_2	76222	78115	1893	renamed_GCF_000008685.2	chromosome	137766	135873	1893	99.6	0.0
UNY1128P	contig_2	80014	78124	1890	renamed_GCF_000008685.2	chromosome	133974	135864	1890	99.2	0.0
UNY1128P	contig_2	80146	81517	1371	renamed_GCF_000008685.2	chromosome	133842	132471	1371	99.7	1.195e-301
UNY1128P	contig_2	82691	81563	1128	renamed_GCF_000008685.2	chromosome	131297	132425	1128	100.0	3.566e-248
UNY1128P	contig_2	93399	94182	783	renamed_GCF_000008685.2	chromosome	120589	119806	783	100.0	5.024e-169
UNY1128P	contig_2	94185	95025	840	renamed_GCF_000008685.2	chromosome	119803	118963	840	96.4	7.682e-174
UNY1128P	contig_2	95059	95614	555	renamed_GCF_000008685.2	chromosome	118929	118374	555	99.4	3.776e-117
UNY1128P	contig_2	95618	96311	693	renamed_GCF_000008685.2	chromosome	118370	117677	693	98.6	6.012e-152
UNY1128P	contig_2	97182	98484	1302	renamed_GCF_000008685.2	chromosome	116806	115504	1302	98.6	5.194e-282
UNY1128P	contig_2	108134	108572	438	renamed_GCF_000008685.2	chromosome	105846	105417	438	97.8	4.286e-88
UNY1128P	contig_2	108558	110226	1668	renamed_GCF_000008685.2	chromosome	105299	103763	1668	99.8	0.0
UNY1128P	contig_2	110218	110974	756	renamed_GCF_000008685.2	chromosome	103771	103015	756	99.6	2.151e-165
UNY1128P	contig_2	111040	112465	1425	renamed_GCF_000008685.2	chromosome	102949	101524	1425	99.5	4.976e-312
UNY1128P	contig_2	134635	134986	351	renamed_GCF_000008685.2	chromosome	79322	79001	351	100.0	3.732e-67
UNY1128P	contig_2	134978	136277	1299	renamed_GCF_000008685.2	chromosome	79009	77710	1299	99.7	4.127e-284
UNY1128P	contig_2	137537	136286	1251	renamed_GCF_000008685.2	chromosome	76450	77701	1251	98.5	2.27e-265
UNY1128P	contig_2	138214	137533	681	renamed_GCF_000008685.2	chromosome	75773	76454	681	100.0	3.584e-147
UNY1128P	contig_2	152733	153423	690	renamed_GCF_000008685.2	chromosome	61257	60567	690	98.6	3.759e-148
UNY1128P	contig_2	153457	153955	498	renamed_GCF_000008685.2	chromosome	60533	60035	498	98.7	8.026e-108
UNY1128P	contig_2	153951	154890	939	renamed_GCF_000008685.2	chromosome	60039	59100	939	99.6	9.091e-206
UNY1128P	contig_2	154953	155961	1008	renamed_GCF_000008685.2	chromosome	58982	58028	1008	99.6	2.659e-205
UNY1128P	contig_2	186131	186563	432	renamed_GCF_000008685.2	chromosome	27865	27433	432	99.3	1.308e-91
UNY1128P	contig_2	187598	186548	1050	renamed_GCF_000008685.2	chromosome	26398	27448	1050	99.4	8.55e-234
UNY1128P	contig_2	188244	187605	639	renamed_GCF_000008685.2	chromosome	25752	26391	639	99.5	1.211e-143
UNY1128P	contig_2	188373	189300	927	renamed_GCF_000008685.2	chromosome	25623	24696	927	97.7	1.738e-196
UNY1128P	contig_2	189300	190032	732	renamed_GCF_000008685.2	chromosome	24696	23964	732	100.0	2.844e-158
UNY1128P	contig_2	191178	190038	1140	renamed_GCF_000008685.2	chromosome	22818	23958	1140	97.6	4.164e-257
UNY1128P	contig_2	201685	201085	600	renamed_GCF_000008685.2	chromosome	12153	12753	600	98.9	1.006e-130
UNY1128P	contig_2	202418	201677	741	renamed_GCF_000008685.2	chromosome	11420	12161	741	99.1	9.218e-164
UNY1128P	contig_2	203258	202418	840	renamed_GCF_000008685.2	chromosome	10580	11420	840	100.0	7.775e-191
UNY1128P	contig_2	203636	203261	375	renamed_GCF_000008685.2	chromosome	10202	10577	375	100.0	3.75e-79
UNY1128P	contig_3	6156	5601	555	renamed_GCF_000008685.2	cp32-6	11929	12484	555	94.0	1.352e-111
UNY1128P	contig_3	7123	6169	954	renamed_GCF_000008685.2	cp32-4	10895	11846	954	98.7	1.762e-209
UNY1128P	contig_3	15997	14689	1308	renamed_GCF_000008685.2	cp32-6	2576	3344	1308	97.6	3.123e-164
UNY1128P	contig_3	17941	16717	1224	renamed_GCF_000008685.2	cp32-6	65	1289	1224	100.0	2.096e-270
UNY1128P	contig_3	37862	37178	684	renamed_GCF_000008685.2	lp56	13754	14438	684	97.3	4.129e-146
UNY1128P	contig_3	39167	37883	1284	renamed_GCF_000008685.2	cp32-4	8977	10273	1284	86.8	7.474e-240
UNY1128P	contig_3	39411	39174	237	renamed_GCF_000008685.2	cp32-9	8741	8978	237	98.7	8.748e-48
UNY1128P	contig_3	46134	45570	564	renamed_GCF_000008685.2	cp32-4	2012	2576	564	98.9	1.105e-123
UNY1128P	contig_4	8506	8725	219	renamed_GCF_000008685.2	lp28-4	5127	5346	219	100.0	1.443e-47
UNY1128P	contig_4	10589	12107	1518	renamed_GCF_000008685.2	lp28-4	7182	8538	1518	89.3	3.728e-287
UNY1128P	contig_4	14369	15476	1107	renamed_GCF_000008685.2	lp28-4	10814	11927	1107	98.9	2.343e-249
UNY1128P	contig_4	15472	16027	555	renamed_GCF_000008685.2	lp28-4	11923	12478	555	100.0	3.559e-126
UNY1128P	contig_4	27577	26710	867	renamed_GCF_000008685.2	lp28-4	25089	24222	867	97.5	9.348e-185
UNY1128P	contig_5	9451	10360	909	renamed_GCF_000008685.2	lp54	43532	42623	909	99.3	2.657e-197
UNY1128P	contig_5	10964	11588	624	renamed_GCF_000008685.2	lp54	42019	41395	624	100.0	3.1e-139
UNY1128P	contig_5	12871	13111	240	renamed_GCF_000008685.2	lp54	40112	39872	240	100.0	3.722e-49
UNY1128P	contig_5	16716	16449	267	renamed_GCF_000008685.2	lp54	36255	36534	267	98.8	1.568e-54
UNY1128P	contig_5	18599	18035	564	renamed_GCF_000008685.2	lp54	34384	34948	564	99.4	3.599e-119
UNY1128P	contig_5	20723	20234	489	renamed_GCF_000008685.2	lp54	32260	32749	489	100.0	3.125e-108
UNY1128P	contig_5	22274	21203	1071	renamed_GCF_000008685.2	lp54	30709	31780	1071	99.4	1.082e-234
UNY1128P	contig_6	21567	22920	1353	renamed_GCF_000008685.2	cp32-6	28485	29838	1353	99.3	1.524e-304
UNY1128P	contig_7	1067	1916	849	renamed_GCF_000008685.2	lp36	35443	34594	849	98.2	1.185e-187
UNY1128P	contig_7	4959	4665	294	renamed_GCF_000008685.2	lp28-1	10895	10697	294	98.4	2.041e-40
UNY1128P	contig_7	16240	15841	399	renamed_GCF_000008685.2	lp36	9372	9999	399	99.1	1.114e-79
UNY1128P	contig_8	16529	16733	204	renamed_GCF_000008685.2	cp32-3	15211	15415	204	100.0	2.578e-39
UNY1128P	contig_8	17401	17755	354	renamed_GCF_000008685.2	cp32-7	16093	16447	354	100.0	1.459e-77
UNY1128P	contig_8	17859	18414	555	renamed_GCF_000008685.2	cp32-8	16544	17099	555	100.0	3.776e-117
UNY1128P	contig_8	30181	30748	567	renamed_GCF_000008685.2	cp32-1	28834	29401	567	95.7	2.258e-116
UNY1128P	contig_9	38	629	591	renamed_GCF_000008685.2	lp56	52608	52134	591	98.7	7.4e-99
UNY1128P	contig_9	7497	3660	3837	renamed_GCF_000008685.2	lp28-3	7728	3891	3837	99.9	0.0
UNY1128P	contig_9	10286	9617	669	renamed_GCF_000008685.2	lp28-3	10516	9847	669	100.0	5.739e-140
UNY1128P	contig_11	11081	12179	1098	renamed_GCF_000008685.2	cp26	4768	5866	1098	100.0	2.035e-249
UNY1128P	contig_11	14148	15078	930	renamed_GCF_000008685.2	cp26	7835	8765	930	97.4	1.145e-201
UNY1128P	contig_11	15586	16348	762	renamed_GCF_000008685.2	cp26	9274	10036	762	98.8	5.77e-164
UNY1128P	contig_12	8529	7968	561	renamed_GCF_000008685.2	cp32-9	21613	22174	561	100.0	6.308e-121
UNY1128P	contig_15	8394	7587	807	renamed_GCF_000008685.2	lp38	16519	17329	807	41.3	8.764e-60
UNY1128P	contig_15	11405	11966	561	renamed_GCF_000008685.2	lp28-1	14329	13768	561	98.9	4.739e-124
UNY1128P	contig_15	12742	13294	552	renamed_GCF_000008685.2	lp28-1	12992	12440	552	97.8	3.273e-118
UNY1128P	contig_16	796	1243	447	renamed_GCF_000008685.2	cp32-3	17802	18249	447	85.8	1.968e-81
UNY1128P	contig_16	3715	4282	567	renamed_GCF_000008685.2	cp32-4	20066	20633	567	100.0	2.944e-130
UNY1128P	contig_18	2394	3171	777	renamed_GCF_000008685.2	cp32-7	25720	24943	777	99.2	3.452e-172
UNY1128P	contig_18	3602	3176	426	renamed_GCF_000008685.2	cp32-7	24512	24938	426	100.0	8.056e-96
UNY1128P	contig_18	6626	6065	561	renamed_GCF_000008685.2	cp9	1891	2452	561	63.4	1.387e-78
UNY1128P	contig_22	278	1187	909	renamed_GCF_000008685.2	cp9	2803	3712	909	99.6	1.933e-209
UNY1128P	contig_1	3179	4211	1032	renamed_GCF_000008685.2	chromosome	217277	218312	1032	99.4	1.06e-219
UNY1128P	contig_1	5533	4954	579	renamed_GCF_000008685.2	chromosome	219634	219055	579	100.0	8.388e-121
UNY1128P	contig_1	6627	7536	909	renamed_GCF_000008685.2	chromosome	220728	221637	909	100.0	9.393e-192
UNY1128P	contig_1	9077	9860	783	renamed_GCF_000008685.2	chromosome	223178	223961	783	100.0	3.455e-173
UNY1128P	contig_1	12509	10724	1785	renamed_GCF_000008685.2	chromosome	226610	224825	1785	99.4	0.0
UNY1128P	contig_1	14420	13712	708	renamed_GCF_000008685.2	chromosome	228521	227813	708	99.5	4.758e-157
UNY1128P	contig_1	17390	16112	1278	renamed_GCF_000008685.2	chromosome	231491	230213	1278	99.7	4.58e-288
UNY1128P	contig_1	18236	21152	2916	renamed_GCF_000008685.2	chromosome	232337	235253	2916	99.4	0.0
UNY1128P	contig_1	23041	21493	1548	renamed_GCF_000008685.2	chromosome	237142	235594	1548	99.8	0.0
UNY1128P	contig_1	64458	62988	1470	renamed_GCF_000008685.2	chromosome	278559	277089	1470	99.5	9.743e-321
UNY1128P	contig_1	65279	64976	303	renamed_GCF_000008685.2	chromosome	279380	279077	303	98.0	2.549e-63
UNY1128P	contig_1	67692	67212	480	renamed_GCF_000008685.2	chromosome	281793	281313	480	99.3	2.386e-101
UNY1128P	contig_1	69764	68597	1167	renamed_GCF_000008685.2	chromosome	283865	282698	1167	100.0	1.172e-258
UNY1128P	contig_1	79328	79103	225	renamed_GCF_000008685.2	chromosome	293429	293204	225	100.0	8.8e-46
UNY1128P	contig_1	81126	80682	444	renamed_GCF_000008685.2	chromosome	295228	294784	444	99.3	2.638e-94
UNY1128P	contig_1	82943	82325	618	renamed_GCF_000008685.2	chromosome	297045	296427	618	99.5	5.47e-132
UNY1128P	contig_1	84674	83363	1311	renamed_GCF_000008685.2	chromosome	298776	297465	1311	100.0	6.981e-289
UNY1128P	contig_1	86662	85627	1035	renamed_GCF_000008685.2	chromosome	300764	299729	1035	100.0	3.255e-216
UNY1128P	contig_1	97550	96455	1095	renamed_GCF_000008685.2	chromosome	311617	310558	1095	98.5	6.652e-227
UNY1128P	contig_1	142917	144351	1434	renamed_GCF_000008685.2	chromosome	357006	358440	1434	99.7	2.35e-313
UNY1128P	contig_1	145406	145127	279	renamed_GCF_000008685.2	chromosome	359495	359216	279	100.0	2.841e-58
UNY1128P	contig_1	147110	148232	1122	renamed_GCF_000008685.2	chromosome	361187	362321	1122	99.7	2.462e-251
UNY1128P	contig_1	150991	150040	951	renamed_GCF_000008685.2	chromosome	364972	364129	951	99.6	1.174e-187
UNY1128P	contig_1	161571	161850	279	renamed_GCF_000008685.2	chromosome	375660	375939	279	100.0	3.143e-57
UNY1128P	contig_1	165241	162949	2292	renamed_GCF_000008685.2	chromosome	379258	377038	2292	98.9	0.0
UNY1128P	contig_1	167803	166465	1338	renamed_GCF_000008685.2	chromosome	381892	380554	1338	100.0	1.408e-311
UNY1128P	contig_1	170073	169305	768	renamed_GCF_000008685.2	chromosome	384162	383394	768	99.6	9.689e-168
UNY1128P	contig_1	171359	172073	714	renamed_GCF_000008685.2	chromosome	385448	386162	714	100.0	3.427e-153
UNY1128P	contig_1	183390	183015	375	renamed_GCF_000008685.2	chromosome	397476	397101	375	100.0	1.385e-81
UNY1128P	contig_1	237838	237055	783	renamed_GCF_000008685.2	chromosome	451921	451138	783	99.6	5.024e-169
UNY1128P	contig_1	242305	240400	1905	renamed_GCF_000008685.2	chromosome	456388	454483	1905	99.8	0.0
UNY1128P	contig_1	244193	245351	1158	renamed_GCF_000008685.2	chromosome	458276	459434	1158	99.7	2.722e-256
UNY1128P	contig_1	245832	245988	156	renamed_GCF_000008685.2	chromosome	459915	460071	156	100.0	2.965e-30
UNY1128P	contig_1	258380	257675	705	renamed_GCF_000008685.2	chromosome	472358	471770	705	99.4	1.099e-121
UNY1128P	contig_1	260461	259309	1152	renamed_GCF_000008685.2	chromosome	474556	473404	1152	100.0	7.714e-261
UNY1128P	contig_1	261510	262116	606	renamed_GCF_000008685.2	chromosome	475605	476211	606	99.5	4.975e-131
UNY1128P	contig_1	267959	267245	714	renamed_GCF_000008685.2	chromosome	482057	481343	714	100.0	3.944e-160
UNY1128P	contig_1	276545	277829	1284	renamed_GCF_000008685.2	chromosome	490643	491927	1284	100.0	9.564e-281
UNY1128P	contig_1	315093	313998	1095	renamed_GCF_000008685.2	chromosome	529198	528103	1095	100.0	3.934e-250
UNY1128P	contig_1	317587	317023	564	renamed_GCF_000008685.2	chromosome	531692	531128	564	100.0	2.704e-122
UNY1128P	contig_1	321598	323422	1824	renamed_GCF_000008685.2	chromosome	535703	537527	1824	99.1	0.0
UNY1128P	contig_1	335513	334814	699	renamed_GCF_000008685.2	chromosome	549618	548919	699	100.0	1.058e-146
UNY1128P	contig_1	339891	341112	1221	renamed_GCF_000008685.2	chromosome	553991	555212	1221	100.0	5.34e-268
UNY1128P	contig_1	343323	342462	861	renamed_GCF_000008685.2	chromosome	557423	556562	861	99.3	6.436e-188
UNY1128P	contig_1	346632	343905	2727	renamed_GCF_000008685.2	chromosome	560732	558005	2727	99.6	0.0
UNY1128P	contig_8	25982	26408	426	renamed_GCF_000008685.2	cp32-8	24743	25169	426	100.0	8.056e-96
UNY1128P	contig_8	27620	28139	519	renamed_GCF_000008685.2	cp32-8	26381	26903	519	75.6	8.35e-86
UNY1128P	contig_8	29462	30002	540	renamed_GCF_000008685.2	cp32-8	28250	28790	540	100.0	1.472e-116
UNY1128P	contig_9	17181	17748	567	renamed_GCF_000008685.2	lp28-3	17407	17974	567	100.0	1.938e-126
UNY1128P	contig_9	18571	19201	630	renamed_GCF_000008685.2	lp28-3	18797	19427	630	99.5	4.977e-135
UNY1128P	contig_9	22453	22729	276	renamed_GCF_000008685.2	lp28-3	22677	22953	276	100.0	6.026e-58
UNY1128P	contig_9	27221	26753	468	renamed_GCF_000008685.2	lp28-3	27445	26977	468	99.3	1.339e-105
UNY1128P	contig_10	11408	11069	339	renamed_GCF_000008685.2	lp28-2	13495	13156	339	97.3	4.171e-72
UNY1128P	contig_10	12799	12289	510	renamed_GCF_000008685.2	lp28-2	14885	14375	510	97.6	2.379e-106
UNY1128P	contig_11	25138	24301	837	renamed_GCF_000008685.2	cp26	19321	17965	837	99.6	4.192e-180
UNY1128P	contig_12	3921	3285	636	renamed_GCF_000008685.2	cp32-9	26209	26770	636	74.6	3.947e-96
UNY1128P	contig_12	13882	13528	354	renamed_GCF_000008685.2	cp32-6	16102	16456	354	100.0	1.459e-77
UNY1128P	contig_12	14754	14550	204	renamed_GCF_000008685.2	cp32-8	15214	15418	204	100.0	2.578e-39
UNY1128P	contig_13	8595	8028	567	renamed_GCF_000008685.2	lp56	23975	24542	567	99.4	3.238e-129
UNY1128P	contig_14	16975	16744	231	renamed_GCF_000008685.2	lp17	16119	15888	231	98.6	8.774e-47
UNY1128P	contig_16	8054	8480	426	renamed_GCF_000008685.2	cp32-3	25068	25494	426	97.1	9.782e-94
UNY1128P	contig_16	9693	10368	675	renamed_GCF_000008685.2	cp32-4	26852	27527	675	87.6	2.351e-125
UNY1128P	contig_18	9457	10474	1017	renamed_GCF_000008685.2	cp32-4	18583	17572	1017	87.3	3.149e-196
UNY1128P	contig_1	42361	44884	2523	renamed_GCF_000008685.2	chromosome	256462	258985	2523	98.5	0.0
UNY1128P	contig_1	49611	47190	2421	renamed_GCF_000008685.2	chromosome	263712	261291	2421	99.8	0.0
UNY1128P	contig_1	49886	52013	2127	renamed_GCF_000008685.2	chromosome	263987	266114	2127	99.4	0.0
UNY1128P	contig_1	52005	52950	945	renamed_GCF_000008685.2	chromosome	266106	267051	945	100.0	6.277e-211
UNY1128P	contig_1	52964	53174	210	renamed_GCF_000008685.2	chromosome	267065	267275	210	100.0	4.647e-42
UNY1128P	contig_1	58579	56386	2193	renamed_GCF_000008685.2	chromosome	272641	270487	2193	99.8	0.0
UNY1128P	contig_1	71858	69767	2091	renamed_GCF_000008685.2	chromosome	285962	283868	2091	99.4	0.0
UNY1128P	contig_1	73776	72987	789	renamed_GCF_000008685.2	chromosome	287877	287088	789	98.4	1.061e-161
UNY1128P	contig_1	74845	74080	765	renamed_GCF_000008685.2	chromosome	288946	288181	765	99.6	5.507e-165
UNY1128P	contig_1	75482	74855	627	renamed_GCF_000008685.2	chromosome	289583	288956	627	94.2	1.222e-124
UNY1128P	contig_1	106157	105578	579	renamed_GCF_000008685.2	chromosome	320249	319679	579	99.4	6.936e-123
UNY1128P	contig_1	107250	107937	687	renamed_GCF_000008685.2	chromosome	321351	322038	687	100.0	1.336e-150
UNY1128P	contig_1	109678	108745	933	renamed_GCF_000008685.2	chromosome	323779	322846	933	99.3	2.018e-204
UNY1128P	contig_1	112187	111134	1053	renamed_GCF_000008685.2	chromosome	326288	325235	1053	99.7	1.991e-233
UNY1128P	contig_1	113930	115064	1134	renamed_GCF_000008685.2	chromosome	328031	329165	1134	100.0	5.485e-253
UNY1128P	contig_1	130970	132272	1302	renamed_GCF_000008685.2	chromosome	345062	346364	1302	99.5	6.653e-288
UNY1128P	contig_1	133209	132768	441	renamed_GCF_000008685.2	chromosome	347301	346860	441	100.0	1.706e-98
UNY1128P	contig_1	135518	134060	1458	renamed_GCF_000008685.2	chromosome	349610	348152	1458	99.5	0.0
UNY1128P	contig_1	137239	136963	276	renamed_GCF_000008685.2	chromosome	351331	351055	276	98.9	4.053e-54
UNY1128P	contig_1	195316	194467	849	renamed_GCF_000008685.2	chromosome	409402	408553	849	100.0	9.834e-190
UNY1128P	contig_1	196700	197360	660	renamed_GCF_000008685.2	chromosome	410786	411446	660	96.3	1.47e-136
UNY1128P	contig_1	199026	200229	1203	renamed_GCF_000008685.2	chromosome	413112	414315	1203	98.7	8.424e-260
UNY1128P	contig_1	202437	201759	678	renamed_GCF_000008685.2	chromosome	416478	415845	678	98.5	5.476e-142
UNY1128P	contig_1	203015	203627	612	renamed_GCF_000008685.2	chromosome	417101	417713	612	100.0	4.975e-132
UNY1128P	contig_1	214561	215590	1029	renamed_GCF_000008685.2	chromosome	428645	429674	1029	99.7	8.604e-239
UNY1128P	contig_1	221019	216534	4485	renamed_GCF_000008685.2	chromosome	435103	430618	4485	98.9	0.0
UNY1128P	contig_1	229162	228601	561	renamed_GCF_000008685.2	chromosome	443248	442687	561	98.3	2.578e-122
UNY1128P	contig_1	233560	232885	675	renamed_GCF_000008685.2	chromosome	447736	446968	675	99.5	9.618e-144
UNY1128P	contig_1	234508	234118	390	renamed_GCF_000008685.2	chromosome	448591	448201	390	100.0	7.926e-82
UNY1128P	contig_1	285243	285606	363	renamed_GCF_000008685.2	chromosome	499340	499703	363	100.0	3.407e-78
UNY1128P	contig_1	286495	286912	417	renamed_GCF_000008685.2	chromosome	500592	501009	417	100.0	2.778e-89
UNY1128P	contig_1	287117	287372	255	renamed_GCF_000008685.2	chromosome	501214	501469	255	100.0	1.745e-51
UNY1128P	contig_1	287782	288088	306	renamed_GCF_000008685.2	chromosome	501879	502185	306	100.0	2.959e-62
UNY1128P	contig_1	288658	288844	186	renamed_GCF_000008685.2	chromosome	502755	502941	186	100.0	7.664e-41
UNY1128P	contig_1	294772	295144	372	renamed_GCF_000008685.2	chromosome	508869	509241	372	98.3	2.155e-76
UNY1128P	contig_1	296738	297527	789	renamed_GCF_000008685.2	chromosome	510835	511624	789	98.8	1.876e-172
UNY1128P	contig_1	299128	300430	1302	renamed_GCF_000008685.2	chromosome	513225	514527	1302	99.0	2.133e-283
UNY1128P	contig_1	302388	308889	6501	renamed_GCF_000008685.2	chromosome	516492	522993	6501	99.1	0.0
UNY1128P	contig_1	369355	369730	375	renamed_GCF_000008685.2	chromosome	583457	583832	375	99.1	1.859e-78
UNY1128P	contig_1	370989	372054	1065	renamed_GCF_000008685.2	chromosome	585079	586156	1065	99.7	1.659e-237
UNY1128P	contig_1	372928	373780	852	renamed_GCF_000008685.2	chromosome	587030	587882	852	99.6	1.732e-192
UNY1128P	contig_1	376106	375581	525	renamed_GCF_000008685.2	chromosome	590208	589683	525	96.5	7.385e-105
UNY1128P	contig_1	377095	378265	1170	renamed_GCF_000008685.2	chromosome	591187	592357	1170	100.0	9.606e-253
UNY1128P	contig_1	397101	395850	1251	renamed_GCF_000008685.2	chromosome	611193	609942	1251	98.3	2.071e-266
UNY1128P	contig_1	397955	399893	1938	renamed_GCF_000008685.2	chromosome	612047	613985	1938	99.6	0.0
UNY1128P	contig_1	401679	399921	1758	renamed_GCF_000008685.2	chromosome	615771	614013	1758	99.1	0.0
UNY1128P	contig_1	404467	402319	2148	renamed_GCF_000008685.2	chromosome	618559	616411	2148	99.7	0.0
UNY1128P	contig_1	407861	406952	909	renamed_GCF_000008685.2	chromosome	621953	621044	909	99.3	3.709e-202
UNY1128P	contig_1	476793	478554	1761	renamed_GCF_000008685.2	chromosome	690884	692645	1761	99.3	0.0
UNY1128P	contig_1	479462	480605	1143	renamed_GCF_000008685.2	chromosome	693553	694696	1143	100.0	3.979e-258
UNY1128P	contig_1	481530	482664	1134	renamed_GCF_000008685.2	chromosome	695630	696764	1134	99.7	1.556e-258
UNY1128P	contig_1	483485	484232	747	renamed_GCF_000008685.2	chromosome	697585	698332	747	100.0	1.547e-167
UNY1128P	contig_1	486825	485952	873	renamed_GCF_000008685.2	chromosome	700924	700051	873	99.3	1.433e-189
UNY1128P	contig_1	497107	497548	441	renamed_GCF_000008685.2	chromosome	711210	711651	441	100.0	1.245e-93
UNY1128P	contig_1	499147	498100	1047	renamed_GCF_000008685.2	chromosome	713250	712203	1047	100.0	1.709e-225
UNY1128P	contig_1	500663	500000	663	renamed_GCF_000008685.2	chromosome	714766	714103	663	98.1	1.77e-143
UNY1128P	contig_1	502516	503668	1152	renamed_GCF_000008685.2	chromosome	716619	717771	1152	100.0	1.261e-246
UNY1128P	contig_1	504723	506985	2262	renamed_GCF_000008685.2	chromosome	718826	721088	2262	99.8	0.0
UNY1128P	contig_1	530418	530742	324	renamed_GCF_000008685.2	chromosome	744521	744845	324	100.0	1.32e-65
UNY1128P	contig_1	535928	536687	759	renamed_GCF_000008685.2	chromosome	750030	750789	759	100.0	2.255e-165
UNY1128P	contig_1	549476	550259	783	renamed_GCF_000008685.2	chromosome	763578	764361	783	100.0	1.874e-171
UNY1128P	contig_1	551270	552614	1344	renamed_GCF_000008685.2	chromosome	765372	766716	1344	100.0	2.685e-305
UNY1128P	contig_1	555368	553976	1392	renamed_GCF_000008685.2	chromosome	769470	768078	1392	100.0	1.696e-292
UNY1128P	contig_1	557461	557059	402	renamed_GCF_000008685.2	chromosome	771563	771161	402	100.0	3.917e-83
UNY1128P	contig_1	560574	561360	786	renamed_GCF_000008685.2	chromosome	774676	775462	786	99.6	5.782e-168
UNY1128P	contig_1	576705	575844	861	renamed_GCF_000008685.2	chromosome	790807	789946	861	99.6	3.489e-186
UNY1128P	contig_1	578150	577691	459	renamed_GCF_000008685.2	chromosome	792252	791793	459	99.3	2.509e-97
UNY1128P	contig_1	617641	616867	774	renamed_GCF_000008685.2	chromosome	831563	830954	774	99.5	5.119e-133
UNY1128P	contig_1	621973	624439	2466	renamed_GCF_000008685.2	chromosome	836060	838526	2466	99.7	0.0
UNY1128P	contig_1	638371	639661	1290	renamed_GCF_000008685.2	chromosome	852488	853778	1290	99.7	1.474e-285
UNY1128P	contig_1	640753	641881	1128	renamed_GCF_000008685.2	chromosome	854868	855996	1128	97.8	1.869e-255
UNY1128P	contig_1	643390	644800	1410	renamed_GCF_000008685.2	chromosome	857505	858915	1410	99.3	7.483e-305
UNY1128P	contig_1	646325	647660	1335	renamed_GCF_000008685.2	chromosome	860439	861774	1335	99.5	2.053e-289
UNY1128P	contig_1	661020	658473	2547	renamed_GCF_000008685.2	chromosome	875132	872585	2547	100.0	0.0
UNY1128P	contig_1	662316	665169	2853	renamed_GCF_000008685.2	chromosome	876491	879281	2853	99.6	0.0
UNY1128P	contig_1	666979	666154	825	renamed_GCF_000008685.2	chromosome	881091	880266	825	98.1	3.813e-179
UNY1128P	contig_1	672335	670115	2220	renamed_GCF_000008685.2	chromosome	886447	884227	2220	99.7	0.0
UNY1128P	contig_2	23267	22526	741	renamed_GCF_000008685.2	chromosome	190718	191459	741	99.5	3.597e-157
UNY1128P	contig_2	23922	23268	654	renamed_GCF_000008685.2	chromosome	190186	190717	654	98.8	6.934e-110
UNY1128P	contig_2	31100	30605	495	renamed_GCF_000008685.2	chromosome	182885	183380	495	100.0	9.271e-106
UNY1128P	contig_2	31183	32578	1395	renamed_GCF_000008685.2	chromosome	182802	181407	1395	99.1	1.125e-297
UNY1128P	contig_2	32580	34446	1866	renamed_GCF_000008685.2	chromosome	181405	179539	1866	99.6	0.0
UNY1128P	contig_2	34442	35069	627	renamed_GCF_000008685.2	chromosome	179543	178916	627	98.5	1.541e-130
UNY1128P	contig_2	35125	36118	993	renamed_GCF_000008685.2	chromosome	178860	177867	993	100.0	4.528e-214
UNY1128P	contig_2	36132	37008	876	renamed_GCF_000008685.2	chromosome	177853	176977	876	100.0	9.427e-195
UNY1128P	contig_2	37089	37917	828	renamed_GCF_000008685.2	chromosome	176974	176068	828	100.0	8.883e-179
UNY1128P	contig_5	17030	16754	276	renamed_GCF_000008685.2	lp54	35953	36229	276	100.0	3.31e-56
UNY1128P	contig_5	17996	17150	846	renamed_GCF_000008685.2	lp54	34987	35833	846	99.6	2.758e-186
UNY1128P	contig_5	20242	20023	219	renamed_GCF_000008685.2	lp54	32741	32960	219	100.0	7.958e-46
UNY1128P	contig_5	21204	20781	423	renamed_GCF_000008685.2	lp54	31779	32202	423	99.2	5.606e-91
UNY1128P	contig_5	22880	22340	540	renamed_GCF_000008685.2	lp54	30093	30633	540	99.4	2.458e-119
UNY1128P	contig_5	24039	23586	453	renamed_GCF_000008685.2	lp54	28934	29387	453	100.0	2.51e-96
UNY1128P	contig_5	25584	24975	609	renamed_GCF_000008685.2	lp54	27389	27998	609	100.0	2.346e-131
UNY1128P	contig_5	27511	26269	1242	renamed_GCF_000008685.2	lp54	25467	26694	1242	100.0	1.5e-268
UNY1128P	contig_5	29187	28548	639	renamed_GCF_000008685.2	lp54	23776	24415	639	98.5	5.219e-136
UNY1128P	contig_5	29689	31279	1590	renamed_GCF_000008685.2	lp54	23273	21683	1590	99.6	0.0
UNY1128P	contig_6	22985	24209	1224	renamed_GCF_000008685.2	cp32-1	65	1289	1224	100.0	2.096e-270
UNY1128P	contig_6	24929	25493	564	renamed_GCF_000008685.2	cp32-6	2009	2573	564	99.4	1.105e-123
UNY1128P	contig_7	516	1071	555	renamed_GCF_000008685.2	lp56	855	1407	555	96.7	4.153e-116
UNY1128P	contig_7	2856	3198	342	renamed_GCF_000008685.2	lp28-3	8017	8431	342	61.5	0.0002439
UNY1128P	contig_7	5764	5590	174	renamed_GCF_000008685.2	lp36	22293	22467	174	92.9	1.178e-34
UNY1128P	contig_7	16753	17449	696	renamed_GCF_000008685.2	lp36	8859	8163	696	97.8	8.359e-149
UNY1128P	contig_7	19575	20328	753	renamed_GCF_000008685.2	lp36	6040	5287	753	98.8	1.953e-157
UNY1128P	contig_8	20335	21433	1098	renamed_GCF_000008685.2	cp32-7	19116	20214	1098	96.9	1.595e-243
UNY1128P	contig_8	30744	32097	1353	renamed_GCF_000008685.2	cp32-7	29447	30800	1353	98.8	1.524e-304
UNY1128P	contig_9	815	1139	324	renamed_GCF_000008685.2	lp28-3	1044	1368	324	99.0	8.87e-70
UNY1128P	contig_9	2740	2029	711	renamed_GCF_000008685.2	lp28-3	2970	2259	711	98.7	4.333e-150
UNY1128P	contig_9	7973	7769	204	renamed_GCF_000008685.2	lp36	17379	17583	204	83.5	3.933e-35
UNY1128P	contig_10	10232	9413	819	renamed_GCF_000008685.2	lp28-2	12319	11500	819	100.0	1.075e-183
UNY1128P	contig_10	20215	17533	2682	renamed_GCF_000008685.2	lp28-2	22259	19619	2682	97.1	0.0
UNY1128P	contig_10	20987	20615	372	renamed_GCF_000008685.2	lp28-2	23033	22658	372	80.4	3.483e-63
UNY1128P	contig_10	22085	21671	414	renamed_GCF_000008685.2	lp28-2	24108	23721	414	55.6	1.931e-43
UNY1128P	contig_10	23938	24331	393	renamed_GCF_000008685.2	lp28-2	25979	26390	393	83.8	4.469e-72
UNY1128P	contig_10	25078	26020	942	renamed_GCF_000008685.2	lp28-2	28030	28831	942	67.4	7.615e-121
UNY1128P	contig_11	10111	8788	1323	renamed_GCF_000008685.2	cp26	3798	2475	1323	99.5	7.001e-291
UNY1128P	contig_11	10752	11070	318	renamed_GCF_000008685.2	cp26	4481	4757	318	97.8	1.616e-54
UNY1128P	contig_11	12989	14027	1038	renamed_GCF_000008685.2	cp26	6676	7714	1038	99.4	4.211e-231
UNY1128P	contig_15	179	1661	1482	renamed_GCF_000008685.2	lp28-1	26996	28073	1482	49.1	4.039e-65
UNY1128P	contig_26	1544	707	837	renamed_GCF_000008685.2	cp26	20786	19430	837	97.8	4.601e-179
UNY1128P	contig_30	920	362	558	renamed_GCF_000008685.2	cp9	1281	1839	558	100.0	4.107e-125